element_name,element,element_type,fixture,kickoff_time,was_home,team,opponent_team,minutes,total_points,running_team_points,running_team_points_home,running_team_points_away,running_opponent_team_points,running_opponent_team_points_home,running_opponent_team_points_away,total_points_difference,relative_points_difference
Cech,0,0,0,2018-08-12T15:00:00Z,True,0,12,90,3,0,0,0,0,0,0,0,0
Cech,0,0,13,2018-08-18T16:30:00Z,False,0,5,90,3,0,0,0,3,0,3,-3,0
Cech,0,0,20,2018-08-25T14:00:00Z,True,0,18,90,3,0,0,0,0,0,0,0,0
Cech,0,0,32,2018-09-02T12:30:00Z,False,0,4,90,1,3,3,0,2,1,1,1,-1
Cech,0,0,45,2018-09-15T14:00:00Z,False,0,14,90,2,6,3,3,1,0,1,5,3
Cech,0,0,50,2018-09-23T15:00:00Z,True,0,7,90,11,9,3,6,6,4,2,3,1
Cech,0,0,60,2018-09-29T14:00:00Z,True,0,17,45,1,12,6,6,13,9,4,-1,2
Cech,0,0,73,2018-10-07T11:00:00Z,False,0,8,0,0,15,9,6,5,4,1,10,2
Cech,0,0,80,2018-10-22T19:00:00Z,True,0,10,0,0,18,9,9,12,6,6,6,3
Cech,0,0,92,2018-10-28T13:30:00Z,False,0,6,0,0,21,12,9,7,1,6,14,8
Cech,0,0,100,2018-11-03T17:30:00Z,True,0,11,0,0,22,12,10,26,13,13,-4,-1
Cech,0,0,110,2018-11-11T16:30:00Z,True,0,19,0,0,23,13,10,15,8,7,8,6
Cech,0,0,120,2018-11-25T13:30:00Z,False,0,1,0,0,24,14,10,20,11,9,4,-1
Cech,0,0,130,2018-12-02T14:05:00Z,True,0,16,0,0,27,14,13,30,9,21,-3,-7
Cech,0,0,144,2018-12-05T20:00:00Z,False,0,13,0,0,30,17,13,22,11,11,8,2
Cech,0,0,150,2018-12-08T15:00:00Z,True,0,9,0,0,31,17,14,10,5,5,21,12
Cech,0,0,166,2018-12-16T13:30:00Z,False,0,15,0,0,34,20,14,9,5,4,25,9
Cech,0,0,170,2018-12-22T12:30:00Z,True,0,3,0,0,34,20,14,12,7,5,22,15
Cech,0,0,180,2018-12-26T17:15:00Z,False,0,2,0,0,37,23,14,21,14,7,16,0
Cech,0,0,195,2018-12-29T17:30:00Z,False,0,11,0,0,38,23,15,51,25,26,-13,-10
Cech,0,0,200,2019-01-01T15:00:00Z,True,0,8,0,0,38,23,15,14,12,2,24,21
Cech,0,0,219,2019-01-12T12:30:00Z,False,0,18,0,0,41,26,15,28,14,14,13,1
Cech,0,0,220,2019-01-19T17:30:00Z,True,0,5,0,0,41,26,15,47,25,22,-6,4
Cech,0,0,230,2019-01-29T19:45:00Z,True,0,4,0,0,44,29,15,19,14,5,25,24
Cech,0,0,247,2019-02-03T16:30:00Z,False,0,12,0,0,47,32,15,56,33,23,-9,-18
Cech,0,0,253,2019-02-09T15:00:00Z,False,0,9,0,0,47,32,15,11,5,6,36,10
Cech,0,0,260,2019-02-24T14:05:00Z,True,0,15,0,0,50,32,18,24,12,12,26,20
Cech,0,0,270,2019-02-27T19:45:00Z,True,0,1,0,0,53,35,18,34,25,9,19,26
Cech,0,0,286,2019-03-02T12:30:00Z,False,0,16,0,0,56,38,18,60,27,33,-4,-9
Cech,0,0,290,2019-03-10T16:30:00Z,True,0,13,0,0,57,38,19,58,29,29,-1,9
Cech,0,0,310,2019-04-01T19:00:00Z,True,0,14,0,0,60,41,19,35,22,13,25,28
Cech,0,0,322,2019-04-07T13:05:00Z,False,0,7,0,0,63,44,19,43,25,18,20,-6
Cech,0,0,339,2019-04-15T19:00:00Z,False,0,17,0,0,63,44,19,46,26,20,17,-7
Cech,0,0,340,2019-04-21T15:00:00Z,True,0,6,0,0,66,44,22,39,16,23,27,21
Cech,0,0,309,2019-04-24T18:45:00Z,False,0,19,0,0,66,44,22,48,28,20,18,-6
Cech,0,0,354,2019-04-28T11:00:00Z,False,0,10,0,0,66,44,22,48,23,25,18,-1
Cech,0,0,360,2019-05-05T15:30:00Z,True,0,2,0,0,66,44,22,35,23,12,31,32
Cech,0,0,371,2019-05-12T14:00:00Z,False,0,3,0,0,67,45,22,40,23,17,27,-1
Leno,1,0,0,2018-08-12T15:00:00Z,True,0,12,0,0,0,0,0,0,0,0,0,0
Leno,1,0,13,2018-08-18T16:30:00Z,False,0,5,0,0,0,0,0,3,0,3,-3,0
Leno,1,0,20,2018-08-25T14:00:00Z,True,0,18,0,0,0,0,0,0,0,0,0,0
Leno,1,0,32,2018-09-02T12:30:00Z,False,0,4,0,0,3,3,0,2,1,1,1,-1
Leno,1,0,45,2018-09-15T14:00:00Z,False,0,14,0,0,6,3,3,1,0,1,5,3
Leno,1,0,50,2018-09-23T15:00:00Z,True,0,7,0,0,9,3,6,6,4,2,3,1
Leno,1,0,60,2018-09-29T14:00:00Z,True,0,17,45,2,12,6,6,13,9,4,-1,2
Leno,1,0,73,2018-10-07T11:00:00Z,False,0,8,90,3,15,9,6,5,4,1,10,2
Leno,1,0,80,2018-10-22T19:00:00Z,True,0,10,90,2,18,9,9,12,6,6,6,3
Leno,1,0,92,2018-10-28T13:30:00Z,False,0,6,90,1,21,12,9,7,1,6,14,8
Leno,1,0,100,2018-11-03T17:30:00Z,True,0,11,90,3,22,12,10,26,13,13,-4,-1
Leno,1,0,110,2018-11-11T16:30:00Z,True,0,19,90,4,23,13,10,15,8,7,8,6
Leno,1,0,120,2018-11-25T13:30:00Z,False,0,1,90,3,24,14,10,20,11,9,4,-1
Leno,1,0,130,2018-12-02T14:05:00Z,True,0,16,90,2,27,14,13,30,9,21,-3,-7
Leno,1,0,144,2018-12-05T20:00:00Z,False,0,13,90,2,30,17,13,22,11,11,8,2
Leno,1,0,150,2018-12-08T15:00:00Z,True,0,9,90,7,31,17,14,10,5,5,21,12
Leno,1,0,166,2018-12-16T13:30:00Z,False,0,15,90,2,34,20,14,9,5,4,25,9
Leno,1,0,170,2018-12-22T12:30:00Z,True,0,3,90,2,34,20,14,12,7,5,22,15
Leno,1,0,180,2018-12-26T17:15:00Z,False,0,2,90,2,37,23,14,21,14,7,16,0
Leno,1,0,195,2018-12-29T17:30:00Z,False,0,11,90,1,38,23,15,51,25,26,-13,-10
Leno,1,0,200,2019-01-01T15:00:00Z,True,0,8,90,3,38,23,15,14,12,2,24,21
Leno,1,0,219,2019-01-12T12:30:00Z,False,0,18,90,2,41,26,15,28,14,14,13,1
Leno,1,0,220,2019-01-19T17:30:00Z,True,0,5,90,6,41,26,15,47,25,22,-6,4
Leno,1,0,230,2019-01-29T19:45:00Z,True,0,4,90,2,44,29,15,19,14,5,25,24
Leno,1,0,247,2019-02-03T16:30:00Z,False,0,12,90,5,47,32,15,56,33,23,-9,-18
Leno,1,0,253,2019-02-09T15:00:00Z,False,0,9,90,3,47,32,15,11,5,6,36,10
Leno,1,0,260,2019-02-24T14:05:00Z,True,0,15,90,7,50,32,18,24,12,12,26,20
Leno,1,0,270,2019-02-27T19:45:00Z,True,0,1,90,3,53,35,18,34,25,9,19,26
Leno,1,0,286,2019-03-02T12:30:00Z,False,0,16,90,2,56,38,18,60,27,33,-4,-9
Leno,1,0,290,2019-03-10T16:30:00Z,True,0,13,90,9,57,38,19,58,29,29,-1,9
Leno,1,0,310,2019-04-01T19:00:00Z,True,0,14,90,6,60,41,19,35,22,13,25,28
Leno,1,0,322,2019-04-07T13:05:00Z,False,0,7,90,3,63,44,19,43,25,18,20,-6
Leno,1,0,339,2019-04-15T19:00:00Z,False,0,17,90,6,63,44,19,46,26,20,17,-7
Leno,1,0,340,2019-04-21T15:00:00Z,True,0,6,90,2,66,44,22,39,16,23,27,21
Leno,1,0,309,2019-04-24T18:45:00Z,False,0,19,90,1,66,44,22,48,28,20,18,-6
Leno,1,0,354,2019-04-28T11:00:00Z,False,0,10,90,4,66,44,22,48,23,25,18,-1
Leno,1,0,360,2019-05-05T15:30:00Z,True,0,2,90,3,66,44,22,35,23,12,31,32
Leno,1,0,371,2019-05-12T14:00:00Z,False,0,3,90,3,67,45,22,40,23,17,27,-1
Koscielny,2,1,0,2018-08-12T15:00:00Z,True,0,12,0,0,0,0,0,0,0,0,0,0
Koscielny,2,1,13,2018-08-18T16:30:00Z,False,0,5,0,0,0,0,0,3,0,3,-3,0
Koscielny,2,1,20,2018-08-25T14:00:00Z,True,0,18,0,0,0,0,0,0,0,0,0,0
Koscielny,2,1,32,2018-09-02T12:30:00Z,False,0,4,0,0,3,3,0,2,1,1,1,-1
Koscielny,2,1,45,2018-09-15T14:00:00Z,False,0,14,0,0,6,3,3,1,0,1,5,3
Koscielny,2,1,50,2018-09-23T15:00:00Z,True,0,7,0,0,9,3,6,6,4,2,3,1
Koscielny,2,1,60,2018-09-29T14:00:00Z,True,0,17,0,0,12,6,6,13,9,4,-1,2
Koscielny,2,1,73,2018-10-07T11:00:00Z,False,0,8,0,0,15,9,6,5,4,1,10,2
Koscielny,2,1,80,2018-10-22T19:00:00Z,True,0,10,0,0,18,9,9,12,6,6,6,3
Koscielny,2,1,92,2018-10-28T13:30:00Z,False,0,6,0,0,21,12,9,7,1,6,14,8
Koscielny,2,1,100,2018-11-03T17:30:00Z,True,0,11,0,0,22,12,10,26,13,13,-4,-1
Koscielny,2,1,110,2018-11-11T16:30:00Z,True,0,19,0,0,23,13,10,15,8,7,8,6
Koscielny,2,1,120,2018-11-25T13:30:00Z,False,0,1,0,0,24,14,10,20,11,9,4,-1
Koscielny,2,1,130,2018-12-02T14:05:00Z,True,0,16,0,0,27,14,13,30,9,21,-3,-7
Koscielny,2,1,144,2018-12-05T20:00:00Z,False,0,13,0,0,30,17,13,22,11,11,8,2
Koscielny,2,1,150,2018-12-08T15:00:00Z,True,0,9,0,0,31,17,14,10,5,5,21,12
Koscielny,2,1,166,2018-12-16T13:30:00Z,False,0,15,90,0,34,20,14,9,5,4,25,9
Koscielny,2,1,170,2018-12-22T12:30:00Z,True,0,3,0,0,34,20,14,12,7,5,22,15
Koscielny,2,1,180,2018-12-26T17:15:00Z,False,0,2,69,2,37,23,14,21,14,7,16,0
Koscielny,2,1,195,2018-12-29T17:30:00Z,False,0,11,45,1,38,23,15,51,25,26,-13,-10
Koscielny,2,1,200,2019-01-01T15:00:00Z,True,0,8,90,2,38,23,15,14,12,2,24,21
Koscielny,2,1,219,2019-01-12T12:30:00Z,False,0,18,90,2,41,26,15,28,14,14,13,1
Koscielny,2,1,220,2019-01-19T17:30:00Z,True,0,5,90,15,41,26,15,47,25,22,-6,4
Koscielny,2,1,230,2019-01-29T19:45:00Z,True,0,4,0,0,44,29,15,19,14,5,25,24
Koscielny,2,1,247,2019-02-03T16:30:00Z,False,0,12,90,7,47,32,15,56,33,23,-9,-18
Koscielny,2,1,253,2019-02-09T15:00:00Z,False,0,9,90,3,47,32,15,11,5,6,36,10
Koscielny,2,1,260,2019-02-24T14:05:00Z,True,0,15,34,1,50,32,18,24,12,12,26,20
Koscielny,2,1,270,2019-02-27T19:45:00Z,True,0,1,90,9,53,35,18,34,25,9,19,26
Koscielny,2,1,286,2019-03-02T12:30:00Z,False,0,16,90,2,56,38,18,60,27,33,-4,-9
Koscielny,2,1,290,2019-03-10T16:30:00Z,True,0,13,90,6,57,38,19,58,29,29,-1,9
Koscielny,2,1,310,2019-04-01T19:00:00Z,True,0,14,0,0,60,41,19,35,22,13,25,28
Koscielny,2,1,322,2019-04-07T13:05:00Z,False,0,7,0,0,63,44,19,43,25,18,20,-6
Koscielny,2,1,339,2019-04-15T19:00:00Z,False,0,17,90,9,63,44,19,46,26,20,17,-7
Koscielny,2,1,340,2019-04-21T15:00:00Z,True,0,6,90,1,66,44,22,39,16,23,27,21
Koscielny,2,1,309,2019-04-24T18:45:00Z,False,0,19,90,1,66,44,22,48,28,20,18,-6
Koscielny,2,1,354,2019-04-28T11:00:00Z,False,0,10,45,0,66,44,22,48,23,25,18,-1
Koscielny,2,1,360,2019-05-05T15:30:00Z,True,0,2,0,0,66,44,22,35,23,12,31,32
Koscielny,2,1,371,2019-05-12T14:00:00Z,False,0,3,56,1,67,45,22,40,23,17,27,-1
Bellerin,3,1,0,2018-08-12T15:00:00Z,True,0,12,90,1,0,0,0,0,0,0,0,0
Bellerin,3,1,13,2018-08-18T16:30:00Z,False,0,5,90,1,0,0,0,3,0,3,-3,0
Bellerin,3,1,20,2018-08-25T14:00:00Z,True,0,18,90,5,0,0,0,0,0,0,0,0
Bellerin,3,1,32,2018-09-02T12:30:00Z,False,0,4,90,0,3,3,0,2,1,1,1,-1
Bellerin,3,1,45,2018-09-15T14:00:00Z,False,0,14,90,2,6,3,3,1,0,1,5,3
Bellerin,3,1,50,2018-09-23T15:00:00Z,True,0,7,90,6,9,3,6,6,4,2,3,1
Bellerin,3,1,60,2018-09-29T14:00:00Z,True,0,17,90,8,12,6,6,13,9,4,-1,2
Bellerin,3,1,73,2018-10-07T11:00:00Z,False,0,8,90,5,15,9,6,5,4,1,10,2
Bellerin,3,1,80,2018-10-22T19:00:00Z,True,0,10,90,7,18,9,9,12,6,6,6,3
Bellerin,3,1,92,2018-10-28T13:30:00Z,False,0,6,45,1,21,12,9,7,1,6,14,8
Bellerin,3,1,100,2018-11-03T17:30:00Z,True,0,11,90,2,22,12,10,26,13,13,-4,-1
Bellerin,3,1,110,2018-11-11T16:30:00Z,True,0,19,90,1,23,13,10,15,8,7,8,6
Bellerin,3,1,120,2018-11-25T13:30:00Z,False,0,1,90,2,24,14,10,20,11,9,4,-1
Bellerin,3,1,130,2018-12-02T14:05:00Z,True,0,16,90,1,27,14,13,30,9,21,-3,-7
Bellerin,3,1,144,2018-12-05T20:00:00Z,False,0,13,90,0,30,17,13,22,11,11,8,2
Bellerin,3,1,150,2018-12-08T15:00:00Z,True,0,9,90,6,31,17,14,10,5,5,21,12
Bellerin,3,1,166,2018-12-16T13:30:00Z,False,0,15,45,0,34,20,14,9,5,4,25,9
Bellerin,3,1,170,2018-12-22T12:30:00Z,True,0,3,0,0,34,20,14,12,7,5,22,15
Bellerin,3,1,180,2018-12-26T17:15:00Z,False,0,2,0,0,37,23,14,21,14,7,16,0
Bellerin,3,1,195,2018-12-29T17:30:00Z,False,0,11,0,0,38,23,15,51,25,26,-13,-10
Bellerin,3,1,200,2019-01-01T15:00:00Z,True,0,8,0,0,38,23,15,14,12,2,24,21
Bellerin,3,1,219,2019-01-12T12:30:00Z,False,0,18,21,1,41,26,15,28,14,14,13,1
Bellerin,3,1,220,2019-01-19T17:30:00Z,True,0,5,71,11,41,26,15,47,25,22,-6,4
Bellerin,3,1,230,2019-01-29T19:45:00Z,True,0,4,0,0,44,29,15,19,14,5,25,24
Bellerin,3,1,247,2019-02-03T16:30:00Z,False,0,12,0,0,47,32,15,56,33,23,-9,-18
Bellerin,3,1,253,2019-02-09T15:00:00Z,False,0,9,0,0,47,32,15,11,5,6,36,10
Bellerin,3,1,260,2019-02-24T14:05:00Z,True,0,15,0,0,50,32,18,24,12,12,26,20
Bellerin,3,1,270,2019-02-27T19:45:00Z,True,0,1,0,0,53,35,18,34,25,9,19,26
Bellerin,3,1,286,2019-03-02T12:30:00Z,False,0,16,0,0,56,38,18,60,27,33,-4,-9
Bellerin,3,1,290,2019-03-10T16:30:00Z,True,0,13,0,0,57,38,19,58,29,29,-1,9
Bellerin,3,1,310,2019-04-01T19:00:00Z,True,0,14,0,0,60,41,19,35,22,13,25,28
Bellerin,3,1,322,2019-04-07T13:05:00Z,False,0,7,0,0,63,44,19,43,25,18,20,-6
Bellerin,3,1,339,2019-04-15T19:00:00Z,False,0,17,0,0,63,44,19,46,26,20,17,-7
Bellerin,3,1,340,2019-04-21T15:00:00Z,True,0,6,0,0,66,44,22,39,16,23,27,21
Bellerin,3,1,309,2019-04-24T18:45:00Z,False,0,19,0,0,66,44,22,48,28,20,18,-6
Bellerin,3,1,354,2019-04-28T11:00:00Z,False,0,10,0,0,66,44,22,48,23,25,18,-1
Bellerin,3,1,360,2019-05-05T15:30:00Z,True,0,2,0,0,66,44,22,35,23,12,31,32
Bellerin,3,1,371,2019-05-12T14:00:00Z,False,0,3,0,0,67,45,22,40,23,17,27,-1
Monreal,4,1,0,2018-08-12T15:00:00Z,True,0,12,0,0,0,0,0,0,0,0,0,0
Monreal,4,1,13,2018-08-18T16:30:00Z,False,0,5,90,1,0,0,0,3,0,3,-3,0
Monreal,4,1,20,2018-08-25T14:00:00Z,True,0,18,90,10,0,0,0,0,0,0,0,0
Monreal,4,1,32,2018-09-02T12:30:00Z,False,0,4,90,0,3,3,0,2,1,1,1,-1
Monreal,4,1,45,2018-09-15T14:00:00Z,False,0,14,90,2,6,3,3,1,0,1,5,3
Monreal,4,1,50,2018-09-23T15:00:00Z,True,0,7,90,6,9,3,6,6,4,2,3,1
Monreal,4,1,60,2018-09-29T14:00:00Z,True,0,17,90,6,12,6,6,13,9,4,-1,2
Monreal,4,1,73,2018-10-07T11:00:00Z,False,0,8,90,5,15,9,6,5,4,1,10,2
Monreal,4,1,80,2018-10-22T19:00:00Z,True,0,10,0,0,18,9,9,12,6,6,6,3
Monreal,4,1,92,2018-10-28T13:30:00Z,False,0,6,0,0,21,12,9,7,1,6,14,8
Monreal,4,1,100,2018-11-03T17:30:00Z,True,0,11,0,0,22,12,10,26,13,13,-4,-1
Monreal,4,1,110,2018-11-11T16:30:00Z,True,0,19,0,0,23,13,10,15,8,7,8,6
Monreal,4,1,120,2018-11-25T13:30:00Z,False,0,1,0,0,24,14,10,20,11,9,4,-1
Monreal,4,1,130,2018-12-02T14:05:00Z,True,0,16,0,0,27,14,13,30,9,21,-3,-7
Monreal,4,1,144,2018-12-05T20:00:00Z,False,0,13,0,0,30,17,13,22,11,11,8,2
Monreal,4,1,150,2018-12-08T15:00:00Z,True,0,9,24,1,31,17,14,10,5,5,21,12
Monreal,4,1,166,2018-12-16T13:30:00Z,False,0,15,90,5,34,20,14,9,5,4,25,9
Monreal,4,1,170,2018-12-22T12:30:00Z,True,0,3,36,1,34,20,14,12,7,5,22,15
Monreal,4,1,180,2018-12-26T17:15:00Z,False,0,2,0,0,37,23,14,21,14,7,16,0
Monreal,4,1,195,2018-12-29T17:30:00Z,False,0,11,0,0,38,23,15,51,25,26,-13,-10
Monreal,4,1,200,2019-01-01T15:00:00Z,True,0,8,0,0,38,23,15,14,12,2,24,21
Monreal,4,1,219,2019-01-12T12:30:00Z,False,0,18,0,0,41,26,15,28,14,14,13,1
Monreal,4,1,220,2019-01-19T17:30:00Z,True,0,5,0,0,41,26,15,47,25,22,-6,4
Monreal,4,1,230,2019-01-29T19:45:00Z,True,0,4,90,1,44,29,15,19,14,5,25,24
Monreal,4,1,247,2019-02-03T16:30:00Z,False,0,12,90,5,47,32,15,56,33,23,-9,-18
Monreal,4,1,253,2019-02-09T15:00:00Z,False,0,9,90,2,47,32,15,11,5,6,36,10
Monreal,4,1,260,2019-02-24T14:05:00Z,True,0,15,0,0,50,32,18,24,12,12,26,20
Monreal,4,1,270,2019-02-27T19:45:00Z,True,0,1,90,2,53,35,18,34,25,9,19,26
Monreal,4,1,286,2019-03-02T12:30:00Z,False,0,16,90,2,56,38,18,60,27,33,-4,-9
Monreal,4,1,290,2019-03-10T16:30:00Z,True,0,13,90,6,57,38,19,58,29,29,-1,9
Monreal,4,1,310,2019-04-01T19:00:00Z,True,0,14,90,5,60,41,19,35,22,13,25,28
Monreal,4,1,322,2019-04-07T13:05:00Z,False,0,7,90,1,63,44,19,43,25,18,20,-6
Monreal,4,1,339,2019-04-15T19:00:00Z,False,0,17,90,8,63,44,19,46,26,20,17,-7
Monreal,4,1,340,2019-04-21T15:00:00Z,True,0,6,0,0,66,44,22,39,16,23,27,21
Monreal,4,1,309,2019-04-24T18:45:00Z,False,0,19,90,0,66,44,22,48,28,20,18,-6
Monreal,4,1,354,2019-04-28T11:00:00Z,False,0,10,0,0,66,44,22,48,23,25,18,-1
Monreal,4,1,360,2019-05-05T15:30:00Z,True,0,2,90,6,66,44,22,35,23,12,31,32
Monreal,4,1,371,2019-05-12T14:00:00Z,False,0,3,90,2,67,45,22,40,23,17,27,-1
Holding,5,1,0,2018-08-12T15:00:00Z,True,0,12,0,0,0,0,0,0,0,0,0,0
Holding,5,1,13,2018-08-18T16:30:00Z,False,0,5,0,0,0,0,0,3,0,3,-3,0
Holding,5,1,20,2018-08-25T14:00:00Z,True,0,18,0,0,0,0,0,0,0,0,0,0
Holding,5,1,32,2018-09-02T12:30:00Z,False,0,4,0,0,3,3,0,2,1,1,1,-1
Holding,5,1,45,2018-09-15T14:00:00Z,False,0,14,0,0,6,3,3,1,0,1,5,3
Holding,5,1,50,2018-09-23T15:00:00Z,True,0,7,51,1,9,3,6,6,4,2,3,1
Holding,5,1,60,2018-09-29T14:00:00Z,True,0,17,90,9,12,6,6,13,9,4,-1,2
Holding,5,1,73,2018-10-07T11:00:00Z,False,0,8,90,2,15,9,6,5,4,1,10,2
Holding,5,1,80,2018-10-22T19:00:00Z,True,0,10,90,1,18,9,9,12,6,6,6,3
Holding,5,1,92,2018-10-28T13:30:00Z,False,0,6,90,1,21,12,9,7,1,6,14,8
Holding,5,1,100,2018-11-03T17:30:00Z,True,0,11,90,4,22,12,10,26,13,13,-4,-1
Holding,5,1,110,2018-11-11T16:30:00Z,True,0,19,90,2,23,13,10,15,8,7,8,6
Holding,5,1,120,2018-11-25T13:30:00Z,False,0,1,90,2,24,14,10,20,11,9,4,-1
Holding,5,1,130,2018-12-02T14:05:00Z,True,0,16,90,1,27,14,13,30,9,21,-3,-7
Holding,5,1,144,2018-12-05T20:00:00Z,False,0,13,35,1,30,17,13,22,11,11,8,2
Holding,5,1,150,2018-12-08T15:00:00Z,True,0,9,0,0,31,17,14,10,5,5,21,12
Holding,5,1,166,2018-12-16T13:30:00Z,False,0,15,0,0,34,20,14,9,5,4,25,9
Holding,5,1,170,2018-12-22T12:30:00Z,True,0,3,0,0,34,20,14,12,7,5,22,15
Holding,5,1,180,2018-12-26T17:15:00Z,False,0,2,0,0,37,23,14,21,14,7,16,0
Holding,5,1,195,2018-12-29T17:30:00Z,False,0,11,0,0,38,23,15,51,25,26,-13,-10
Holding,5,1,200,2019-01-01T15:00:00Z,True,0,8,0,0,38,23,15,14,12,2,24,21
Holding,5,1,219,2019-01-12T12:30:00Z,False,0,18,0,0,41,26,15,28,14,14,13,1
Holding,5,1,220,2019-01-19T17:30:00Z,True,0,5,0,0,41,26,15,47,25,22,-6,4
Holding,5,1,230,2019-01-29T19:45:00Z,True,0,4,0,0,44,29,15,19,14,5,25,24
Holding,5,1,247,2019-02-03T16:30:00Z,False,0,12,0,0,47,32,15,56,33,23,-9,-18
Holding,5,1,253,2019-02-09T15:00:00Z,False,0,9,0,0,47,32,15,11,5,6,36,10
Holding,5,1,260,2019-02-24T14:05:00Z,True,0,15,0,0,50,32,18,24,12,12,26,20
Holding,5,1,270,2019-02-27T19:45:00Z,True,0,1,0,0,53,35,18,34,25,9,19,26
Holding,5,1,286,2019-03-02T12:30:00Z,False,0,16,0,0,56,38,18,60,27,33,-4,-9
Holding,5,1,290,2019-03-10T16:30:00Z,True,0,13,0,0,57,38,19,58,29,29,-1,9
Holding,5,1,310,2019-04-01T19:00:00Z,True,0,14,0,0,60,41,19,35,22,13,25,28
Holding,5,1,322,2019-04-07T13:05:00Z,False,0,7,0,0,63,44,19,43,25,18,20,-6
Holding,5,1,339,2019-04-15T19:00:00Z,False,0,17,0,0,63,44,19,46,26,20,17,-7
Holding,5,1,340,2019-04-21T15:00:00Z,True,0,6,0,0,66,44,22,39,16,23,27,21
Holding,5,1,309,2019-04-24T18:45:00Z,False,0,19,0,0,66,44,22,48,28,20,18,-6
Holding,5,1,354,2019-04-28T11:00:00Z,False,0,10,0,0,66,44,22,48,23,25,18,-1
Holding,5,1,360,2019-05-05T15:30:00Z,True,0,2,0,0,66,44,22,35,23,12,31,32
Holding,5,1,371,2019-05-12T14:00:00Z,False,0,3,0,0,67,45,22,40,23,17,27,-1
Mustafi,6,1,0,2018-08-12T15:00:00Z,True,0,12,90,1,0,0,0,0,0,0,0,0
Mustafi,6,1,13,2018-08-18T16:30:00Z,False,0,5,90,0,0,0,0,3,0,3,-3,0
Mustafi,6,1,20,2018-08-25T14:00:00Z,True,0,18,90,2,0,0,0,0,0,0,0,0
Mustafi,6,1,32,2018-09-02T12:30:00Z,False,0,4,90,8,3,3,0,2,1,1,1,-1
Mustafi,6,1,45,2018-09-15T14:00:00Z,False,0,14,90,2,6,3,3,1,0,1,5,3
Mustafi,6,1,50,2018-09-23T15:00:00Z,True,0,7,90,6,9,3,6,6,4,2,3,1
Mustafi,6,1,60,2018-09-29T14:00:00Z,True,0,17,90,5,12,6,6,13,9,4,-1,2
Mustafi,6,1,73,2018-10-07T11:00:00Z,False,0,8,90,2,15,9,6,5,4,1,10,2
Mustafi,6,1,80,2018-10-22T19:00:00Z,True,0,10,90,2,18,9,9,12,6,6,6,3
Mustafi,6,1,92,2018-10-28T13:30:00Z,False,0,6,90,1,21,12,9,7,1,6,14,8
Mustafi,6,1,100,2018-11-03T17:30:00Z,True,0,11,90,2,22,12,10,26,13,13,-4,-1
Mustafi,6,1,110,2018-11-11T16:30:00Z,True,0,19,90,2,23,13,10,15,8,7,8,6
Mustafi,6,1,120,2018-11-25T13:30:00Z,False,0,1,90,2,24,14,10,20,11,9,4,-1
Mustafi,6,1,130,2018-12-02T14:05:00Z,True,0,16,70,0,27,14,13,30,9,21,-3,-7
Mustafi,6,1,144,2018-12-05T20:00:00Z,False,0,13,90,7,30,17,13,22,11,11,8,2
Mustafi,6,1,150,2018-12-08T15:00:00Z,True,0,9,65,5,31,17,14,10,5,5,21,12
Mustafi,6,1,166,2018-12-16T13:30:00Z,False,0,15,0,0,34,20,14,9,5,4,25,9
Mustafi,6,1,170,2018-12-22T12:30:00Z,True,0,3,0,0,34,20,14,12,7,5,22,15
Mustafi,6,1,180,2018-12-26T17:15:00Z,False,0,2,0,0,37,23,14,21,14,7,16,0
Mustafi,6,1,195,2018-12-29T17:30:00Z,False,0,11,45,-1,38,23,15,51,25,26,-13,-10
Mustafi,6,1,200,2019-01-01T15:00:00Z,True,0,8,45,1,38,23,15,14,12,2,24,21
Mustafi,6,1,219,2019-01-12T12:30:00Z,False,0,18,58,0,41,26,15,28,14,14,13,1
Mustafi,6,1,220,2019-01-19T17:30:00Z,True,0,5,0,0,41,26,15,47,25,22,-6,4
Mustafi,6,1,230,2019-01-29T19:45:00Z,True,0,4,90,2,44,29,15,19,14,5,25,24
Mustafi,6,1,247,2019-02-03T16:30:00Z,False,0,12,78,1,47,32,15,56,33,23,-9,-18
Mustafi,6,1,253,2019-02-09T15:00:00Z,False,0,9,90,2,47,32,15,11,5,6,36,10
Mustafi,6,1,260,2019-02-24T14:05:00Z,True,0,15,90,6,50,32,18,24,12,12,26,20
Mustafi,6,1,270,2019-02-27T19:45:00Z,True,0,1,0,0,53,35,18,34,25,9,19,26
Mustafi,6,1,286,2019-03-02T12:30:00Z,False,0,16,90,2,56,38,18,60,27,33,-4,-9
Mustafi,6,1,290,2019-03-10T16:30:00Z,True,0,13,0,0,57,38,19,58,29,29,-1,9
Mustafi,6,1,310,2019-04-01T19:00:00Z,True,0,14,90,8,60,41,19,35,22,13,25,28
Mustafi,6,1,322,2019-04-07T13:05:00Z,False,0,7,90,1,63,44,19,43,25,18,20,-6
Mustafi,6,1,339,2019-04-15T19:00:00Z,False,0,17,90,7,63,44,19,46,26,20,17,-7
Mustafi,6,1,340,2019-04-21T15:00:00Z,True,0,6,90,0,66,44,22,39,16,23,27,21
Mustafi,6,1,309,2019-04-24T18:45:00Z,False,0,19,0,0,66,44,22,48,28,20,18,-6
Mustafi,6,1,354,2019-04-28T11:00:00Z,False,0,10,90,1,66,44,22,48,23,25,18,-1
Mustafi,6,1,360,2019-05-05T15:30:00Z,True,0,2,90,1,66,44,22,35,23,12,31,32
Mustafi,6,1,371,2019-05-12T14:00:00Z,False,0,3,90,2,67,45,22,40,23,17,27,-1
Kolasinac,7,1,0,2018-08-12T15:00:00Z,True,0,12,0,0,0,0,0,0,0,0,0,0
Kolasinac,7,1,13,2018-08-18T16:30:00Z,False,0,5,0,0,0,0,0,3,0,3,-3,0
Kolasinac,7,1,20,2018-08-25T14:00:00Z,True,0,18,0,0,0,0,0,0,0,0,0,0
Kolasinac,7,1,32,2018-09-02T12:30:00Z,False,0,4,0,0,3,3,0,2,1,1,1,-1
Kolasinac,7,1,45,2018-09-15T14:00:00Z,False,0,14,0,0,6,3,3,1,0,1,5,3
Kolasinac,7,1,50,2018-09-23T15:00:00Z,True,0,7,0,0,9,3,6,6,4,2,3,1
Kolasinac,7,1,60,2018-09-29T14:00:00Z,True,0,17,0,0,12,6,6,13,9,4,-1,2
Kolasinac,7,1,73,2018-10-07T11:00:00Z,False,0,8,0,0,15,9,6,5,4,1,10,2
Kolasinac,7,1,80,2018-10-22T19:00:00Z,True,0,10,0,0,18,9,9,12,6,6,6,3
Kolasinac,7,1,92,2018-10-28T13:30:00Z,False,0,6,0,0,21,12,9,7,1,6,14,8
Kolasinac,7,1,100,2018-11-03T17:30:00Z,True,0,11,80,2,22,12,10,26,13,13,-4,-1
Kolasinac,7,1,110,2018-11-11T16:30:00Z,True,0,19,75,2,23,13,10,15,8,7,8,6
Kolasinac,7,1,120,2018-11-25T13:30:00Z,False,0,1,90,11,24,14,10,20,11,9,4,-1
Kolasinac,7,1,130,2018-12-02T14:05:00Z,True,0,16,90,1,27,14,13,30,9,21,-3,-7
Kolasinac,7,1,144,2018-12-05T20:00:00Z,False,0,13,90,1,30,17,13,22,11,11,8,2
Kolasinac,7,1,150,2018-12-08T15:00:00Z,True,0,9,90,8,31,17,14,10,5,5,21,12
Kolasinac,7,1,166,2018-12-16T13:30:00Z,False,0,15,0,0,34,20,14,9,5,4,25,9
Kolasinac,7,1,170,2018-12-22T12:30:00Z,True,0,3,90,6,34,20,14,12,7,5,22,15
Kolasinac,7,1,180,2018-12-26T17:15:00Z,False,0,2,90,1,37,23,14,21,14,7,16,0
Kolasinac,7,1,195,2018-12-29T17:30:00Z,False,0,11,80,0,38,23,15,51,25,26,-13,-10
Kolasinac,7,1,200,2019-01-01T15:00:00Z,True,0,8,90,7,38,23,15,14,12,2,24,21
Kolasinac,7,1,219,2019-01-12T12:30:00Z,False,0,18,90,1,41,26,15,28,14,14,13,1
Kolasinac,7,1,220,2019-01-19T17:30:00Z,True,0,5,90,6,41,26,15,47,25,22,-6,4
Kolasinac,7,1,230,2019-01-29T19:45:00Z,True,0,4,90,5,44,29,15,19,14,5,25,24
Kolasinac,7,1,247,2019-02-03T16:30:00Z,False,0,12,65,1,47,32,15,56,33,23,-9,-18
Kolasinac,7,1,253,2019-02-09T15:00:00Z,False,0,9,90,2,47,32,15,11,5,6,36,10
Kolasinac,7,1,260,2019-02-24T14:05:00Z,True,0,15,90,8,50,32,18,24,12,12,26,20
Kolasinac,7,1,270,2019-02-27T19:45:00Z,True,0,1,56,4,53,35,18,34,25,9,19,26
Kolasinac,7,1,286,2019-03-02T12:30:00Z,False,0,16,0,0,56,38,18,60,27,33,-4,-9
Kolasinac,7,1,290,2019-03-10T16:30:00Z,True,0,13,90,5,57,38,19,58,29,29,-1,9
Kolasinac,7,1,310,2019-04-01T19:00:00Z,True,0,14,90,5,60,41,19,35,22,13,25,28
Kolasinac,7,1,322,2019-04-07T13:05:00Z,False,0,7,45,1,63,44,19,43,25,18,20,-6
Kolasinac,7,1,339,2019-04-15T19:00:00Z,False,0,17,0,0,63,44,19,46,26,20,17,-7
Kolasinac,7,1,340,2019-04-21T15:00:00Z,True,0,6,90,1,66,44,22,39,16,23,27,21
Kolasinac,7,1,309,2019-04-24T18:45:00Z,False,0,19,32,1,66,44,22,48,28,20,18,-6
Kolasinac,7,1,354,2019-04-28T11:00:00Z,False,0,10,90,1,66,44,22,48,23,25,18,-1
Kolasinac,7,1,360,2019-05-05T15:30:00Z,True,0,2,13,1,66,44,22,35,23,12,31,32
Kolasinac,7,1,371,2019-05-12T14:00:00Z,False,0,3,0,0,67,45,22,40,23,17,27,-1
Chambers,8,1,2,2018-08-11T14:00:00Z,True,8,6,90,1,0,0,0,0,0,0,0,0
Chambers,8,1,18,2018-08-18T14:00:00Z,False,8,16,90,1,0,0,0,3,0,3,-3,0
Chambers,8,1,22,2018-08-26T15:00:00Z,True,8,3,18,1,0,0,0,1,0,1,-1,-1
Chambers,8,1,30,2018-09-01T14:00:00Z,False,8,2,3,1,3,3,0,3,3,0,0,-3
Chambers,8,1,44,2018-09-15T14:00:00Z,False,8,12,0,0,4,3,1,10,6,4,-6,-5
Chambers,8,1,55,2018-09-22T11:30:00Z,True,8,17,90,2,4,3,1,12,9,3,-8,0
Chambers,8,1,64,2018-09-29T14:00:00Z,False,8,7,0,0,5,4,1,6,4,2,-1,-3
Chambers,8,1,73,2018-10-07T11:00:00Z,True,8,0,0,0,5,4,1,15,9,6,-10,-2
Chambers,8,1,82,2018-10-20T14:00:00Z,False,8,4,45,-1,5,4,1,2,1,1,3,0
Chambers,8,1,93,2018-10-27T14:00:00Z,True,8,1,0,0,5,4,1,17,11,6,-12,-2
Chambers,8,1,105,2018-11-05T20:00:00Z,False,8,9,0,0,5,4,1,3,1,2,2,0
Chambers,8,1,116,2018-11-11T12:00:00Z,False,8,11,90,0,5,4,1,27,13,14,-22,-12
Chambers,8,1,124,2018-11-24T15:00:00Z,True,8,15,90,1,5,4,1,8,4,4,-3,0
Chambers,8,1,132,2018-12-02T12:00:00Z,False,8,5,90,1,8,7,1,28,15,13,-20,-14
Chambers,8,1,143,2018-12-05T19:45:00Z,True,8,10,90,2,8,7,1,21,11,10,-13,-3
Chambers,8,1,157,2018-12-08T15:00:00Z,False,8,13,0,0,9,8,1,23,12,11,-14,-11
Chambers,8,1,162,2018-12-15T17:30:00Z,True,8,18,90,1,9,8,1,21,13,8,-12,0
Chambers,8,1,177,2018-12-22T15:00:00Z,False,8,14,90,6,9,8,1,16,6,10,-7,-5
Chambers,8,1,183,2018-12-26T12:30:00Z,True,8,19,90,1,10,8,2,25,14,11,-15,-3
Chambers,8,1,193,2018-12-29T15:00:00Z,True,8,9,90,6,11,9,2,10,5,5,1,4
Chambers,8,1,200,2019-01-01T15:00:00Z,False,8,0,0,0,14,12,2,38,23,15,-24,-21
Chambers,8,1,211,2019-01-12T15:00:00Z,False,8,3,90,0,14,12,2,18,10,8,-4,-8
Chambers,8,1,222,2019-01-20T16:00:00Z,True,8,16,90,1,14,12,2,48,18,30,-34,-18
Chambers,8,1,232,2019-01-29T19:45:00Z,True,8,2,90,7,14,12,2,26,18,8,-12,4
Chambers,8,1,244,2019-02-02T15:00:00Z,False,8,6,90,1,17,15,2,23,9,14,-6,-7
Chambers,8,1,252,2019-02-09T12:30:00Z,True,8,13,90,0,17,15,2,48,25,23,-31,-8
Chambers,8,1,269,2019-02-22T19:45:00Z,False,8,18,90,1,17,15,2,33,18,15,-16,-16
Chambers,8,1,279,2019-02-27T19:45:00Z,False,8,15,90,1,17,15,2,24,12,12,-7,-10
Chambers,8,1,284,2019-03-03T14:05:00Z,True,8,5,90,6,17,15,2,53,31,22,-36,-7
Chambers,8,1,295,2019-03-09T15:00:00Z,False,8,10,90,1,17,15,2,35,17,18,-18,-15
Chambers,8,1,304,2019-03-17T14:15:00Z,True,8,11,90,1,17,15,2,73,41,32,-56,-17
Chambers,8,1,315,2019-03-30T12:30:00Z,True,8,12,90,1,17,15,2,74,45,29,-57,-14
Chambers,8,1,328,2019-04-02T18:45:00Z,False,8,17,90,-1,17,15,2,43,23,20,-26,-21
Chambers,8,1,333,2019-04-13T14:00:00Z,True,8,7,90,6,17,15,2,46,28,18,-29,-3
Chambers,8,1,341,2019-04-20T14:00:00Z,False,8,1,90,5,20,18,2,41,26,15,-21,-24
Chambers,8,1,353,2019-04-27T14:00:00Z,True,8,4,90,6,23,18,5,31,20,11,-8,7
Chambers,8,1,369,2019-05-04T14:00:00Z,False,8,19,90,1,26,21,5,54,31,23,-28,-26
Chambers,8,1,373,2019-05-12T14:00:00Z,True,8,14,90,0,26,21,5,42,25,17,-16,4
Mavropanos,9,1,0,2018-08-12T15:00:00Z,True,0,12,0,0,0,0,0,0,0,0,0,0
Mavropanos,9,1,13,2018-08-18T16:30:00Z,False,0,5,0,0,0,0,0,3,0,3,-3,0
Mavropanos,9,1,20,2018-08-25T14:00:00Z,True,0,18,0,0,0,0,0,0,0,0,0,0
Mavropanos,9,1,32,2018-09-02T12:30:00Z,False,0,4,0,0,3,3,0,2,1,1,1,-1
Mavropanos,9,1,45,2018-09-15T14:00:00Z,False,0,14,0,0,6,3,3,1,0,1,5,3
Mavropanos,9,1,50,2018-09-23T15:00:00Z,True,0,7,0,0,9,3,6,6,4,2,3,1
Mavropanos,9,1,60,2018-09-29T14:00:00Z,True,0,17,0,0,12,6,6,13,9,4,-1,2
Mavropanos,9,1,73,2018-10-07T11:00:00Z,False,0,8,0,0,15,9,6,5,4,1,10,2
Mavropanos,9,1,80,2018-10-22T19:00:00Z,True,0,10,0,0,18,9,9,12,6,6,6,3
Mavropanos,9,1,92,2018-10-28T13:30:00Z,False,0,6,0,0,21,12,9,7,1,6,14,8
Mavropanos,9,1,100,2018-11-03T17:30:00Z,True,0,11,0,0,22,12,10,26,13,13,-4,-1
Mavropanos,9,1,110,2018-11-11T16:30:00Z,True,0,19,0,0,23,13,10,15,8,7,8,6
Mavropanos,9,1,120,2018-11-25T13:30:00Z,False,0,1,0,0,24,14,10,20,11,9,4,-1
Mavropanos,9,1,130,2018-12-02T14:05:00Z,True,0,16,0,0,27,14,13,30,9,21,-3,-7
Mavropanos,9,1,144,2018-12-05T20:00:00Z,False,0,13,0,0,30,17,13,22,11,11,8,2
Mavropanos,9,1,150,2018-12-08T15:00:00Z,True,0,9,0,0,31,17,14,10,5,5,21,12
Mavropanos,9,1,166,2018-12-16T13:30:00Z,False,0,15,0,0,34,20,14,9,5,4,25,9
Mavropanos,9,1,170,2018-12-22T12:30:00Z,True,0,3,0,0,34,20,14,12,7,5,22,15
Mavropanos,9,1,180,2018-12-26T17:15:00Z,False,0,2,0,0,37,23,14,21,14,7,16,0
Mavropanos,9,1,195,2018-12-29T17:30:00Z,False,0,11,0,0,38,23,15,51,25,26,-13,-10
Mavropanos,9,1,200,2019-01-01T15:00:00Z,True,0,8,0,0,38,23,15,14,12,2,24,21
Mavropanos,9,1,219,2019-01-12T12:30:00Z,False,0,18,0,0,41,26,15,28,14,14,13,1
Mavropanos,9,1,220,2019-01-19T17:30:00Z,True,0,5,0,0,41,26,15,47,25,22,-6,4
Mavropanos,9,1,230,2019-01-29T19:45:00Z,True,0,4,0,0,44,29,15,19,14,5,25,24
Mavropanos,9,1,247,2019-02-03T16:30:00Z,False,0,12,11,1,47,32,15,56,33,23,-9,-18
Mavropanos,9,1,253,2019-02-09T15:00:00Z,False,0,9,0,0,47,32,15,11,5,6,36,10
Mavropanos,9,1,260,2019-02-24T14:05:00Z,True,0,15,0,0,50,32,18,24,12,12,26,20
Mavropanos,9,1,270,2019-02-27T19:45:00Z,True,0,1,0,0,53,35,18,34,25,9,19,26
Mavropanos,9,1,286,2019-03-02T12:30:00Z,False,0,16,0,0,56,38,18,60,27,33,-4,-9
Mavropanos,9,1,290,2019-03-10T16:30:00Z,True,0,13,0,0,57,38,19,58,29,29,-1,9
Mavropanos,9,1,310,2019-04-01T19:00:00Z,True,0,14,0,0,60,41,19,35,22,13,25,28
Mavropanos,9,1,322,2019-04-07T13:05:00Z,False,0,7,0,0,63,44,19,43,25,18,20,-6
Mavropanos,9,1,339,2019-04-15T19:00:00Z,False,0,17,58,1,63,44,19,46,26,20,17,-7
Mavropanos,9,1,340,2019-04-21T15:00:00Z,True,0,6,45,0,66,44,22,39,16,23,27,21
Mavropanos,9,1,309,2019-04-24T18:45:00Z,False,0,19,0,0,66,44,22,48,28,20,18,-6
Mavropanos,9,1,354,2019-04-28T11:00:00Z,False,0,10,0,0,66,44,22,48,23,25,18,-1
Mavropanos,9,1,360,2019-05-05T15:30:00Z,True,0,2,0,0,66,44,22,35,23,12,31,32
Mavropanos,9,1,371,2019-05-12T14:00:00Z,False,0,3,33,1,67,45,22,40,23,17,27,-1
Lichtsteiner,10,1,0,2018-08-12T15:00:00Z,True,0,12,55,1,0,0,0,0,0,0,0,0
Lichtsteiner,10,1,13,2018-08-18T16:30:00Z,False,0,5,0,0,0,0,0,3,0,3,-3,0
Lichtsteiner,10,1,20,2018-08-25T14:00:00Z,True,0,18,0,0,0,0,0,0,0,0,0,0
Lichtsteiner,10,1,32,2018-09-02T12:30:00Z,False,0,4,0,0,3,3,0,2,1,1,1,-1
Lichtsteiner,10,1,45,2018-09-15T14:00:00Z,False,0,14,0,0,6,3,3,1,0,1,5,3
Lichtsteiner,10,1,50,2018-09-23T15:00:00Z,True,0,7,0,0,9,3,6,6,4,2,3,1
Lichtsteiner,10,1,60,2018-09-29T14:00:00Z,True,0,17,0,0,12,6,6,13,9,4,-1,2
Lichtsteiner,10,1,73,2018-10-07T11:00:00Z,False,0,8,0,0,15,9,6,5,4,1,10,2
Lichtsteiner,10,1,80,2018-10-22T19:00:00Z,True,0,10,60,2,18,9,9,12,6,6,6,3
Lichtsteiner,10,1,92,2018-10-28T13:30:00Z,False,0,6,45,0,21,12,9,7,1,6,14,8
Lichtsteiner,10,1,100,2018-11-03T17:30:00Z,True,0,11,0,0,22,12,10,26,13,13,-4,-1
Lichtsteiner,10,1,110,2018-11-11T16:30:00Z,True,0,19,0,0,23,13,10,15,8,7,8,6
Lichtsteiner,10,1,120,2018-11-25T13:30:00Z,False,0,1,0,0,24,14,10,20,11,9,4,-1
Lichtsteiner,10,1,130,2018-12-02T14:05:00Z,True,0,16,0,0,27,14,13,30,9,21,-3,-7
Lichtsteiner,10,1,144,2018-12-05T20:00:00Z,False,0,13,54,1,30,17,13,22,11,11,8,2
Lichtsteiner,10,1,150,2018-12-08T15:00:00Z,True,0,9,45,0,31,17,14,10,5,5,21,12
Lichtsteiner,10,1,166,2018-12-16T13:30:00Z,False,0,15,73,1,34,20,14,9,5,4,25,9
Lichtsteiner,10,1,170,2018-12-22T12:30:00Z,True,0,3,53,1,34,20,14,12,7,5,22,15
Lichtsteiner,10,1,180,2018-12-26T17:15:00Z,False,0,2,90,2,37,23,14,21,14,7,16,0
Lichtsteiner,10,1,195,2018-12-29T17:30:00Z,False,0,11,90,0,38,23,15,51,25,26,-13,-10
Lichtsteiner,10,1,200,2019-01-01T15:00:00Z,True,0,8,0,0,38,23,15,14,12,2,24,21
Lichtsteiner,10,1,219,2019-01-12T12:30:00Z,False,0,18,0,0,41,26,15,28,14,14,13,1
Lichtsteiner,10,1,220,2019-01-19T17:30:00Z,True,0,5,0,0,41,26,15,47,25,22,-6,4
Lichtsteiner,10,1,230,2019-01-29T19:45:00Z,True,0,4,59,1,44,29,15,19,14,5,25,24
Lichtsteiner,10,1,247,2019-02-03T16:30:00Z,False,0,12,90,1,47,32,15,56,33,23,-9,-18
Lichtsteiner,10,1,253,2019-02-09T15:00:00Z,False,0,9,0,0,47,32,15,11,5,6,36,10
Lichtsteiner,10,1,260,2019-02-24T14:05:00Z,True,0,15,55,1,50,32,18,24,12,12,26,20
Lichtsteiner,10,1,270,2019-02-27T19:45:00Z,True,0,1,0,0,53,35,18,34,25,9,19,26
Lichtsteiner,10,1,286,2019-03-02T12:30:00Z,False,0,16,0,0,56,38,18,60,27,33,-4,-9
Lichtsteiner,10,1,290,2019-03-10T16:30:00Z,True,0,13,0,0,57,38,19,58,29,29,-1,9
Lichtsteiner,10,1,310,2019-04-01T19:00:00Z,True,0,14,0,0,60,41,19,35,22,13,25,28
Lichtsteiner,10,1,322,2019-04-07T13:05:00Z,False,0,7,0,0,63,44,19,43,25,18,20,-6
Lichtsteiner,10,1,339,2019-04-15T19:00:00Z,False,0,17,0,0,63,44,19,46,26,20,17,-7
Lichtsteiner,10,1,340,2019-04-21T15:00:00Z,True,0,6,0,0,66,44,22,39,16,23,27,21
Lichtsteiner,10,1,309,2019-04-24T18:45:00Z,False,0,19,0,0,66,44,22,48,28,20,18,-6
Lichtsteiner,10,1,354,2019-04-28T11:00:00Z,False,0,10,0,0,66,44,22,48,23,25,18,-1
Lichtsteiner,10,1,360,2019-05-05T15:30:00Z,True,0,2,76,1,66,44,22,35,23,12,31,32
Lichtsteiner,10,1,371,2019-05-12T14:00:00Z,False,0,3,90,2,67,45,22,40,23,17,27,-1
Sokratis,11,1,0,2018-08-12T15:00:00Z,True,0,12,90,0,0,0,0,0,0,0,0,0
Sokratis,11,1,13,2018-08-18T16:30:00Z,False,0,5,90,1,0,0,0,3,0,3,-3,0
Sokratis,11,1,20,2018-08-25T14:00:00Z,True,0,18,90,1,0,0,0,0,0,0,0,0
Sokratis,11,1,32,2018-09-02T12:30:00Z,False,0,4,90,1,3,3,0,2,1,1,1,-1
Sokratis,11,1,45,2018-09-15T14:00:00Z,False,0,14,90,2,6,3,3,1,0,1,5,3
Sokratis,11,1,50,2018-09-23T15:00:00Z,True,0,7,38,0,9,3,6,6,4,2,3,1
Sokratis,11,1,60,2018-09-29T14:00:00Z,True,0,17,0,0,12,6,6,13,9,4,-1,2
Sokratis,11,1,73,2018-10-07T11:00:00Z,False,0,8,0,0,15,9,6,5,4,1,10,2
Sokratis,11,1,80,2018-10-22T19:00:00Z,True,0,10,0,0,18,9,9,12,6,6,6,3
Sokratis,11,1,92,2018-10-28T13:30:00Z,False,0,6,0,0,21,12,9,7,1,6,14,8
Sokratis,11,1,100,2018-11-03T17:30:00Z,True,0,11,0,0,22,12,10,26,13,13,-4,-1
Sokratis,11,1,110,2018-11-11T16:30:00Z,True,0,19,0,0,23,13,10,15,8,7,8,6
Sokratis,11,1,120,2018-11-25T13:30:00Z,False,0,1,90,1,24,14,10,20,11,9,4,-1
Sokratis,11,1,130,2018-12-02T14:05:00Z,True,0,16,90,1,27,14,13,30,9,21,-3,-7
Sokratis,11,1,144,2018-12-05T20:00:00Z,False,0,13,90,1,30,17,13,22,11,11,8,2
Sokratis,11,1,150,2018-12-08T15:00:00Z,True,0,9,90,6,31,17,14,10,5,5,21,12
Sokratis,11,1,166,2018-12-16T13:30:00Z,False,0,15,0,0,34,20,14,9,5,4,25,9
Sokratis,11,1,170,2018-12-22T12:30:00Z,True,0,3,90,1,34,20,14,12,7,5,22,15
Sokratis,11,1,180,2018-12-26T17:15:00Z,False,0,2,90,2,37,23,14,21,14,7,16,0
Sokratis,11,1,195,2018-12-29T17:30:00Z,False,0,11,90,-1,38,23,15,51,25,26,-13,-10
Sokratis,11,1,200,2019-01-01T15:00:00Z,True,0,8,90,5,38,23,15,14,12,2,24,21
Sokratis,11,1,219,2019-01-12T12:30:00Z,False,0,18,90,2,41,26,15,28,14,14,13,1
Sokratis,11,1,220,2019-01-19T17:30:00Z,True,0,5,90,11,41,26,15,47,25,22,-6,4
Sokratis,11,1,230,2019-01-29T19:45:00Z,True,0,4,0,0,44,29,15,19,14,5,25,24
Sokratis,11,1,247,2019-02-03T16:30:00Z,False,0,12,0,0,47,32,15,56,33,23,-9,-18
Sokratis,11,1,253,2019-02-09T15:00:00Z,False,0,9,0,0,47,32,15,11,5,6,36,10
Sokratis,11,1,260,2019-02-24T14:05:00Z,True,0,15,90,6,50,32,18,24,12,12,26,20
Sokratis,11,1,270,2019-02-27T19:45:00Z,True,0,1,90,1,53,35,18,34,25,9,19,26
Sokratis,11,1,286,2019-03-02T12:30:00Z,False,0,16,90,2,56,38,18,60,27,33,-4,-9
Sokratis,11,1,290,2019-03-10T16:30:00Z,True,0,13,90,5,57,38,19,58,29,29,-1,9
Sokratis,11,1,310,2019-04-01T19:00:00Z,True,0,14,90,6,60,41,19,35,22,13,25,28
Sokratis,11,1,322,2019-04-07T13:05:00Z,False,0,7,90,1,63,44,19,43,25,18,20,-6
Sokratis,11,1,339,2019-04-15T19:00:00Z,False,0,17,0,0,63,44,19,46,26,20,17,-7
Sokratis,11,1,340,2019-04-21T15:00:00Z,True,0,6,0,0,66,44,22,39,16,23,27,21
Sokratis,11,1,309,2019-04-24T18:45:00Z,False,0,19,90,8,66,44,22,48,28,20,18,-6
Sokratis,11,1,354,2019-04-28T11:00:00Z,False,0,10,90,0,66,44,22,48,23,25,18,-1
Sokratis,11,1,360,2019-05-05T15:30:00Z,True,0,2,90,1,66,44,22,35,23,12,31,32
Sokratis,11,1,371,2019-05-12T14:00:00Z,False,0,3,0,0,67,45,22,40,23,17,27,-1
Ozil,12,2,0,2018-08-12T15:00:00Z,True,0,12,90,2,0,0,0,0,0,0,0,0
Ozil,12,2,13,2018-08-18T16:30:00Z,False,0,5,67,2,0,0,0,3,0,3,-3,0
Ozil,12,2,20,2018-08-25T14:00:00Z,True,0,18,0,0,0,0,0,0,0,0,0,0
Ozil,12,2,32,2018-09-02T12:30:00Z,False,0,4,83,2,3,3,0,2,1,1,1,-1
Ozil,12,2,45,2018-09-15T14:00:00Z,False,0,14,90,10,6,3,3,1,0,1,5,3
Ozil,12,2,50,2018-09-23T15:00:00Z,True,0,7,90,3,9,3,6,6,4,2,3,1
Ozil,12,2,60,2018-09-29T14:00:00Z,True,0,17,90,10,12,6,6,13,9,4,-1,2
Ozil,12,2,73,2018-10-07T11:00:00Z,False,0,8,0,0,15,9,6,5,4,1,10,2
Ozil,12,2,80,2018-10-22T19:00:00Z,True,0,10,79,12,18,9,9,12,6,6,6,3
Ozil,12,2,92,2018-10-28T13:30:00Z,False,0,6,67,2,21,12,9,7,1,6,14,8
Ozil,12,2,100,2018-11-03T17:30:00Z,True,0,11,90,2,22,12,10,26,13,13,-4,-1
Ozil,12,2,110,2018-11-11T16:30:00Z,True,0,19,74,1,23,13,10,15,8,7,8,6
Ozil,12,2,120,2018-11-25T13:30:00Z,False,0,1,0,0,24,14,10,20,11,9,4,-1
Ozil,12,2,130,2018-12-02T14:05:00Z,True,0,16,0,0,27,14,13,30,9,21,-3,-7
Ozil,12,2,144,2018-12-05T20:00:00Z,False,0,13,0,0,30,17,13,22,11,11,8,2
Ozil,12,2,150,2018-12-08T15:00:00Z,True,0,9,0,0,31,17,14,10,5,5,21,12
Ozil,12,2,166,2018-12-16T13:30:00Z,False,0,15,20,1,34,20,14,9,5,4,25,9
Ozil,12,2,170,2018-12-22T12:30:00Z,True,0,3,90,5,34,20,14,12,7,5,22,15
Ozil,12,2,180,2018-12-26T17:15:00Z,False,0,2,45,1,37,23,14,21,14,7,16,0
Ozil,12,2,195,2018-12-29T17:30:00Z,False,0,11,0,0,38,23,15,51,25,26,-13,-10
Ozil,12,2,200,2019-01-01T15:00:00Z,True,0,8,0,0,38,23,15,14,12,2,24,21
Ozil,12,2,219,2019-01-12T12:30:00Z,False,0,18,0,0,41,26,15,28,14,14,13,1
Ozil,12,2,220,2019-01-19T17:30:00Z,True,0,5,0,0,41,26,15,47,25,22,-6,4
Ozil,12,2,230,2019-01-29T19:45:00Z,True,0,4,75,3,44,29,15,19,14,5,25,24
Ozil,12,2,247,2019-02-03T16:30:00Z,False,0,12,0,0,47,32,15,56,33,23,-9,-18
Ozil,12,2,253,2019-02-09T15:00:00Z,False,0,9,0,0,47,32,15,11,5,6,36,10
Ozil,12,2,260,2019-02-24T14:05:00Z,True,0,15,27,1,50,32,18,24,12,12,26,20
Ozil,12,2,270,2019-02-27T19:45:00Z,True,0,1,90,12,53,35,18,34,25,9,19,26
Ozil,12,2,286,2019-03-02T12:30:00Z,False,0,16,18,1,56,38,18,60,27,33,-4,-9
Ozil,12,2,290,2019-03-10T16:30:00Z,True,0,13,76,3,57,38,19,58,29,29,-1,9
Ozil,12,2,310,2019-04-01T19:00:00Z,True,0,14,83,3,60,41,19,35,22,13,25,28
Ozil,12,2,322,2019-04-07T13:05:00Z,False,0,7,73,2,63,44,19,43,25,18,20,-6
Ozil,12,2,339,2019-04-15T19:00:00Z,False,0,17,45,1,63,44,19,46,26,20,17,-7
Ozil,12,2,340,2019-04-21T15:00:00Z,True,0,6,90,6,66,44,22,39,16,23,27,21
Ozil,12,2,309,2019-04-24T18:45:00Z,False,0,19,90,2,66,44,22,48,28,20,18,-6
Ozil,12,2,354,2019-04-28T11:00:00Z,False,0,10,0,0,66,44,22,48,23,25,18,-1
Ozil,12,2,360,2019-05-05T15:30:00Z,True,0,2,90,2,66,44,22,35,23,12,31,32
Ozil,12,2,371,2019-05-12T14:00:00Z,False,0,3,0,0,67,45,22,40,23,17,27,-1
Ramsey,13,2,0,2018-08-12T15:00:00Z,True,0,12,53,1,0,0,0,0,0,0,0,0
Ramsey,13,2,13,2018-08-18T16:30:00Z,False,0,5,22,1,0,0,0,3,0,3,-3,0
Ramsey,13,2,20,2018-08-25T14:00:00Z,True,0,18,90,2,0,0,0,0,0,0,0,0
Ramsey,13,2,32,2018-09-02T12:30:00Z,False,0,4,90,2,3,3,0,2,1,1,1,-1
Ramsey,13,2,45,2018-09-15T14:00:00Z,False,0,14,79,3,6,3,3,1,0,1,5,3
Ramsey,13,2,50,2018-09-23T15:00:00Z,True,0,7,79,9,9,3,6,6,4,2,3,1
Ramsey,13,2,60,2018-09-29T14:00:00Z,True,0,17,62,3,12,6,6,13,9,4,-1,2
Ramsey,13,2,73,2018-10-07T11:00:00Z,False,0,8,23,10,15,9,6,5,4,1,10,2
Ramsey,13,2,80,2018-10-22T19:00:00Z,True,0,10,10,1,18,9,9,12,6,6,6,3
Ramsey,13,2,92,2018-10-28T13:30:00Z,False,0,6,12,1,21,12,9,7,1,6,14,8
Ramsey,13,2,100,2018-11-03T17:30:00Z,True,0,11,17,1,22,12,10,26,13,13,-4,-1
Ramsey,13,2,110,2018-11-11T16:30:00Z,True,0,19,15,4,23,13,10,15,8,7,8,6
Ramsey,13,2,120,2018-11-25T13:30:00Z,False,0,1,8,1,24,14,10,20,11,9,4,-1
Ramsey,13,2,130,2018-12-02T14:05:00Z,True,0,16,45,7,27,14,13,30,9,21,-3,-7
Ramsey,13,2,144,2018-12-05T20:00:00Z,False,0,13,45,1,30,17,13,22,11,11,8,2
Ramsey,13,2,150,2018-12-08T15:00:00Z,True,0,9,0,0,31,17,14,10,5,5,21,12
Ramsey,13,2,166,2018-12-16T13:30:00Z,False,0,15,0,0,34,20,14,9,5,4,25,9
Ramsey,13,2,170,2018-12-22T12:30:00Z,True,0,3,0,0,34,20,14,12,7,5,22,15
Ramsey,13,2,180,2018-12-26T17:15:00Z,False,0,2,28,1,37,23,14,21,14,7,16,0
Ramsey,13,2,195,2018-12-29T17:30:00Z,False,0,11,90,2,38,23,15,51,25,26,-13,-10
Ramsey,13,2,200,2019-01-01T15:00:00Z,True,0,8,15,6,38,23,15,14,12,2,24,21
Ramsey,13,2,219,2019-01-12T12:30:00Z,False,0,18,31,1,41,26,15,28,14,14,13,1
Ramsey,13,2,220,2019-01-19T17:30:00Z,True,0,5,66,3,41,26,15,47,25,22,-6,4
Ramsey,13,2,230,2019-01-29T19:45:00Z,True,0,4,14,1,44,29,15,19,14,5,25,24
Ramsey,13,2,247,2019-02-03T16:30:00Z,False,0,12,24,1,47,32,15,56,33,23,-9,-18
Ramsey,13,2,253,2019-02-09T15:00:00Z,False,0,9,0,0,47,32,15,11,5,6,36,10
Ramsey,13,2,260,2019-02-24T14:05:00Z,True,0,15,62,3,50,32,18,24,12,12,26,20
Ramsey,13,2,270,2019-02-27T19:45:00Z,True,0,1,0,0,53,35,18,34,25,9,19,26
Ramsey,13,2,286,2019-03-02T12:30:00Z,False,0,16,71,8,56,38,18,60,27,33,-4,-9
Ramsey,13,2,290,2019-03-10T16:30:00Z,True,0,13,90,3,57,38,19,58,29,29,-1,9
Ramsey,13,2,310,2019-04-01T19:00:00Z,True,0,14,66,11,60,41,19,35,22,13,25,28
Ramsey,13,2,322,2019-04-07T13:05:00Z,False,0,7,45,1,63,44,19,43,25,18,20,-6
Ramsey,13,2,339,2019-04-15T19:00:00Z,False,0,17,67,3,63,44,19,46,26,20,17,-7
Ramsey,13,2,340,2019-04-21T15:00:00Z,True,0,6,0,0,66,44,22,39,16,23,27,21
Ramsey,13,2,309,2019-04-24T18:45:00Z,False,0,19,0,0,66,44,22,48,28,20,18,-6
Ramsey,13,2,354,2019-04-28T11:00:00Z,False,0,10,0,0,66,44,22,48,23,25,18,-1
Ramsey,13,2,360,2019-05-05T15:30:00Z,True,0,2,0,0,66,44,22,35,23,12,31,32
Ramsey,13,2,371,2019-05-12T14:00:00Z,False,0,3,0,0,67,45,22,40,23,17,27,-1
Iwobi,14,2,0,2018-08-12T15:00:00Z,True,0,12,0,0,0,0,0,0,0,0,0,0
Iwobi,14,2,13,2018-08-18T16:30:00Z,False,0,5,74,7,0,0,0,3,0,3,-3,0
Iwobi,14,2,20,2018-08-25T14:00:00Z,True,0,18,45,4,0,0,0,0,0,0,0,0
Iwobi,14,2,32,2018-09-02T12:30:00Z,False,0,4,0,0,3,3,0,2,1,1,1,-1
Iwobi,14,2,45,2018-09-15T14:00:00Z,False,0,14,0,0,6,3,3,1,0,1,5,3
Iwobi,14,2,50,2018-09-23T15:00:00Z,True,0,7,21,1,9,3,6,6,4,2,3,1
Iwobi,14,2,60,2018-09-29T14:00:00Z,True,0,17,27,4,12,6,6,13,9,4,-1,2
Iwobi,14,2,73,2018-10-07T11:00:00Z,False,0,8,66,2,15,9,6,5,4,1,10,2
Iwobi,14,2,80,2018-10-22T19:00:00Z,True,0,10,90,2,18,9,9,12,6,6,6,3
Iwobi,14,2,92,2018-10-28T13:30:00Z,False,0,6,90,2,21,12,9,7,1,6,14,8
Iwobi,14,2,100,2018-11-03T17:30:00Z,True,0,11,22,4,22,12,10,26,13,13,-4,-1
Iwobi,14,2,110,2018-11-11T16:30:00Z,True,0,19,45,1,23,13,10,15,8,7,8,6
Iwobi,14,2,120,2018-11-25T13:30:00Z,False,0,1,81,2,24,14,10,20,11,9,4,-1
Iwobi,14,2,130,2018-12-02T14:05:00Z,True,0,16,45,1,27,14,13,30,9,21,-3,-7
Iwobi,14,2,144,2018-12-05T20:00:00Z,False,0,13,64,2,30,17,13,22,11,11,8,2
Iwobi,14,2,150,2018-12-08T15:00:00Z,True,0,9,45,1,31,17,14,10,5,5,21,12
Iwobi,14,2,166,2018-12-16T13:30:00Z,False,0,15,69,2,34,20,14,9,5,4,25,9
Iwobi,14,2,170,2018-12-22T12:30:00Z,True,0,3,12,6,34,20,14,12,7,5,22,15
Iwobi,14,2,180,2018-12-26T17:15:00Z,False,0,2,45,1,37,23,14,21,14,7,16,0
Iwobi,14,2,195,2018-12-29T17:30:00Z,False,0,11,90,5,38,23,15,51,25,26,-13,-10
Iwobi,14,2,200,2019-01-01T15:00:00Z,True,0,8,82,6,38,23,15,14,12,2,24,21
Iwobi,14,2,219,2019-01-12T12:30:00Z,False,0,18,90,2,41,26,15,28,14,14,13,1
Iwobi,14,2,220,2019-01-19T17:30:00Z,True,0,5,22,1,41,26,15,47,25,22,-6,4
Iwobi,14,2,230,2019-01-29T19:45:00Z,True,0,4,45,1,44,29,15,19,14,5,25,24
Iwobi,14,2,247,2019-02-03T16:30:00Z,False,0,12,65,2,47,32,15,56,33,23,-9,-18
Iwobi,14,2,253,2019-02-09T15:00:00Z,False,0,9,87,8,47,32,15,11,5,6,36,10
Iwobi,14,2,260,2019-02-24T14:05:00Z,True,0,15,74,6,50,32,18,24,12,12,26,20
Iwobi,14,2,270,2019-02-27T19:45:00Z,True,0,1,33,1,53,35,18,34,25,9,19,26
Iwobi,14,2,286,2019-03-02T12:30:00Z,False,0,16,90,2,56,38,18,60,27,33,-4,-9
Iwobi,14,2,290,2019-03-10T16:30:00Z,True,0,13,13,1,57,38,19,58,29,29,-1,9
Iwobi,14,2,310,2019-04-01T19:00:00Z,True,0,14,60,3,60,41,19,35,22,13,25,28
Iwobi,14,2,322,2019-04-07T13:05:00Z,False,0,7,16,1,63,44,19,43,25,18,20,-6
Iwobi,14,2,339,2019-04-15T19:00:00Z,False,0,17,90,3,63,44,19,46,26,20,17,-7
Iwobi,14,2,340,2019-04-21T15:00:00Z,True,0,6,45,1,66,44,22,39,16,23,27,21
Iwobi,14,2,309,2019-04-24T18:45:00Z,False,0,19,70,2,66,44,22,48,28,20,18,-6
Iwobi,14,2,354,2019-04-28T11:00:00Z,False,0,10,45,1,66,44,22,48,23,25,18,-1
Iwobi,14,2,360,2019-05-05T15:30:00Z,True,0,2,13,1,66,44,22,35,23,12,31,32
Iwobi,14,2,371,2019-05-12T14:00:00Z,False,0,3,90,10,67,45,22,40,23,17,27,-1
Elneny,15,2,0,2018-08-12T15:00:00Z,True,0,12,0,0,0,0,0,0,0,0,0,0
Elneny,15,2,13,2018-08-18T16:30:00Z,False,0,5,0,0,0,0,0,3,0,3,-3,0
Elneny,15,2,20,2018-08-25T14:00:00Z,True,0,18,0,0,0,0,0,0,0,0,0,0
Elneny,15,2,32,2018-09-02T12:30:00Z,False,0,4,0,0,3,3,0,2,1,1,1,-1
Elneny,15,2,45,2018-09-15T14:00:00Z,False,0,14,0,0,6,3,3,1,0,1,5,3
Elneny,15,2,50,2018-09-23T15:00:00Z,True,0,7,0,0,9,3,6,6,4,2,3,1
Elneny,15,2,60,2018-09-29T14:00:00Z,True,0,17,0,0,12,6,6,13,9,4,-1,2
Elneny,15,2,73,2018-10-07T11:00:00Z,False,0,8,0,0,15,9,6,5,4,1,10,2
Elneny,15,2,80,2018-10-22T19:00:00Z,True,0,10,0,0,18,9,9,12,6,6,6,3
Elneny,15,2,92,2018-10-28T13:30:00Z,False,0,6,0,0,21,12,9,7,1,6,14,8
Elneny,15,2,100,2018-11-03T17:30:00Z,True,0,11,0,0,22,12,10,26,13,13,-4,-1
Elneny,15,2,110,2018-11-11T16:30:00Z,True,0,19,0,0,23,13,10,15,8,7,8,6
Elneny,15,2,120,2018-11-25T13:30:00Z,False,0,1,0,0,24,14,10,20,11,9,4,-1
Elneny,15,2,130,2018-12-02T14:05:00Z,True,0,16,0,0,27,14,13,30,9,21,-3,-7
Elneny,15,2,144,2018-12-05T20:00:00Z,False,0,13,0,0,30,17,13,22,11,11,8,2
Elneny,15,2,150,2018-12-08T15:00:00Z,True,0,9,0,0,31,17,14,10,5,5,21,12
Elneny,15,2,166,2018-12-16T13:30:00Z,False,0,15,0,0,34,20,14,9,5,4,25,9
Elneny,15,2,170,2018-12-22T12:30:00Z,True,0,3,58,1,34,20,14,12,7,5,22,15
Elneny,15,2,180,2018-12-26T17:15:00Z,False,0,2,0,0,37,23,14,21,14,7,16,0
Elneny,15,2,195,2018-12-29T17:30:00Z,False,0,11,0,0,38,23,15,51,25,26,-13,-10
Elneny,15,2,200,2019-01-01T15:00:00Z,True,0,8,0,0,38,23,15,14,12,2,24,21
Elneny,15,2,219,2019-01-12T12:30:00Z,False,0,18,0,0,41,26,15,28,14,14,13,1
Elneny,15,2,220,2019-01-19T17:30:00Z,True,0,5,18,1,41,26,15,47,25,22,-6,4
Elneny,15,2,230,2019-01-29T19:45:00Z,True,0,4,45,1,44,29,15,19,14,5,25,24
Elneny,15,2,247,2019-02-03T16:30:00Z,False,0,12,0,0,47,32,15,56,33,23,-9,-18
Elneny,15,2,253,2019-02-09T15:00:00Z,False,0,9,31,1,47,32,15,11,5,6,36,10
Elneny,15,2,260,2019-02-24T14:05:00Z,True,0,15,0,0,50,32,18,24,12,12,26,20
Elneny,15,2,270,2019-02-27T19:45:00Z,True,0,1,0,0,53,35,18,34,25,9,19,26
Elneny,15,2,286,2019-03-02T12:30:00Z,False,0,16,0,0,56,38,18,60,27,33,-4,-9
Elneny,15,2,290,2019-03-10T16:30:00Z,True,0,13,0,0,57,38,19,58,29,29,-1,9
Elneny,15,2,310,2019-04-01T19:00:00Z,True,0,14,23,1,60,41,19,35,22,13,25,28
Elneny,15,2,322,2019-04-07T13:05:00Z,False,0,7,45,1,63,44,19,43,25,18,20,-6
Elneny,15,2,339,2019-04-15T19:00:00Z,False,0,17,0,0,63,44,19,46,26,20,17,-7
Elneny,15,2,340,2019-04-21T15:00:00Z,True,0,6,67,2,66,44,22,39,16,23,27,21
Elneny,15,2,309,2019-04-24T18:45:00Z,False,0,19,0,0,66,44,22,48,28,20,18,-6
Elneny,15,2,354,2019-04-28T11:00:00Z,False,0,10,0,0,66,44,22,48,23,25,18,-1
Elneny,15,2,360,2019-05-05T15:30:00Z,True,0,2,0,0,66,44,22,35,23,12,31,32
Elneny,15,2,371,2019-05-12T14:00:00Z,False,0,3,90,2,67,45,22,40,23,17,27,-1
Xhaka,16,2,0,2018-08-12T15:00:00Z,True,0,12,69,1,0,0,0,0,0,0,0,0
Xhaka,16,2,13,2018-08-18T16:30:00Z,False,0,5,45,0,0,0,0,3,0,3,-3,0
Xhaka,16,2,20,2018-08-25T14:00:00Z,True,0,18,90,2,0,0,0,0,0,0,0,0
Xhaka,16,2,32,2018-09-02T12:30:00Z,False,0,4,90,4,3,3,0,2,1,1,1,-1
Xhaka,16,2,45,2018-09-15T14:00:00Z,False,0,14,90,9,6,3,3,1,0,1,5,3
Xhaka,16,2,50,2018-09-23T15:00:00Z,True,0,7,90,3,9,3,6,6,4,2,3,1
Xhaka,16,2,60,2018-09-29T14:00:00Z,True,0,17,90,3,12,6,6,13,9,4,-1,2
Xhaka,16,2,73,2018-10-07T11:00:00Z,False,0,8,90,2,15,9,6,5,4,1,10,2
Xhaka,16,2,80,2018-10-22T19:00:00Z,True,0,10,90,1,18,9,9,12,6,6,6,3
Xhaka,16,2,92,2018-10-28T13:30:00Z,False,0,6,90,7,21,12,9,7,1,6,14,8
Xhaka,16,2,100,2018-11-03T17:30:00Z,True,0,11,90,2,22,12,10,26,13,13,-4,-1
Xhaka,16,2,110,2018-11-11T16:30:00Z,True,0,19,90,2,23,13,10,15,8,7,8,6
Xhaka,16,2,120,2018-11-25T13:30:00Z,False,0,1,90,2,24,14,10,20,11,9,4,-1
Xhaka,16,2,130,2018-12-02T14:05:00Z,True,0,16,90,4,27,14,13,30,9,21,-3,-7
Xhaka,16,2,144,2018-12-05T20:00:00Z,False,0,13,0,0,30,17,13,22,11,11,8,2
Xhaka,16,2,150,2018-12-08T15:00:00Z,True,0,9,90,2,31,17,14,10,5,5,21,12
Xhaka,16,2,166,2018-12-16T13:30:00Z,False,0,15,90,2,34,20,14,9,5,4,25,9
Xhaka,16,2,170,2018-12-22T12:30:00Z,True,0,3,90,2,34,20,14,12,7,5,22,15
Xhaka,16,2,180,2018-12-26T17:15:00Z,False,0,2,90,2,37,23,14,21,14,7,16,0
Xhaka,16,2,195,2018-12-29T17:30:00Z,False,0,11,90,1,38,23,15,51,25,26,-13,-10
Xhaka,16,2,200,2019-01-01T15:00:00Z,True,0,8,90,10,38,23,15,14,12,2,24,21
Xhaka,16,2,219,2019-01-12T12:30:00Z,False,0,18,58,1,41,26,15,28,14,14,13,1
Xhaka,16,2,220,2019-01-19T17:30:00Z,True,0,5,90,3,41,26,15,47,25,22,-6,4
Xhaka,16,2,230,2019-01-29T19:45:00Z,True,0,4,0,0,44,29,15,19,14,5,25,24
Xhaka,16,2,247,2019-02-03T16:30:00Z,False,0,12,0,0,47,32,15,56,33,23,-9,-18
Xhaka,16,2,253,2019-02-09T15:00:00Z,False,0,9,0,0,47,32,15,11,5,6,36,10
Xhaka,16,2,260,2019-02-24T14:05:00Z,True,0,15,90,3,50,32,18,24,12,12,26,20
Xhaka,16,2,270,2019-02-27T19:45:00Z,True,0,1,0,0,53,35,18,34,25,9,19,26
Xhaka,16,2,286,2019-03-02T12:30:00Z,False,0,16,90,1,56,38,18,60,27,33,-4,-9
Xhaka,16,2,290,2019-03-10T16:30:00Z,True,0,13,90,11,57,38,19,58,29,29,-1,9
Xhaka,16,2,310,2019-04-01T19:00:00Z,True,0,14,0,0,60,41,19,35,22,13,25,28
Xhaka,16,2,322,2019-04-07T13:05:00Z,False,0,7,0,0,63,44,19,43,25,18,20,-6
Xhaka,16,2,339,2019-04-15T19:00:00Z,False,0,17,90,3,63,44,19,46,26,20,17,-7
Xhaka,16,2,340,2019-04-21T15:00:00Z,True,0,6,0,0,66,44,22,39,16,23,27,21
Xhaka,16,2,309,2019-04-24T18:45:00Z,False,0,19,90,4,66,44,22,48,28,20,18,-6
Xhaka,16,2,354,2019-04-28T11:00:00Z,False,0,10,90,2,66,44,22,48,23,25,18,-1
Xhaka,16,2,360,2019-05-05T15:30:00Z,True,0,2,76,1,66,44,22,35,23,12,31,32
Xhaka,16,2,371,2019-05-12T14:00:00Z,False,0,3,0,0,67,45,22,40,23,17,27,-1
Mkhitaryan,17,2,0,2018-08-12T15:00:00Z,True,0,12,90,2,0,0,0,0,0,0,0,0
Mkhitaryan,17,2,13,2018-08-18T16:30:00Z,False,0,5,90,12,0,0,0,3,0,3,-3,0
Mkhitaryan,17,2,20,2018-08-25T14:00:00Z,True,0,18,90,2,0,0,0,0,0,0,0,0
Mkhitaryan,17,2,32,2018-09-02T12:30:00Z,False,0,4,1,1,3,3,0,2,1,1,1,-1
Mkhitaryan,17,2,45,2018-09-15T14:00:00Z,False,0,14,21,1,6,3,3,1,0,1,5,3
Mkhitaryan,17,2,50,2018-09-23T15:00:00Z,True,0,7,0,0,9,3,6,6,4,2,3,1
Mkhitaryan,17,2,60,2018-09-29T14:00:00Z,True,0,17,0,0,12,6,6,13,9,4,-1,2
Mkhitaryan,17,2,73,2018-10-07T11:00:00Z,False,0,8,90,2,15,9,6,5,4,1,10,2
Mkhitaryan,17,2,80,2018-10-22T19:00:00Z,True,0,10,60,2,18,9,9,12,6,6,6,3
Mkhitaryan,17,2,92,2018-10-28T13:30:00Z,False,0,6,0,0,21,12,9,7,1,6,14,8
Mkhitaryan,17,2,100,2018-11-03T17:30:00Z,True,0,11,67,2,22,12,10,26,13,13,-4,-1
Mkhitaryan,17,2,110,2018-11-11T16:30:00Z,True,0,19,14,8,23,13,10,15,8,7,8,6
Mkhitaryan,17,2,120,2018-11-25T13:30:00Z,False,0,1,90,2,24,14,10,20,11,9,4,-1
Mkhitaryan,17,2,130,2018-12-02T14:05:00Z,True,0,16,45,1,27,14,13,30,9,21,-3,-7
Mkhitaryan,17,2,144,2018-12-05T20:00:00Z,False,0,13,45,1,30,17,13,22,11,11,8,2
Mkhitaryan,17,2,150,2018-12-08T15:00:00Z,True,0,9,45,1,31,17,14,10,5,5,21,12
Mkhitaryan,17,2,166,2018-12-16T13:30:00Z,False,0,15,90,14,34,20,14,9,5,4,25,9
Mkhitaryan,17,2,170,2018-12-22T12:30:00Z,True,0,3,0,0,34,20,14,12,7,5,22,15
Mkhitaryan,17,2,180,2018-12-26T17:15:00Z,False,0,2,0,0,37,23,14,21,14,7,16,0
Mkhitaryan,17,2,195,2018-12-29T17:30:00Z,False,0,11,0,0,38,23,15,51,25,26,-13,-10
Mkhitaryan,17,2,200,2019-01-01T15:00:00Z,True,0,8,0,0,38,23,15,14,12,2,24,21
Mkhitaryan,17,2,219,2019-01-12T12:30:00Z,False,0,18,0,0,41,26,15,28,14,14,13,1
Mkhitaryan,17,2,220,2019-01-19T17:30:00Z,True,0,5,0,0,41,26,15,47,25,22,-6,4
Mkhitaryan,17,2,230,2019-01-29T19:45:00Z,True,0,4,0,0,44,29,15,19,14,5,25,24
Mkhitaryan,17,2,247,2019-02-03T16:30:00Z,False,0,12,0,0,47,32,15,56,33,23,-9,-18
Mkhitaryan,17,2,253,2019-02-09T15:00:00Z,False,0,9,75,3,47,32,15,11,5,6,36,10
Mkhitaryan,17,2,260,2019-02-24T14:05:00Z,True,0,15,90,14,50,32,18,24,12,12,26,20
Mkhitaryan,17,2,270,2019-02-27T19:45:00Z,True,0,1,63,16,53,35,18,34,25,9,19,26
Mkhitaryan,17,2,286,2019-03-02T12:30:00Z,False,0,16,90,1,56,38,18,60,27,33,-4,-9
Mkhitaryan,17,2,290,2019-03-10T16:30:00Z,True,0,13,0,0,57,38,19,58,29,29,-1,9
Mkhitaryan,17,2,310,2019-04-01T19:00:00Z,True,0,14,6,1,60,41,19,35,22,13,25,28
Mkhitaryan,17,2,322,2019-04-07T13:05:00Z,False,0,7,90,2,63,44,19,43,25,18,20,-6
Mkhitaryan,17,2,339,2019-04-15T19:00:00Z,False,0,17,90,3,63,44,19,46,26,20,17,-7
Mkhitaryan,17,2,340,2019-04-21T15:00:00Z,True,0,6,0,0,66,44,22,39,16,23,27,21
Mkhitaryan,17,2,309,2019-04-24T18:45:00Z,False,0,19,57,1,66,44,22,48,28,20,18,-6
Mkhitaryan,17,2,354,2019-04-28T11:00:00Z,False,0,10,72,2,66,44,22,48,23,25,18,-1
Mkhitaryan,17,2,360,2019-05-05T15:30:00Z,True,0,2,76,2,66,44,22,35,23,12,31,32
Mkhitaryan,17,2,371,2019-05-12T14:00:00Z,False,0,3,90,2,67,45,22,40,23,17,27,-1
Nelson,18,2,0,2018-08-12T15:00:00Z,True,0,12,0,0,0,0,0,0,0,0,0,0
Nelson,18,2,13,2018-08-18T16:30:00Z,False,0,5,0,0,0,0,0,3,0,3,-3,0
Nelson,18,2,20,2018-08-25T14:00:00Z,True,0,18,0,0,0,0,0,0,0,0,0,0
Nelson,18,2,32,2018-09-02T12:30:00Z,False,0,4,0,0,3,3,0,2,1,1,1,-1
Nelson,18,2,45,2018-09-15T14:00:00Z,False,0,14,0,0,6,3,3,1,0,1,5,3
Nelson,18,2,50,2018-09-23T15:00:00Z,True,0,7,0,0,9,3,6,6,4,2,3,1
Nelson,18,2,60,2018-09-29T14:00:00Z,True,0,17,0,0,12,6,6,13,9,4,-1,2
Nelson,18,2,73,2018-10-07T11:00:00Z,False,0,8,0,0,15,9,6,5,4,1,10,2
Nelson,18,2,80,2018-10-22T19:00:00Z,True,0,10,0,0,18,9,9,12,6,6,6,3
Nelson,18,2,92,2018-10-28T13:30:00Z,False,0,6,0,0,21,12,9,7,1,6,14,8
Nelson,18,2,100,2018-11-03T17:30:00Z,True,0,11,0,0,22,12,10,26,13,13,-4,-1
Nelson,18,2,110,2018-11-11T16:30:00Z,True,0,19,0,0,23,13,10,15,8,7,8,6
Nelson,18,2,120,2018-11-25T13:30:00Z,False,0,1,0,0,24,14,10,20,11,9,4,-1
Nelson,18,2,130,2018-12-02T14:05:00Z,True,0,16,0,0,27,14,13,30,9,21,-3,-7
Nelson,18,2,144,2018-12-05T20:00:00Z,False,0,13,0,0,30,17,13,22,11,11,8,2
Nelson,18,2,150,2018-12-08T15:00:00Z,True,0,9,0,0,31,17,14,10,5,5,21,12
Nelson,18,2,166,2018-12-16T13:30:00Z,False,0,15,0,0,34,20,14,9,5,4,25,9
Nelson,18,2,170,2018-12-22T12:30:00Z,True,0,3,0,0,34,20,14,12,7,5,22,15
Nelson,18,2,180,2018-12-26T17:15:00Z,False,0,2,0,0,37,23,14,21,14,7,16,0
Nelson,18,2,195,2018-12-29T17:30:00Z,False,0,11,0,0,38,23,15,51,25,26,-13,-10
Nelson,18,2,200,2019-01-01T15:00:00Z,True,0,8,0,0,38,23,15,14,12,2,24,21
Nelson,18,2,219,2019-01-12T12:30:00Z,False,0,18,0,0,41,26,15,28,14,14,13,1
Nelson,18,2,220,2019-01-19T17:30:00Z,True,0,5,0,0,41,26,15,47,25,22,-6,4
Nelson,18,2,230,2019-01-29T19:45:00Z,True,0,4,0,0,44,29,15,19,14,5,25,24
Nelson,18,2,247,2019-02-03T16:30:00Z,False,0,12,0,0,47,32,15,56,33,23,-9,-18
Nelson,18,2,253,2019-02-09T15:00:00Z,False,0,9,0,0,47,32,15,11,5,6,36,10
Nelson,18,2,260,2019-02-24T14:05:00Z,True,0,15,0,0,50,32,18,24,12,12,26,20
Nelson,18,2,270,2019-02-27T19:45:00Z,True,0,1,0,0,53,35,18,34,25,9,19,26
Nelson,18,2,286,2019-03-02T12:30:00Z,False,0,16,0,0,56,38,18,60,27,33,-4,-9
Nelson,18,2,290,2019-03-10T16:30:00Z,True,0,13,0,0,57,38,19,58,29,29,-1,9
Nelson,18,2,310,2019-04-01T19:00:00Z,True,0,14,0,0,60,41,19,35,22,13,25,28
Nelson,18,2,322,2019-04-07T13:05:00Z,False,0,7,0,0,63,44,19,43,25,18,20,-6
Nelson,18,2,339,2019-04-15T19:00:00Z,False,0,17,0,0,63,44,19,46,26,20,17,-7
Nelson,18,2,340,2019-04-21T15:00:00Z,True,0,6,0,0,66,44,22,39,16,23,27,21
Nelson,18,2,309,2019-04-24T18:45:00Z,False,0,19,0,0,66,44,22,48,28,20,18,-6
Nelson,18,2,354,2019-04-28T11:00:00Z,False,0,10,0,0,66,44,22,48,23,25,18,-1
Nelson,18,2,360,2019-05-05T15:30:00Z,True,0,2,0,0,66,44,22,35,23,12,31,32
Nelson,18,2,371,2019-05-12T14:00:00Z,False,0,3,0,0,67,45,22,40,23,17,27,-1
Maitland-Niles,19,2,0,2018-08-12T15:00:00Z,True,0,12,34,1,0,0,0,0,0,0,0,0
Maitland-Niles,19,2,13,2018-08-18T16:30:00Z,False,0,5,0,0,0,0,0,3,0,3,-3,0
Maitland-Niles,19,2,20,2018-08-25T14:00:00Z,True,0,18,0,0,0,0,0,0,0,0,0,0
Maitland-Niles,19,2,32,2018-09-02T12:30:00Z,False,0,4,0,0,3,3,0,2,1,1,1,-1
Maitland-Niles,19,2,45,2018-09-15T14:00:00Z,False,0,14,0,0,6,3,3,1,0,1,5,3
Maitland-Niles,19,2,50,2018-09-23T15:00:00Z,True,0,7,0,0,9,3,6,6,4,2,3,1
Maitland-Niles,19,2,60,2018-09-29T14:00:00Z,True,0,17,0,0,12,6,6,13,9,4,-1,2
Maitland-Niles,19,2,73,2018-10-07T11:00:00Z,False,0,8,0,0,15,9,6,5,4,1,10,2
Maitland-Niles,19,2,80,2018-10-22T19:00:00Z,True,0,10,0,0,18,9,9,12,6,6,6,3
Maitland-Niles,19,2,92,2018-10-28T13:30:00Z,False,0,6,0,0,21,12,9,7,1,6,14,8
Maitland-Niles,19,2,100,2018-11-03T17:30:00Z,True,0,11,0,0,22,12,10,26,13,13,-4,-1
Maitland-Niles,19,2,110,2018-11-11T16:30:00Z,True,0,19,0,0,23,13,10,15,8,7,8,6
Maitland-Niles,19,2,120,2018-11-25T13:30:00Z,False,0,1,0,0,24,14,10,20,11,9,4,-1
Maitland-Niles,19,2,130,2018-12-02T14:05:00Z,True,0,16,0,0,27,14,13,30,9,21,-3,-7
Maitland-Niles,19,2,144,2018-12-05T20:00:00Z,False,0,13,0,0,30,17,13,22,11,11,8,2
Maitland-Niles,19,2,150,2018-12-08T15:00:00Z,True,0,9,0,0,31,17,14,10,5,5,21,12
Maitland-Niles,19,2,166,2018-12-16T13:30:00Z,False,0,15,16,1,34,20,14,9,5,4,25,9
Maitland-Niles,19,2,170,2018-12-22T12:30:00Z,True,0,3,90,2,34,20,14,12,7,5,22,15
Maitland-Niles,19,2,180,2018-12-26T17:15:00Z,False,0,2,20,1,37,23,14,21,14,7,16,0
Maitland-Niles,19,2,195,2018-12-29T17:30:00Z,False,0,11,90,8,38,23,15,51,25,26,-13,-10
Maitland-Niles,19,2,200,2019-01-01T15:00:00Z,True,0,8,90,2,38,23,15,14,12,2,24,21
Maitland-Niles,19,2,219,2019-01-12T12:30:00Z,False,0,18,68,2,41,26,15,28,14,14,13,1
Maitland-Niles,19,2,220,2019-01-19T17:30:00Z,True,0,5,23,1,41,26,15,47,25,22,-6,4
Maitland-Niles,19,2,230,2019-01-29T19:45:00Z,True,0,4,0,0,44,29,15,19,14,5,25,24
Maitland-Niles,19,2,247,2019-02-03T16:30:00Z,False,0,12,0,0,47,32,15,56,33,23,-9,-18
Maitland-Niles,19,2,253,2019-02-09T15:00:00Z,False,0,9,90,6,47,32,15,11,5,6,36,10
Maitland-Niles,19,2,260,2019-02-24T14:05:00Z,True,0,15,0,0,50,32,18,24,12,12,26,20
Maitland-Niles,19,2,270,2019-02-27T19:45:00Z,True,0,1,0,0,53,35,18,34,25,9,19,26
Maitland-Niles,19,2,286,2019-03-02T12:30:00Z,False,0,16,0,0,56,38,18,60,27,33,-4,-9
Maitland-Niles,19,2,290,2019-03-10T16:30:00Z,True,0,13,90,3,57,38,19,58,29,29,-1,9
Maitland-Niles,19,2,310,2019-04-01T19:00:00Z,True,0,14,90,3,60,41,19,35,22,13,25,28
Maitland-Niles,19,2,322,2019-04-07T13:05:00Z,False,0,7,90,2,63,44,19,43,25,18,20,-6
Maitland-Niles,19,2,339,2019-04-15T19:00:00Z,False,0,17,22,1,63,44,19,46,26,20,17,-7
Maitland-Niles,19,2,340,2019-04-21T15:00:00Z,True,0,6,45,1,66,44,22,39,16,23,27,21
Maitland-Niles,19,2,309,2019-04-24T18:45:00Z,False,0,19,90,2,66,44,22,48,28,20,18,-6
Maitland-Niles,19,2,354,2019-04-28T11:00:00Z,False,0,10,35,-2,66,44,22,48,23,25,18,-1
Maitland-Niles,19,2,360,2019-05-05T15:30:00Z,True,0,2,0,0,66,44,22,35,23,12,31,32
Maitland-Niles,19,2,371,2019-05-12T14:00:00Z,False,0,3,0,0,67,45,22,40,23,17,27,-1
Welbeck,20,3,0,2018-08-12T15:00:00Z,True,0,12,0,0,0,0,0,0,0,0,0,0
Welbeck,20,3,13,2018-08-18T16:30:00Z,False,0,5,0,0,0,0,0,3,0,3,-3,0
Welbeck,20,3,20,2018-08-25T14:00:00Z,True,0,18,15,8,0,0,0,0,0,0,0,0
Welbeck,20,3,32,2018-09-02T12:30:00Z,False,0,4,6,1,3,3,0,2,1,1,1,-1
Welbeck,20,3,45,2018-09-15T14:00:00Z,False,0,14,10,1,6,3,3,1,0,1,5,3
Welbeck,20,3,50,2018-09-23T15:00:00Z,True,0,7,10,1,9,3,6,6,4,2,3,1
Welbeck,20,3,60,2018-09-29T14:00:00Z,True,0,17,13,1,12,6,6,13,9,4,-1,2
Welbeck,20,3,73,2018-10-07T11:00:00Z,False,0,8,61,5,15,9,6,5,4,1,10,2
Welbeck,20,3,80,2018-10-22T19:00:00Z,True,0,10,0,0,18,9,9,12,6,6,6,3
Welbeck,20,3,92,2018-10-28T13:30:00Z,False,0,6,22,1,21,12,9,7,1,6,14,8
Welbeck,20,3,100,2018-11-03T17:30:00Z,True,0,11,9,1,22,12,10,26,13,13,-4,-1
Welbeck,20,3,110,2018-11-11T16:30:00Z,True,0,19,0,0,23,13,10,15,8,7,8,6
Welbeck,20,3,120,2018-11-25T13:30:00Z,False,0,1,0,0,24,14,10,20,11,9,4,-1
Welbeck,20,3,130,2018-12-02T14:05:00Z,True,0,16,0,0,27,14,13,30,9,21,-3,-7
Welbeck,20,3,144,2018-12-05T20:00:00Z,False,0,13,0,0,30,17,13,22,11,11,8,2
Welbeck,20,3,150,2018-12-08T15:00:00Z,True,0,9,0,0,31,17,14,10,5,5,21,12
Welbeck,20,3,166,2018-12-16T13:30:00Z,False,0,15,0,0,34,20,14,9,5,4,25,9
Welbeck,20,3,170,2018-12-22T12:30:00Z,True,0,3,0,0,34,20,14,12,7,5,22,15
Welbeck,20,3,180,2018-12-26T17:15:00Z,False,0,2,0,0,37,23,14,21,14,7,16,0
Welbeck,20,3,195,2018-12-29T17:30:00Z,False,0,11,0,0,38,23,15,51,25,26,-13,-10
Welbeck,20,3,200,2019-01-01T15:00:00Z,True,0,8,0,0,38,23,15,14,12,2,24,21
Welbeck,20,3,219,2019-01-12T12:30:00Z,False,0,18,0,0,41,26,15,28,14,14,13,1
Welbeck,20,3,220,2019-01-19T17:30:00Z,True,0,5,0,0,41,26,15,47,25,22,-6,4
Welbeck,20,3,230,2019-01-29T19:45:00Z,True,0,4,0,0,44,29,15,19,14,5,25,24
Welbeck,20,3,247,2019-02-03T16:30:00Z,False,0,12,0,0,47,32,15,56,33,23,-9,-18
Welbeck,20,3,253,2019-02-09T15:00:00Z,False,0,9,0,0,47,32,15,11,5,6,36,10
Welbeck,20,3,260,2019-02-24T14:05:00Z,True,0,15,0,0,50,32,18,24,12,12,26,20
Welbeck,20,3,270,2019-02-27T19:45:00Z,True,0,1,0,0,53,35,18,34,25,9,19,26
Welbeck,20,3,286,2019-03-02T12:30:00Z,False,0,16,0,0,56,38,18,60,27,33,-4,-9
Welbeck,20,3,290,2019-03-10T16:30:00Z,True,0,13,0,0,57,38,19,58,29,29,-1,9
Welbeck,20,3,310,2019-04-01T19:00:00Z,True,0,14,0,0,60,41,19,35,22,13,25,28
Welbeck,20,3,322,2019-04-07T13:05:00Z,False,0,7,0,0,63,44,19,43,25,18,20,-6
Welbeck,20,3,339,2019-04-15T19:00:00Z,False,0,17,0,0,63,44,19,46,26,20,17,-7
Welbeck,20,3,340,2019-04-21T15:00:00Z,True,0,6,0,0,66,44,22,39,16,23,27,21
Welbeck,20,3,309,2019-04-24T18:45:00Z,False,0,19,0,0,66,44,22,48,28,20,18,-6
Welbeck,20,3,354,2019-04-28T11:00:00Z,False,0,10,0,0,66,44,22,48,23,25,18,-1
Welbeck,20,3,360,2019-05-05T15:30:00Z,True,0,2,0,0,66,44,22,35,23,12,31,32
Welbeck,20,3,371,2019-05-12T14:00:00Z,False,0,3,0,0,67,45,22,40,23,17,27,-1
Lacazette,21,3,0,2018-08-12T15:00:00Z,True,0,12,36,1,0,0,0,0,0,0,0,0
Lacazette,21,3,13,2018-08-18T16:30:00Z,False,0,5,15,1,0,0,0,3,0,3,-3,0
Lacazette,21,3,20,2018-08-25T14:00:00Z,True,0,18,45,4,0,0,0,0,0,0,0,0
Lacazette,21,3,32,2018-09-02T12:30:00Z,False,0,4,90,12,3,3,0,2,1,1,1,-1
Lacazette,21,3,45,2018-09-15T14:00:00Z,False,0,14,90,5,6,3,3,1,0,1,5,3
Lacazette,21,3,50,2018-09-23T15:00:00Z,True,0,7,90,8,9,3,6,6,4,2,3,1
Lacazette,21,3,60,2018-09-29T14:00:00Z,True,0,17,90,5,12,6,6,13,9,4,-1,2
Lacazette,21,3,73,2018-10-07T11:00:00Z,False,0,8,79,12,15,9,6,5,4,1,10,2
Lacazette,21,3,80,2018-10-22T19:00:00Z,True,0,10,90,2,18,9,9,12,6,6,6,3
Lacazette,21,3,92,2018-10-28T13:30:00Z,False,0,6,90,2,21,12,9,7,1,6,14,8
Lacazette,21,3,100,2018-11-03T17:30:00Z,True,0,11,90,6,22,12,10,26,13,13,-4,-1
Lacazette,21,3,110,2018-11-11T16:30:00Z,True,0,19,90,2,23,13,10,15,8,7,8,6
Lacazette,21,3,120,2018-11-25T13:30:00Z,False,0,1,0,0,24,14,10,20,11,9,4,-1
Lacazette,21,3,130,2018-12-02T14:05:00Z,True,0,16,45,7,27,14,13,30,9,21,-3,-7
Lacazette,21,3,144,2018-12-05T20:00:00Z,False,0,13,25,4,30,17,13,22,11,11,8,2
Lacazette,21,3,150,2018-12-08T15:00:00Z,True,0,9,45,1,31,17,14,10,5,5,21,12
Lacazette,21,3,166,2018-12-16T13:30:00Z,False,0,15,45,4,34,20,14,9,5,4,25,9
Lacazette,21,3,170,2018-12-22T12:30:00Z,True,0,3,77,5,34,20,14,12,7,5,22,15
Lacazette,21,3,180,2018-12-26T17:15:00Z,False,0,2,61,6,37,23,14,21,14,7,16,0
Lacazette,21,3,195,2018-12-29T17:30:00Z,False,0,11,19,1,38,23,15,51,25,26,-13,-10
Lacazette,21,3,200,2019-01-01T15:00:00Z,True,0,8,74,6,38,23,15,14,12,2,24,21
Lacazette,21,3,219,2019-01-12T12:30:00Z,False,0,18,90,2,41,26,15,28,14,14,13,1
Lacazette,21,3,220,2019-01-19T17:30:00Z,True,0,5,67,8,41,26,15,47,25,22,-6,4
Lacazette,21,3,230,2019-01-29T19:45:00Z,True,0,4,90,7,44,29,15,19,14,5,25,24
Lacazette,21,3,247,2019-02-03T16:30:00Z,False,0,12,90,2,47,32,15,56,33,23,-9,-18
Lacazette,21,3,253,2019-02-09T15:00:00Z,False,0,9,90,9,47,32,15,11,5,6,36,10
Lacazette,21,3,260,2019-02-24T14:05:00Z,True,0,15,90,7,50,32,18,24,12,12,26,20
Lacazette,21,3,270,2019-02-27T19:45:00Z,True,0,1,26,5,53,35,18,34,25,9,19,26
Lacazette,21,3,286,2019-03-02T12:30:00Z,False,0,16,55,4,56,38,18,60,27,33,-4,-9
Lacazette,21,3,290,2019-03-10T16:30:00Z,True,0,13,85,8,57,38,19,58,29,29,-1,9
Lacazette,21,3,310,2019-04-01T19:00:00Z,True,0,14,90,7,60,41,19,35,22,13,25,28
Lacazette,21,3,322,2019-04-07T13:05:00Z,False,0,7,90,2,63,44,19,43,25,18,20,-6
Lacazette,21,3,339,2019-04-15T19:00:00Z,False,0,17,0,0,63,44,19,46,26,20,17,-7
Lacazette,21,3,340,2019-04-21T15:00:00Z,True,0,6,90,5,66,44,22,39,16,23,27,21
Lacazette,21,3,309,2019-04-24T18:45:00Z,False,0,19,90,2,66,44,22,48,28,20,18,-6
Lacazette,21,3,354,2019-04-28T11:00:00Z,False,0,10,78,2,66,44,22,48,23,25,18,-1
Lacazette,21,3,360,2019-05-05T15:30:00Z,True,0,2,90,2,66,44,22,35,23,12,31,32
Lacazette,21,3,371,2019-05-12T14:00:00Z,False,0,3,0,0,67,45,22,40,23,17,27,-1
Aubameyang,22,3,0,2018-08-12T15:00:00Z,True,0,12,90,2,0,0,0,0,0,0,0,0
Aubameyang,22,3,13,2018-08-18T16:30:00Z,False,0,5,90,2,0,0,0,3,0,3,-3,0
Aubameyang,22,3,20,2018-08-25T14:00:00Z,True,0,18,74,2,0,0,0,0,0,0,0,0
Aubameyang,22,3,32,2018-09-02T12:30:00Z,False,0,4,88,8,3,3,0,2,1,1,1,-1
Aubameyang,22,3,45,2018-09-15T14:00:00Z,False,0,14,68,5,6,3,3,1,0,1,5,3
Aubameyang,22,3,50,2018-09-23T15:00:00Z,True,0,7,68,7,9,3,6,6,4,2,3,1
Aubameyang,22,3,60,2018-09-29T14:00:00Z,True,0,17,76,2,12,6,6,13,9,4,-1,2
Aubameyang,22,3,73,2018-10-07T11:00:00Z,False,0,8,28,15,15,9,6,5,4,1,10,2
Aubameyang,22,3,80,2018-10-22T19:00:00Z,True,0,10,29,12,18,9,9,12,6,6,6,3
Aubameyang,22,3,92,2018-10-28T13:30:00Z,False,0,6,77,8,21,12,9,7,1,6,14,8
Aubameyang,22,3,100,2018-11-03T17:30:00Z,True,0,11,72,2,22,12,10,26,13,13,-4,-1
Aubameyang,22,3,110,2018-11-11T16:30:00Z,True,0,19,90,2,23,13,10,15,8,7,8,6
Aubameyang,22,3,120,2018-11-25T13:30:00Z,False,0,1,90,8,24,14,10,20,11,9,4,-1
Aubameyang,22,3,130,2018-12-02T14:05:00Z,True,0,16,90,16,27,14,13,30,9,21,-3,-7
Aubameyang,22,3,144,2018-12-05T20:00:00Z,False,0,13,90,2,30,17,13,22,11,11,8,2
Aubameyang,22,3,150,2018-12-08T15:00:00Z,True,0,9,90,5,31,17,14,10,5,5,21,12
Aubameyang,22,3,166,2018-12-16T13:30:00Z,False,0,15,90,2,34,20,14,9,5,4,25,9
Aubameyang,22,3,170,2018-12-22T12:30:00Z,True,0,3,90,13,34,20,14,12,7,5,22,15
Aubameyang,22,3,180,2018-12-26T17:15:00Z,False,0,2,90,8,37,23,14,21,14,7,16,0
Aubameyang,22,3,195,2018-12-29T17:30:00Z,False,0,11,70,2,38,23,15,51,25,26,-13,-10
Aubameyang,22,3,200,2019-01-01T15:00:00Z,True,0,8,90,9,38,23,15,14,12,2,24,21
Aubameyang,22,3,219,2019-01-12T12:30:00Z,False,0,18,90,2,41,26,15,28,14,14,13,1
Aubameyang,22,3,220,2019-01-19T17:30:00Z,True,0,5,90,2,41,26,15,47,25,22,-6,4
Aubameyang,22,3,230,2019-01-29T19:45:00Z,True,0,4,90,12,44,29,15,19,14,5,25,24
Aubameyang,22,3,247,2019-02-03T16:30:00Z,False,0,12,90,2,47,32,15,56,33,23,-9,-18
Aubameyang,22,3,253,2019-02-09T15:00:00Z,False,0,9,0,0,47,32,15,11,5,6,36,10
Aubameyang,22,3,260,2019-02-24T14:05:00Z,True,0,15,15,1,50,32,18,24,12,12,26,20
Aubameyang,22,3,270,2019-02-27T19:45:00Z,True,0,1,70,7,53,35,18,34,25,9,19,26
Aubameyang,22,3,286,2019-03-02T12:30:00Z,False,0,16,34,-1,56,38,18,60,27,33,-4,-9
Aubameyang,22,3,290,2019-03-10T16:30:00Z,True,0,13,79,7,57,38,19,58,29,29,-1,9
Aubameyang,22,3,310,2019-04-01T19:00:00Z,True,0,14,29,4,60,41,19,35,22,13,25,28
Aubameyang,22,3,322,2019-04-07T13:05:00Z,False,0,7,45,1,63,44,19,43,25,18,20,-6
Aubameyang,22,3,339,2019-04-15T19:00:00Z,False,0,17,90,6,63,44,19,46,26,20,17,-7
Aubameyang,22,3,340,2019-04-21T15:00:00Z,True,0,6,90,7,66,44,22,39,16,23,27,21
Aubameyang,22,3,309,2019-04-24T18:45:00Z,False,0,19,0,0,66,44,22,48,28,20,18,-6
Aubameyang,22,3,354,2019-04-28T11:00:00Z,False,0,10,90,2,66,44,22,48,23,25,18,-1
Aubameyang,22,3,360,2019-05-05T15:30:00Z,True,0,2,90,8,66,44,22,35,23,12,31,32
Aubameyang,22,3,371,2019-05-12T14:00:00Z,False,0,3,90,13,67,45,22,40,23,17,27,-1
Begovic,23,0,1,2018-08-11T14:00:00Z,True,1,4,90,6,0,0,0,0,0,0,0,0
Begovic,23,0,19,2018-08-18T14:00:00Z,False,1,18,90,3,3,3,0,0,0,0,3,0
Begovic,23,0,21,2018-08-25T14:00:00Z,True,1,7,90,1,6,3,3,4,3,1,2,2
Begovic,23,0,33,2018-09-01T14:00:00Z,False,1,5,90,2,7,4,3,9,3,6,-2,0
Begovic,23,0,40,2018-09-15T14:00:00Z,True,1,10,90,2,7,4,3,6,3,3,1,1
Begovic,23,0,52,2018-09-22T14:00:00Z,False,1,3,90,0,10,7,3,1,0,1,9,3
Begovic,23,0,61,2018-10-01T19:00:00Z,True,1,6,90,2,10,7,3,7,1,6,3,1
Begovic,23,0,79,2018-10-06T14:00:00Z,False,1,17,90,6,13,10,3,13,9,4,0,-6
Begovic,23,0,81,2018-10-20T14:00:00Z,True,1,15,90,9,16,10,6,5,2,3,11,7
Begovic,23,0,93,2018-10-27T14:00:00Z,False,1,8,90,6,17,11,6,5,4,1,12,2
Begovic,23,0,101,2018-11-03T12:30:00Z,True,1,13,90,2,20,11,9,17,10,7,3,4
Begovic,23,0,118,2018-11-10T15:00:00Z,False,1,14,90,2,20,11,9,6,3,3,14,6
Begovic,23,0,120,2018-11-25T13:30:00Z,True,1,0,90,2,20,11,9,24,14,10,-4,1
Begovic,23,0,137,2018-12-01T15:00:00Z,False,1,12,90,2,20,11,9,35,21,14,-15,-12
Begovic,23,0,140,2018-12-04T19:45:00Z,True,1,9,90,3,20,11,9,10,5,5,10,6
Begovic,23,0,151,2018-12-08T12:30:00Z,True,1,11,90,0,23,14,9,39,19,20,-16,-6
Begovic,23,0,169,2018-12-15T15:00:00Z,False,1,19,90,1,23,14,9,22,11,11,1,-2
Begovic,23,0,171,2018-12-22T15:00:00Z,True,1,2,90,9,23,14,9,21,14,7,2,7
Begovic,23,0,188,2018-12-26T15:00:00Z,False,1,16,90,0,26,17,9,42,15,27,-16,-6
Begovic,23,0,196,2018-12-30T16:30:00Z,False,1,13,90,1,26,17,9,32,18,14,-6,-9
Begovic,23,0,201,2019-01-02T19:45:00Z,True,1,17,90,1,26,17,9,28,16,12,-2,5
Begovic,23,0,215,2019-01-13T14:15:00Z,False,1,7,90,1,27,18,9,27,18,9,0,-9
Begovic,23,0,221,2019-01-19T15:00:00Z,True,1,18,0,0,27,18,9,31,17,14,-4,4
Begovic,23,0,231,2019-01-30T19:45:00Z,True,1,5,0,0,30,21,9,47,25,22,-17,-1
Begovic,23,0,242,2019-02-02T17:30:00Z,False,1,4,0,0,33,24,9,19,14,5,14,-5
Begovic,23,0,254,2019-02-09T15:00:00Z,False,1,11,0,0,33,24,9,62,32,30,-29,-23
Begovic,23,0,261,2019-02-23T15:00:00Z,True,1,19,0,0,33,24,9,39,21,18,-6,6
Begovic,23,0,270,2019-02-27T19:45:00Z,False,1,0,0,0,34,25,9,53,35,18,-19,-26
Begovic,23,0,280,2019-03-02T15:00:00Z,True,1,12,0,0,34,25,9,68,42,26,-34,-1
Begovic,23,0,294,2019-03-09T15:00:00Z,False,1,9,0,0,34,25,9,14,8,6,20,1
Begovic,23,0,300,2019-03-16T15:00:00Z,True,1,14,0,0,37,25,12,34,22,12,3,13
Begovic,23,0,316,2019-03-30T15:00:00Z,False,1,10,90,1,38,26,12,41,20,21,-3,-8
Begovic,23,0,320,2019-04-06T14:00:00Z,True,1,3,90,1,38,26,12,33,20,13,5,13
Begovic,23,0,330,2019-04-13T14:00:00Z,False,1,2,0,0,38,26,12,33,22,11,5,-10
Begovic,23,0,341,2019-04-20T14:00:00Z,True,1,8,0,0,41,26,15,20,18,2,21,24
Begovic,23,0,357,2019-04-27T14:00:00Z,False,1,15,0,0,41,26,15,37,21,16,4,-6
Begovic,23,0,361,2019-05-04T11:30:00Z,True,1,16,0,0,42,26,16,70,37,33,-28,-7
Begovic,23,0,372,2019-05-12T14:00:00Z,False,1,6,0,0,45,29,16,46,17,29,-1,-1
Boruc,24,0,1,2018-08-11T14:00:00Z,True,1,4,0,0,0,0,0,0,0,0,0,0
Boruc,24,0,19,2018-08-18T14:00:00Z,False,1,18,0,0,3,3,0,0,0,0,3,0
Boruc,24,0,21,2018-08-25T14:00:00Z,True,1,7,0,0,6,3,3,4,3,1,2,2
Boruc,24,0,33,2018-09-01T14:00:00Z,False,1,5,0,0,7,4,3,9,3,6,-2,0
Boruc,24,0,40,2018-09-15T14:00:00Z,True,1,10,0,0,7,4,3,6,3,3,1,1
Boruc,24,0,52,2018-09-22T14:00:00Z,False,1,3,0,0,10,7,3,1,0,1,9,3
Boruc,24,0,61,2018-10-01T19:00:00Z,True,1,6,0,0,10,7,3,7,1,6,3,1
Boruc,24,0,79,2018-10-06T14:00:00Z,False,1,17,0,0,13,10,3,13,9,4,0,-6
Boruc,24,0,81,2018-10-20T14:00:00Z,True,1,15,0,0,16,10,6,5,2,3,11,7
Boruc,24,0,93,2018-10-27T14:00:00Z,False,1,8,0,0,17,11,6,5,4,1,12,2
Boruc,24,0,101,2018-11-03T12:30:00Z,True,1,13,0,0,20,11,9,17,10,7,3,4
Boruc,24,0,118,2018-11-10T15:00:00Z,False,1,14,0,0,20,11,9,6,3,3,14,6
Boruc,24,0,120,2018-11-25T13:30:00Z,True,1,0,0,0,20,11,9,24,14,10,-4,1
Boruc,24,0,137,2018-12-01T15:00:00Z,False,1,12,0,0,20,11,9,35,21,14,-15,-12
Boruc,24,0,140,2018-12-04T19:45:00Z,True,1,9,0,0,20,11,9,10,5,5,10,6
Boruc,24,0,151,2018-12-08T12:30:00Z,True,1,11,0,0,23,14,9,39,19,20,-16,-6
Boruc,24,0,169,2018-12-15T15:00:00Z,False,1,19,0,0,23,14,9,22,11,11,1,-2
Boruc,24,0,171,2018-12-22T15:00:00Z,True,1,2,0,0,23,14,9,21,14,7,2,7
Boruc,24,0,188,2018-12-26T15:00:00Z,False,1,16,0,0,26,17,9,42,15,27,-16,-6
Boruc,24,0,196,2018-12-30T16:30:00Z,False,1,13,0,0,26,17,9,32,18,14,-6,-9
Boruc,24,0,201,2019-01-02T19:45:00Z,True,1,17,0,0,26,17,9,28,16,12,-2,5
Boruc,24,0,215,2019-01-13T14:15:00Z,False,1,7,0,0,27,18,9,27,18,9,0,-9
Boruc,24,0,221,2019-01-19T15:00:00Z,True,1,18,90,6,27,18,9,31,17,14,-4,4
Boruc,24,0,231,2019-01-30T19:45:00Z,True,1,5,90,10,30,21,9,47,25,22,-17,-1
Boruc,24,0,242,2019-02-02T17:30:00Z,False,1,4,90,2,33,24,9,19,14,5,14,-5
Boruc,24,0,254,2019-02-09T15:00:00Z,False,1,11,90,3,33,24,9,62,32,30,-29,-23
Boruc,24,0,261,2019-02-23T15:00:00Z,True,1,19,90,1,33,24,9,39,21,18,-6,6
Boruc,24,0,270,2019-02-27T19:45:00Z,False,1,0,90,0,34,25,9,53,35,18,-19,-26
Boruc,24,0,280,2019-03-02T15:00:00Z,True,1,12,90,6,34,25,9,68,42,26,-34,-1
Boruc,24,0,294,2019-03-09T15:00:00Z,False,1,9,90,6,34,25,9,14,8,6,20,1
Boruc,24,0,300,2019-03-16T15:00:00Z,True,1,14,90,2,37,25,12,34,22,12,3,13
Boruc,24,0,316,2019-03-30T15:00:00Z,False,1,10,0,0,38,26,12,41,20,21,-3,-8
Boruc,24,0,320,2019-04-06T14:00:00Z,True,1,3,0,0,38,26,12,33,20,13,5,13
Boruc,24,0,330,2019-04-13T14:00:00Z,False,1,2,90,5,38,26,12,33,22,11,5,-10
Boruc,24,0,341,2019-04-20T14:00:00Z,True,1,8,90,3,41,26,15,20,18,2,21,24
Boruc,24,0,357,2019-04-27T14:00:00Z,False,1,15,90,2,41,26,15,37,21,16,4,-6
Boruc,24,0,361,2019-05-04T11:30:00Z,True,1,16,0,0,42,26,16,70,37,33,-28,-7
Boruc,24,0,372,2019-05-12T14:00:00Z,False,1,6,0,0,45,29,16,46,17,29,-1,-1
Francis,25,1,1,2018-08-11T14:00:00Z,True,1,4,23,4,0,0,0,0,0,0,0,0
Francis,25,1,19,2018-08-18T14:00:00Z,False,1,18,12,1,3,3,0,0,0,0,3,0
Francis,25,1,21,2018-08-25T14:00:00Z,True,1,7,0,0,6,3,3,4,3,1,2,2
Francis,25,1,33,2018-09-01T14:00:00Z,False,1,5,90,1,7,4,3,9,3,6,-2,0
Francis,25,1,40,2018-09-15T14:00:00Z,True,1,10,22,0,7,4,3,6,3,3,1,1
Francis,25,1,52,2018-09-22T14:00:00Z,False,1,3,45,0,10,7,3,1,0,1,9,3
Francis,25,1,61,2018-10-01T19:00:00Z,True,1,6,90,2,10,7,3,7,1,6,3,1
Francis,25,1,79,2018-10-06T14:00:00Z,False,1,17,90,6,13,10,3,13,9,4,0,-6
Francis,25,1,81,2018-10-20T14:00:00Z,True,1,15,90,6,16,10,6,5,2,3,11,7
Francis,25,1,93,2018-10-27T14:00:00Z,False,1,8,90,6,17,11,6,5,4,1,12,2
Francis,25,1,101,2018-11-03T12:30:00Z,True,1,13,90,1,20,11,9,17,10,7,3,4
Francis,25,1,118,2018-11-10T15:00:00Z,False,1,14,90,1,20,11,9,6,3,3,14,6
Francis,25,1,120,2018-11-25T13:30:00Z,True,1,0,90,1,20,11,9,24,14,10,-4,1
Francis,25,1,137,2018-12-01T15:00:00Z,False,1,12,90,4,20,11,9,35,21,14,-15,-12
Francis,25,1,140,2018-12-04T19:45:00Z,True,1,9,90,1,20,11,9,10,5,5,10,6
Francis,25,1,151,2018-12-08T12:30:00Z,True,1,11,90,0,23,14,9,39,19,20,-16,-6
Francis,25,1,169,2018-12-15T15:00:00Z,False,1,19,0,0,23,14,9,22,11,11,1,-2
Francis,25,1,171,2018-12-22T15:00:00Z,True,1,2,90,6,23,14,9,21,14,7,2,7
Francis,25,1,188,2018-12-26T15:00:00Z,False,1,16,45,0,26,17,9,42,15,27,-16,-6
Francis,25,1,196,2018-12-30T16:30:00Z,False,1,13,0,0,26,17,9,32,18,14,-6,-9
Francis,25,1,201,2019-01-02T19:45:00Z,True,1,17,0,0,26,17,9,28,16,12,-2,5
Francis,25,1,215,2019-01-13T14:15:00Z,False,1,7,0,0,27,18,9,27,18,9,0,-9
Francis,25,1,221,2019-01-19T15:00:00Z,True,1,18,0,0,27,18,9,31,17,14,-4,4
Francis,25,1,231,2019-01-30T19:45:00Z,True,1,5,0,0,30,21,9,47,25,22,-17,-1
Francis,25,1,242,2019-02-02T17:30:00Z,False,1,4,0,0,33,24,9,19,14,5,14,-5
Francis,25,1,254,2019-02-09T15:00:00Z,False,1,11,0,0,33,24,9,62,32,30,-29,-23
Francis,25,1,261,2019-02-23T15:00:00Z,True,1,19,0,0,33,24,9,39,21,18,-6,6
Francis,25,1,270,2019-02-27T19:45:00Z,False,1,0,0,0,34,25,9,53,35,18,-19,-26
Francis,25,1,280,2019-03-02T15:00:00Z,True,1,12,0,0,34,25,9,68,42,26,-34,-1
Francis,25,1,294,2019-03-09T15:00:00Z,False,1,9,0,0,34,25,9,14,8,6,20,1
Francis,25,1,300,2019-03-16T15:00:00Z,True,1,14,0,0,37,25,12,34,22,12,3,13
Francis,25,1,316,2019-03-30T15:00:00Z,False,1,10,0,0,38,26,12,41,20,21,-3,-8
Francis,25,1,320,2019-04-06T14:00:00Z,True,1,3,0,0,38,26,12,33,20,13,5,13
Francis,25,1,330,2019-04-13T14:00:00Z,False,1,2,0,0,38,26,12,33,22,11,5,-10
Francis,25,1,341,2019-04-20T14:00:00Z,True,1,8,0,0,41,26,15,20,18,2,21,24
Francis,25,1,357,2019-04-27T14:00:00Z,False,1,15,0,0,41,26,15,37,21,16,4,-6
Francis,25,1,361,2019-05-04T11:30:00Z,True,1,16,0,0,42,26,16,70,37,33,-28,-7
Francis,25,1,372,2019-05-12T14:00:00Z,False,1,6,0,0,45,29,16,46,17,29,-1,-1
Steve Cook,26,1,1,2018-08-11T14:00:00Z,True,1,4,90,6,0,0,0,0,0,0,0,0
Steve Cook,26,1,19,2018-08-18T14:00:00Z,False,1,18,90,14,3,3,0,0,0,0,3,0
Steve Cook,26,1,21,2018-08-25T14:00:00Z,True,1,7,90,1,6,3,3,4,3,1,2,2
Steve Cook,26,1,33,2018-09-01T14:00:00Z,False,1,5,90,1,7,4,3,9,3,6,-2,0
Steve Cook,26,1,40,2018-09-15T14:00:00Z,True,1,10,90,1,7,4,3,6,3,3,1,1
Steve Cook,26,1,52,2018-09-22T14:00:00Z,False,1,3,90,0,10,7,3,1,0,1,9,3
Steve Cook,26,1,61,2018-10-01T19:00:00Z,True,1,6,90,2,10,7,3,7,1,6,3,1
Steve Cook,26,1,79,2018-10-06T14:00:00Z,False,1,17,90,6,13,10,3,13,9,4,0,-6
Steve Cook,26,1,81,2018-10-20T14:00:00Z,True,1,15,90,6,16,10,6,5,2,3,11,7
Steve Cook,26,1,93,2018-10-27T14:00:00Z,False,1,8,90,5,17,11,6,5,4,1,12,2
Steve Cook,26,1,101,2018-11-03T12:30:00Z,True,1,13,90,1,20,11,9,17,10,7,3,4
Steve Cook,26,1,118,2018-11-10T15:00:00Z,False,1,14,90,1,20,11,9,6,3,3,14,6
Steve Cook,26,1,120,2018-11-25T13:30:00Z,True,1,0,90,1,20,11,9,24,14,10,-4,1
Steve Cook,26,1,137,2018-12-01T15:00:00Z,False,1,12,90,1,20,11,9,35,21,14,-15,-12
Steve Cook,26,1,140,2018-12-04T19:45:00Z,True,1,9,90,2,20,11,9,10,5,5,10,6
Steve Cook,26,1,151,2018-12-08T12:30:00Z,True,1,11,90,-2,23,14,9,39,19,20,-16,-6
Steve Cook,26,1,169,2018-12-15T15:00:00Z,False,1,19,90,0,23,14,9,22,11,11,1,-2
Steve Cook,26,1,171,2018-12-22T15:00:00Z,True,1,2,90,7,23,14,9,21,14,7,2,7
Steve Cook,26,1,188,2018-12-26T15:00:00Z,False,1,16,90,0,26,17,9,42,15,27,-16,-6
Steve Cook,26,1,196,2018-12-30T16:30:00Z,False,1,13,90,0,26,17,9,32,18,14,-6,-9
Steve Cook,26,1,201,2019-01-02T19:45:00Z,True,1,17,90,1,26,17,9,28,16,12,-2,5
Steve Cook,26,1,215,2019-01-13T14:15:00Z,False,1,7,90,1,27,18,9,27,18,9,0,-9
Steve Cook,26,1,221,2019-01-19T15:00:00Z,True,1,18,90,7,27,18,9,31,17,14,-4,4
Steve Cook,26,1,231,2019-01-30T19:45:00Z,True,1,5,90,6,30,21,9,47,25,22,-17,-1
Steve Cook,26,1,242,2019-02-02T17:30:00Z,False,1,4,90,1,33,24,9,19,14,5,14,-5
Steve Cook,26,1,254,2019-02-09T15:00:00Z,False,1,11,90,1,33,24,9,62,32,30,-29,-23
Steve Cook,26,1,261,2019-02-23T15:00:00Z,True,1,19,0,0,33,24,9,39,21,18,-6,6
Steve Cook,26,1,270,2019-02-27T19:45:00Z,False,1,0,0,0,34,25,9,53,35,18,-19,-26
Steve Cook,26,1,280,2019-03-02T15:00:00Z,True,1,12,0,0,34,25,9,68,42,26,-34,-1
Steve Cook,26,1,294,2019-03-09T15:00:00Z,False,1,9,0,0,34,25,9,14,8,6,20,1
Steve Cook,26,1,300,2019-03-16T15:00:00Z,True,1,14,0,0,37,25,12,34,22,12,3,13
Steve Cook,26,1,316,2019-03-30T15:00:00Z,False,1,10,0,0,38,26,12,41,20,21,-3,-8
Steve Cook,26,1,320,2019-04-06T14:00:00Z,True,1,3,0,0,38,26,12,33,20,13,5,13
Steve Cook,26,1,330,2019-04-13T14:00:00Z,False,1,2,86,6,38,26,12,33,22,11,5,-10
Steve Cook,26,1,341,2019-04-20T14:00:00Z,True,1,8,90,1,41,26,15,20,18,2,21,24
Steve Cook,26,1,357,2019-04-27T14:00:00Z,False,1,15,90,1,41,26,15,37,21,16,4,-6
Steve Cook,26,1,361,2019-05-04T11:30:00Z,True,1,16,90,7,42,26,16,70,37,33,-28,-7
Steve Cook,26,1,372,2019-05-12T14:00:00Z,False,1,6,90,0,45,29,16,46,17,29,-1,-1
Daniels,27,1,1,2018-08-11T14:00:00Z,True,1,4,90,5,0,0,0,0,0,0,0,0
Daniels,27,1,19,2018-08-18T14:00:00Z,False,1,18,90,2,3,3,0,0,0,0,3,0
Daniels,27,1,21,2018-08-25T14:00:00Z,True,1,7,90,1,6,3,3,4,3,1,2,2
Daniels,27,1,33,2018-09-01T14:00:00Z,False,1,5,0,0,7,4,3,9,3,6,-2,0
Daniels,27,1,40,2018-09-15T14:00:00Z,True,1,10,0,0,7,4,3,6,3,3,1,1
Daniels,27,1,52,2018-09-22T14:00:00Z,False,1,3,0,0,10,7,3,1,0,1,9,3
Daniels,27,1,61,2018-10-01T19:00:00Z,True,1,6,0,0,10,7,3,7,1,6,3,1
Daniels,27,1,79,2018-10-06T14:00:00Z,False,1,17,0,0,13,10,3,13,9,4,0,-6
Daniels,27,1,81,2018-10-20T14:00:00Z,True,1,15,0,0,16,10,6,5,2,3,11,7
Daniels,27,1,93,2018-10-27T14:00:00Z,False,1,8,90,6,17,11,6,5,4,1,12,2
Daniels,27,1,101,2018-11-03T12:30:00Z,True,1,13,0,0,20,11,9,17,10,7,3,4
Daniels,27,1,118,2018-11-10T15:00:00Z,False,1,14,60,2,20,11,9,6,3,3,14,6
Daniels,27,1,120,2018-11-25T13:30:00Z,True,1,0,90,1,20,11,9,24,14,10,-4,1
Daniels,27,1,137,2018-12-01T15:00:00Z,False,1,12,90,1,20,11,9,35,21,14,-15,-12
Daniels,27,1,140,2018-12-04T19:45:00Z,True,1,9,90,1,20,11,9,10,5,5,10,6
Daniels,27,1,151,2018-12-08T12:30:00Z,True,1,11,82,0,23,14,9,39,19,20,-16,-6
Daniels,27,1,169,2018-12-15T15:00:00Z,False,1,19,90,1,23,14,9,22,11,11,1,-2
Daniels,27,1,171,2018-12-22T15:00:00Z,True,1,2,90,6,23,14,9,21,14,7,2,7
Daniels,27,1,188,2018-12-26T15:00:00Z,False,1,16,90,0,26,17,9,42,15,27,-16,-6
Daniels,27,1,196,2018-12-30T16:30:00Z,False,1,13,90,0,26,17,9,32,18,14,-6,-9
Daniels,27,1,201,2019-01-02T19:45:00Z,True,1,17,90,1,26,17,9,28,16,12,-2,5
Daniels,27,1,215,2019-01-13T14:15:00Z,False,1,7,0,0,27,18,9,27,18,9,0,-9
Daniels,27,1,221,2019-01-19T15:00:00Z,True,1,18,1,1,27,18,9,31,17,14,-4,4
Daniels,27,1,231,2019-01-30T19:45:00Z,True,1,5,1,7,30,21,9,47,25,22,-17,-1
Daniels,27,1,242,2019-02-02T17:30:00Z,False,1,4,0,0,33,24,9,19,14,5,14,-5
Daniels,27,1,254,2019-02-09T15:00:00Z,False,1,11,0,0,33,24,9,62,32,30,-29,-23
Daniels,27,1,261,2019-02-23T15:00:00Z,True,1,19,0,0,33,24,9,39,21,18,-6,6
Daniels,27,1,270,2019-02-27T19:45:00Z,False,1,0,34,-1,34,25,9,53,35,18,-19,-26
Daniels,27,1,280,2019-03-02T15:00:00Z,True,1,12,90,2,34,25,9,68,42,26,-34,-1
Daniels,27,1,294,2019-03-09T15:00:00Z,False,1,9,90,7,34,25,9,14,8,6,20,1
Daniels,27,1,300,2019-03-16T15:00:00Z,True,1,14,90,0,37,25,12,34,22,12,3,13
Daniels,27,1,316,2019-03-30T15:00:00Z,False,1,10,55,1,38,26,12,41,20,21,-3,-8
Daniels,27,1,320,2019-04-06T14:00:00Z,True,1,3,0,0,38,26,12,33,20,13,5,13
Daniels,27,1,330,2019-04-13T14:00:00Z,False,1,2,0,0,38,26,12,33,22,11,5,-10
Daniels,27,1,341,2019-04-20T14:00:00Z,True,1,8,0,0,41,26,15,20,18,2,21,24
Daniels,27,1,357,2019-04-27T14:00:00Z,False,1,15,0,0,41,26,15,37,21,16,4,-6
Daniels,27,1,361,2019-05-04T11:30:00Z,True,1,16,0,0,42,26,16,70,37,33,-28,-7
Daniels,27,1,372,2019-05-12T14:00:00Z,False,1,6,0,0,45,29,16,46,17,29,-1,-1
Adam Smith,28,1,1,2018-08-11T14:00:00Z,True,1,4,90,6,0,0,0,0,0,0,0,0
Adam Smith,28,1,19,2018-08-18T14:00:00Z,False,1,18,90,2,3,3,0,0,0,0,3,0
Adam Smith,28,1,21,2018-08-25T14:00:00Z,True,1,7,60,-2,6,3,3,4,3,1,2,2
Adam Smith,28,1,33,2018-09-01T14:00:00Z,False,1,5,79,2,7,4,3,9,3,6,-2,0
Adam Smith,28,1,40,2018-09-15T14:00:00Z,True,1,10,90,7,7,4,3,6,3,3,1,1
Adam Smith,28,1,52,2018-09-22T14:00:00Z,False,1,3,77,1,10,7,3,1,0,1,9,3
Adam Smith,28,1,61,2018-10-01T19:00:00Z,True,1,6,90,2,10,7,3,7,1,6,3,1
Adam Smith,28,1,79,2018-10-06T14:00:00Z,False,1,17,90,6,13,10,3,13,9,4,0,-6
Adam Smith,28,1,81,2018-10-20T14:00:00Z,True,1,15,90,6,16,10,6,5,2,3,11,7
Adam Smith,28,1,93,2018-10-27T14:00:00Z,False,1,8,90,6,17,11,6,5,4,1,12,2
Adam Smith,28,1,101,2018-11-03T12:30:00Z,True,1,13,90,0,20,11,9,17,10,7,3,4
Adam Smith,28,1,118,2018-11-10T15:00:00Z,False,1,14,29,1,20,11,9,6,3,3,14,6
Adam Smith,28,1,120,2018-11-25T13:30:00Z,True,1,0,0,0,20,11,9,24,14,10,-4,1
Adam Smith,28,1,137,2018-12-01T15:00:00Z,False,1,12,0,0,20,11,9,35,21,14,-15,-12
Adam Smith,28,1,140,2018-12-04T19:45:00Z,True,1,9,0,0,20,11,9,10,5,5,10,6
Adam Smith,28,1,151,2018-12-08T12:30:00Z,True,1,11,0,0,23,14,9,39,19,20,-16,-6
Adam Smith,28,1,169,2018-12-15T15:00:00Z,False,1,19,0,0,23,14,9,22,11,11,1,-2
Adam Smith,28,1,171,2018-12-22T15:00:00Z,True,1,2,0,0,23,14,9,21,14,7,2,7
Adam Smith,28,1,188,2018-12-26T15:00:00Z,False,1,16,0,0,26,17,9,42,15,27,-16,-6
Adam Smith,28,1,196,2018-12-30T16:30:00Z,False,1,13,0,0,26,17,9,32,18,14,-6,-9
Adam Smith,28,1,201,2019-01-02T19:45:00Z,True,1,17,0,0,26,17,9,28,16,12,-2,5
Adam Smith,28,1,215,2019-01-13T14:15:00Z,False,1,7,90,1,27,18,9,27,18,9,0,-9
Adam Smith,28,1,221,2019-01-19T15:00:00Z,True,1,18,90,6,27,18,9,31,17,14,-4,4
Adam Smith,28,1,231,2019-01-30T19:45:00Z,True,1,5,90,6,30,21,9,47,25,22,-17,-1
Adam Smith,28,1,242,2019-02-02T17:30:00Z,False,1,4,90,0,33,24,9,19,14,5,14,-5
Adam Smith,28,1,254,2019-02-09T15:00:00Z,False,1,11,90,0,33,24,9,62,32,30,-29,-23
Adam Smith,28,1,261,2019-02-23T15:00:00Z,True,1,19,90,1,33,24,9,39,21,18,-6,6
Adam Smith,28,1,270,2019-02-27T19:45:00Z,False,1,0,69,0,34,25,9,53,35,18,-19,-26
Adam Smith,28,1,280,2019-03-02T15:00:00Z,True,1,12,90,2,34,25,9,68,42,26,-34,-1
Adam Smith,28,1,294,2019-03-09T15:00:00Z,False,1,9,43,1,34,25,9,14,8,6,20,1
Adam Smith,28,1,300,2019-03-16T15:00:00Z,True,1,14,0,0,37,25,12,34,22,12,3,13
Adam Smith,28,1,316,2019-03-30T15:00:00Z,False,1,10,0,0,38,26,12,41,20,21,-3,-8
Adam Smith,28,1,320,2019-04-06T14:00:00Z,True,1,3,90,0,38,26,12,33,20,13,5,13
Adam Smith,28,1,330,2019-04-13T14:00:00Z,False,1,2,90,6,38,26,12,33,22,11,5,-10
Adam Smith,28,1,341,2019-04-20T14:00:00Z,True,1,8,0,0,41,26,15,20,18,2,21,24
Adam Smith,28,1,357,2019-04-27T14:00:00Z,False,1,15,0,0,41,26,15,37,21,16,4,-6
Adam Smith,28,1,361,2019-05-04T11:30:00Z,True,1,16,90,6,42,26,16,70,37,33,-28,-7
Adam Smith,28,1,372,2019-05-12T14:00:00Z,False,1,6,90,4,45,29,16,46,17,29,-1,-1
Mings,29,1,1,2018-08-11T14:00:00Z,True,1,4,0,0,0,0,0,0,0,0,0,0
Mings,29,1,19,2018-08-18T14:00:00Z,False,1,18,0,0,3,3,0,0,0,0,3,0
Mings,29,1,21,2018-08-25T14:00:00Z,True,1,7,0,0,6,3,3,4,3,1,2,2
Mings,29,1,33,2018-09-01T14:00:00Z,False,1,5,0,0,7,4,3,9,3,6,-2,0
Mings,29,1,40,2018-09-15T14:00:00Z,True,1,10,0,0,7,4,3,6,3,3,1,1
Mings,29,1,52,2018-09-22T14:00:00Z,False,1,3,0,0,10,7,3,1,0,1,9,3
Mings,29,1,61,2018-10-01T19:00:00Z,True,1,6,0,0,10,7,3,7,1,6,3,1
Mings,29,1,79,2018-10-06T14:00:00Z,False,1,17,0,0,13,10,3,13,9,4,0,-6
Mings,29,1,81,2018-10-20T14:00:00Z,True,1,15,0,0,16,10,6,5,2,3,11,7
Mings,29,1,93,2018-10-27T14:00:00Z,False,1,8,0,0,17,11,6,5,4,1,12,2
Mings,29,1,101,2018-11-03T12:30:00Z,True,1,13,0,0,20,11,9,17,10,7,3,4
Mings,29,1,118,2018-11-10T15:00:00Z,False,1,14,0,0,20,11,9,6,3,3,14,6
Mings,29,1,120,2018-11-25T13:30:00Z,True,1,0,0,0,20,11,9,24,14,10,-4,1
Mings,29,1,137,2018-12-01T15:00:00Z,False,1,12,90,1,20,11,9,35,21,14,-15,-12
Mings,29,1,140,2018-12-04T19:45:00Z,True,1,9,1,1,20,11,9,10,5,5,10,6
Mings,29,1,151,2018-12-08T12:30:00Z,True,1,11,7,1,23,14,9,39,19,20,-16,-6
Mings,29,1,169,2018-12-15T15:00:00Z,False,1,19,35,1,23,14,9,22,11,11,1,-2
Mings,29,1,171,2018-12-22T15:00:00Z,True,1,2,0,0,23,14,9,21,14,7,2,7
Mings,29,1,188,2018-12-26T15:00:00Z,False,1,16,0,0,26,17,9,42,15,27,-16,-6
Mings,29,1,196,2018-12-30T16:30:00Z,False,1,13,8,1,26,17,9,32,18,14,-6,-9
Mings,29,1,201,2019-01-02T19:45:00Z,True,1,17,0,0,26,17,9,28,16,12,-2,5
Mings,29,1,215,2019-01-13T14:15:00Z,False,1,7,0,0,27,18,9,27,18,9,0,-9
Mings,29,1,221,2019-01-19T15:00:00Z,True,1,18,0,0,27,18,9,31,17,14,-4,4
Mings,29,1,231,2019-01-30T19:45:00Z,True,1,5,0,0,30,21,9,47,25,22,-17,-1
Mings,29,1,242,2019-02-02T17:30:00Z,False,1,4,0,0,33,24,9,19,14,5,14,-5
Mings,29,1,254,2019-02-09T15:00:00Z,False,1,11,0,0,33,24,9,62,32,30,-29,-23
Mings,29,1,261,2019-02-23T15:00:00Z,True,1,19,0,0,33,24,9,39,21,18,-6,6
Mings,29,1,270,2019-02-27T19:45:00Z,False,1,0,0,0,34,25,9,53,35,18,-19,-26
Mings,29,1,280,2019-03-02T15:00:00Z,True,1,12,0,0,34,25,9,68,42,26,-34,-1
Mings,29,1,294,2019-03-09T15:00:00Z,False,1,9,0,0,34,25,9,14,8,6,20,1
Mings,29,1,300,2019-03-16T15:00:00Z,True,1,14,0,0,37,25,12,34,22,12,3,13
Mings,29,1,316,2019-03-30T15:00:00Z,False,1,10,0,0,38,26,12,41,20,21,-3,-8
Mings,29,1,320,2019-04-06T14:00:00Z,True,1,3,0,0,38,26,12,33,20,13,5,13
Mings,29,1,330,2019-04-13T14:00:00Z,False,1,2,0,0,38,26,12,33,22,11,5,-10
Mings,29,1,341,2019-04-20T14:00:00Z,True,1,8,0,0,41,26,15,20,18,2,21,24
Mings,29,1,357,2019-04-27T14:00:00Z,False,1,15,0,0,41,26,15,37,21,16,4,-6
Mings,29,1,361,2019-05-04T11:30:00Z,True,1,16,0,0,42,26,16,70,37,33,-28,-7
Mings,29,1,372,2019-05-12T14:00:00Z,False,1,6,0,0,45,29,16,46,17,29,-1,-1
Ake,30,1,1,2018-08-11T14:00:00Z,True,1,4,90,8,0,0,0,0,0,0,0,0
Ake,30,1,19,2018-08-18T14:00:00Z,False,1,18,90,2,3,3,0,0,0,0,3,0
Ake,30,1,21,2018-08-25T14:00:00Z,True,1,7,90,8,6,3,3,4,3,1,2,2
Ake,30,1,33,2018-09-01T14:00:00Z,False,1,5,90,1,7,4,3,9,3,6,-2,0
Ake,30,1,40,2018-09-15T14:00:00Z,True,1,10,90,1,7,4,3,6,3,3,1,1
Ake,30,1,52,2018-09-22T14:00:00Z,False,1,3,90,0,10,7,3,1,0,1,9,3
Ake,30,1,61,2018-10-01T19:00:00Z,True,1,6,90,2,10,7,3,7,1,6,3,1
Ake,30,1,79,2018-10-06T14:00:00Z,False,1,17,90,6,13,10,3,13,9,4,0,-6
Ake,30,1,81,2018-10-20T14:00:00Z,True,1,15,90,6,16,10,6,5,2,3,11,7
Ake,30,1,93,2018-10-27T14:00:00Z,False,1,8,90,7,17,11,6,5,4,1,12,2
Ake,30,1,101,2018-11-03T12:30:00Z,True,1,13,90,1,20,11,9,17,10,7,3,4
Ake,30,1,118,2018-11-10T15:00:00Z,False,1,14,90,1,20,11,9,6,3,3,14,6
Ake,30,1,120,2018-11-25T13:30:00Z,True,1,0,90,0,20,11,9,24,14,10,-4,1
Ake,30,1,137,2018-12-01T15:00:00Z,False,1,12,90,1,20,11,9,35,21,14,-15,-12
Ake,30,1,140,2018-12-04T19:45:00Z,True,1,9,90,2,20,11,9,10,5,5,10,6
Ake,30,1,151,2018-12-08T12:30:00Z,True,1,11,90,-1,23,14,9,39,19,20,-16,-6
Ake,30,1,169,2018-12-15T15:00:00Z,False,1,19,90,1,23,14,9,22,11,11,1,-2
Ake,30,1,171,2018-12-22T15:00:00Z,True,1,2,90,7,23,14,9,21,14,7,2,7
Ake,30,1,188,2018-12-26T15:00:00Z,False,1,16,90,0,26,17,9,42,15,27,-16,-6
Ake,30,1,196,2018-12-30T16:30:00Z,False,1,13,81,7,26,17,9,32,18,14,-6,-9
Ake,30,1,201,2019-01-02T19:45:00Z,True,1,17,90,7,26,17,9,28,16,12,-2,5
Ake,30,1,215,2019-01-13T14:15:00Z,False,1,7,90,1,27,18,9,27,18,9,0,-9
Ake,30,1,221,2019-01-19T15:00:00Z,True,1,18,90,6,27,18,9,31,17,14,-4,4
Ake,30,1,231,2019-01-30T19:45:00Z,True,1,5,90,6,30,21,9,47,25,22,-17,-1
Ake,30,1,242,2019-02-02T17:30:00Z,False,1,4,90,1,33,24,9,19,14,5,14,-5
Ake,30,1,254,2019-02-09T15:00:00Z,False,1,11,90,1,33,24,9,62,32,30,-29,-23
Ake,30,1,261,2019-02-23T15:00:00Z,True,1,19,90,2,33,24,9,39,21,18,-6,6
Ake,30,1,270,2019-02-27T19:45:00Z,False,1,0,90,0,34,25,9,53,35,18,-19,-26
Ake,30,1,280,2019-03-02T15:00:00Z,True,1,12,90,2,34,25,9,68,42,26,-34,-1
Ake,30,1,294,2019-03-09T15:00:00Z,False,1,9,90,6,34,25,9,14,8,6,20,1
Ake,30,1,300,2019-03-16T15:00:00Z,True,1,14,90,4,37,25,12,34,22,12,3,13
Ake,30,1,316,2019-03-30T15:00:00Z,False,1,10,90,1,38,26,12,41,20,21,-3,-8
Ake,30,1,320,2019-04-06T14:00:00Z,True,1,3,90,1,38,26,12,33,20,13,5,13
Ake,30,1,330,2019-04-13T14:00:00Z,False,1,2,90,5,38,26,12,33,22,11,5,-10
Ake,30,1,341,2019-04-20T14:00:00Z,True,1,8,90,2,41,26,15,20,18,2,21,24
Ake,30,1,357,2019-04-27T14:00:00Z,False,1,15,90,1,41,26,15,37,21,16,4,-6
Ake,30,1,361,2019-05-04T11:30:00Z,True,1,16,90,14,42,26,16,70,37,33,-28,-7
Ake,30,1,372,2019-05-12T14:00:00Z,False,1,6,90,0,45,29,16,46,17,29,-1,-1
Simpson,31,1,1,2018-08-11T14:00:00Z,True,1,4,0,0,0,0,0,0,0,0,0,0
Simpson,31,1,19,2018-08-18T14:00:00Z,False,1,18,0,0,3,3,0,0,0,0,3,0
Simpson,31,1,21,2018-08-25T14:00:00Z,True,1,7,0,0,6,3,3,4,3,1,2,2
Simpson,31,1,33,2018-09-01T14:00:00Z,False,1,5,0,0,7,4,3,9,3,6,-2,0
Simpson,31,1,40,2018-09-15T14:00:00Z,True,1,10,0,0,7,4,3,6,3,3,1,1
Simpson,31,1,52,2018-09-22T14:00:00Z,False,1,3,0,0,10,7,3,1,0,1,9,3
Simpson,31,1,61,2018-10-01T19:00:00Z,True,1,6,0,0,10,7,3,7,1,6,3,1
Simpson,31,1,79,2018-10-06T14:00:00Z,False,1,17,0,0,13,10,3,13,9,4,0,-6
Simpson,31,1,81,2018-10-20T14:00:00Z,True,1,15,0,0,16,10,6,5,2,3,11,7
Simpson,31,1,93,2018-10-27T14:00:00Z,False,1,8,0,0,17,11,6,5,4,1,12,2
Simpson,31,1,101,2018-11-03T12:30:00Z,True,1,13,0,0,20,11,9,17,10,7,3,4
Simpson,31,1,118,2018-11-10T15:00:00Z,False,1,14,0,0,20,11,9,6,3,3,14,6
Simpson,31,1,120,2018-11-25T13:30:00Z,True,1,0,0,0,20,11,9,24,14,10,-4,1
Simpson,31,1,137,2018-12-01T15:00:00Z,False,1,12,0,0,20,11,9,35,21,14,-15,-12
Simpson,31,1,140,2018-12-04T19:45:00Z,True,1,9,0,0,20,11,9,10,5,5,10,6
Simpson,31,1,151,2018-12-08T12:30:00Z,True,1,11,0,0,23,14,9,39,19,20,-16,-6
Simpson,31,1,169,2018-12-15T15:00:00Z,False,1,19,0,0,23,14,9,22,11,11,1,-2
Simpson,31,1,171,2018-12-22T15:00:00Z,True,1,2,0,0,23,14,9,21,14,7,2,7
Simpson,31,1,188,2018-12-26T15:00:00Z,False,1,16,0,0,26,17,9,42,15,27,-16,-6
Simpson,31,1,196,2018-12-30T16:30:00Z,False,1,13,0,0,26,17,9,32,18,14,-6,-9
Simpson,31,1,201,2019-01-02T19:45:00Z,True,1,17,0,0,26,17,9,28,16,12,-2,5
Simpson,31,1,215,2019-01-13T14:15:00Z,False,1,7,0,0,27,18,9,27,18,9,0,-9
Simpson,31,1,221,2019-01-19T15:00:00Z,True,1,18,0,0,27,18,9,31,17,14,-4,4
Simpson,31,1,231,2019-01-30T19:45:00Z,True,1,5,0,0,30,21,9,47,25,22,-17,-1
Simpson,31,1,242,2019-02-02T17:30:00Z,False,1,4,0,0,33,24,9,19,14,5,14,-5
Simpson,31,1,254,2019-02-09T15:00:00Z,False,1,11,0,0,33,24,9,62,32,30,-29,-23
Simpson,31,1,261,2019-02-23T15:00:00Z,True,1,19,0,0,33,24,9,39,21,18,-6,6
Simpson,31,1,270,2019-02-27T19:45:00Z,False,1,0,0,0,34,25,9,53,35,18,-19,-26
Simpson,31,1,280,2019-03-02T15:00:00Z,True,1,12,82,2,34,25,9,68,42,26,-34,-1
Simpson,31,1,294,2019-03-09T15:00:00Z,False,1,9,0,0,34,25,9,14,8,6,20,1
Simpson,31,1,300,2019-03-16T15:00:00Z,True,1,14,0,0,37,25,12,34,22,12,3,13
Simpson,31,1,316,2019-03-30T15:00:00Z,False,1,10,0,0,38,26,12,41,20,21,-3,-8
Simpson,31,1,320,2019-04-06T14:00:00Z,True,1,3,0,0,38,26,12,33,20,13,5,13
Simpson,31,1,330,2019-04-13T14:00:00Z,False,1,2,3,1,38,26,12,33,22,11,5,-10
Simpson,31,1,341,2019-04-20T14:00:00Z,True,1,8,67,2,41,26,15,20,18,2,21,24
Simpson,31,1,357,2019-04-27T14:00:00Z,False,1,15,90,1,41,26,15,37,21,16,4,-6
Simpson,31,1,361,2019-05-04T11:30:00Z,True,1,16,90,6,42,26,16,70,37,33,-28,-7
Simpson,31,1,372,2019-05-12T14:00:00Z,False,1,6,69,-2,45,29,16,46,17,29,-1,-1
Arter,32,2,1,2018-08-11T14:00:00Z,False,4,1,0,0,0,0,0,0,0,0,0,0
Arter,32,2,12,2018-08-18T11:30:00Z,True,4,14,90,2,0,0,0,0,0,0,0,0
Arter,32,2,23,2018-08-25T14:00:00Z,False,4,9,90,2,1,1,0,0,0,0,1,0
Arter,32,2,32,2018-09-02T12:30:00Z,True,4,0,90,1,2,1,1,3,3,0,-1,1
Arter,32,2,41,2018-09-15T14:00:00Z,False,4,5,45,1,2,1,1,12,6,6,-10,-5
Arter,32,2,53,2018-09-22T14:00:00Z,True,4,12,90,2,2,1,1,13,9,4,-11,-3
Arter,32,2,62,2018-09-30T15:00:00Z,True,4,3,90,2,2,1,1,4,3,1,-2,0
Arter,32,2,78,2018-10-06T14:00:00Z,False,4,16,90,1,2,1,1,15,3,12,-13,-2
Arter,32,2,82,2018-10-20T14:00:00Z,True,4,8,85,2,2,1,1,5,4,1,-3,0
Arter,32,2,95,2018-10-27T14:00:00Z,False,4,11,0,0,5,4,1,23,10,13,-18,-9
Arter,32,2,102,2018-11-03T15:00:00Z,True,4,10,78,1,5,4,1,13,7,6,-8,-2
Arter,32,2,111,2018-11-10T12:30:00Z,True,4,2,0,0,5,4,1,14,10,4,-9,0
Arter,32,2,123,2018-11-24T15:00:00Z,False,4,7,73,2,8,7,1,19,13,6,-11,-12
Arter,32,2,131,2018-11-30T20:00:00Z,True,4,19,75,2,8,7,1,16,8,8,-8,-1
Arter,32,2,146,2018-12-04T19:45:00Z,False,4,18,90,2,11,10,1,15,7,8,-4,-6
Arter,32,2,153,2018-12-08T15:00:00Z,True,4,15,90,3,11,10,1,9,5,4,2,6
Arter,32,2,168,2018-12-15T15:00:00Z,False,4,17,90,2,14,13,1,21,12,9,-7,-11
Arter,32,2,172,2018-12-22T17:30:00Z,True,4,13,60,2,14,13,1,26,15,11,-12,2
Arter,32,2,182,2018-12-26T15:00:00Z,False,4,6,1,1,14,13,1,18,8,10,-4,-7
Arter,32,2,194,2018-12-29T15:00:00Z,False,4,10,90,3,15,13,2,28,14,14,-13,-12
Arter,32,2,202,2019-01-01T17:30:00Z,True,4,16,90,2,18,13,5,45,18,27,-27,-14
Arter,32,2,212,2019-01-12T15:00:00Z,True,4,9,90,2,18,13,5,10,5,5,8,8
Arter,32,2,226,2019-01-19T15:00:00Z,False,4,14,0,0,19,14,5,18,7,11,1,-2
Arter,32,2,230,2019-01-29T19:45:00Z,False,4,0,80,1,19,14,5,44,29,15,-25,-24
Arter,32,2,242,2019-02-02T17:30:00Z,True,4,1,0,0,19,14,5,33,24,9,-14,5
Arter,32,2,256,2019-02-09T15:00:00Z,False,4,15,90,2,22,17,5,24,12,12,-2,-7
Arter,32,2,263,2019-02-22T19:45:00Z,True,4,17,90,2,25,17,8,37,20,17,-12,0
Arter,32,2,271,2019-02-26T19:45:00Z,True,4,7,0,0,25,17,8,33,21,12,-8,5
Arter,32,2,289,2019-03-02T15:00:00Z,False,4,19,0,0,25,17,8,40,21,19,-15,-13
Arter,32,2,291,2019-03-09T15:00:00Z,True,4,18,83,2,25,17,8,39,24,15,-14,2
Arter,32,2,313,2019-03-31T13:05:00Z,True,4,5,79,5,28,20,8,57,32,25,-29,-5
Arter,32,2,324,2019-04-03T18:45:00Z,False,4,12,0,0,28,20,8,77,45,32,-49,-37
Arter,32,2,331,2019-04-13T14:00:00Z,False,4,3,80,1,28,20,8,36,20,16,-8,-12
Arter,32,2,301,2019-04-16T18:45:00Z,False,4,2,0,0,28,20,8,33,22,11,-5,-14
Arter,32,2,342,2019-04-21T15:00:00Z,True,4,11,0,0,31,20,11,85,47,38,-54,-18
Arter,32,2,353,2019-04-27T14:00:00Z,False,4,8,0,0,31,20,11,23,18,5,8,-7
Arter,32,2,362,2019-05-04T16:30:00Z,True,4,6,0,0,31,20,11,43,17,26,-12,-6
Arter,32,2,376,2019-05-12T14:00:00Z,False,4,13,0,0,31,20,11,66,36,30,-35,-25
Pugh,33,2,1,2018-08-11T14:00:00Z,True,1,4,0,0,0,0,0,0,0,0,0,0
Pugh,33,2,19,2018-08-18T14:00:00Z,False,1,18,0,0,3,3,0,0,0,0,3,0
Pugh,33,2,21,2018-08-25T14:00:00Z,True,1,7,0,0,6,3,3,4,3,1,2,2
Pugh,33,2,33,2018-09-01T14:00:00Z,False,1,5,0,0,7,4,3,9,3,6,-2,0
Pugh,33,2,40,2018-09-15T14:00:00Z,True,1,10,0,0,7,4,3,6,3,3,1,1
Pugh,33,2,52,2018-09-22T14:00:00Z,False,1,3,0,0,10,7,3,1,0,1,9,3
Pugh,33,2,61,2018-10-01T19:00:00Z,True,1,6,0,0,10,7,3,7,1,6,3,1
Pugh,33,2,79,2018-10-06T14:00:00Z,False,1,17,0,0,13,10,3,13,9,4,0,-6
Pugh,33,2,81,2018-10-20T14:00:00Z,True,1,15,0,0,16,10,6,5,2,3,11,7
Pugh,33,2,93,2018-10-27T14:00:00Z,False,1,8,0,0,17,11,6,5,4,1,12,2
Pugh,33,2,101,2018-11-03T12:30:00Z,True,1,13,0,0,20,11,9,17,10,7,3,4
Pugh,33,2,118,2018-11-10T15:00:00Z,False,1,14,0,0,20,11,9,6,3,3,14,6
Pugh,33,2,120,2018-11-25T13:30:00Z,True,1,0,0,0,20,11,9,24,14,10,-4,1
Pugh,33,2,137,2018-12-01T15:00:00Z,False,1,12,0,0,20,11,9,35,21,14,-15,-12
Pugh,33,2,140,2018-12-04T19:45:00Z,True,1,9,0,0,20,11,9,10,5,5,10,6
Pugh,33,2,151,2018-12-08T12:30:00Z,True,1,11,0,0,23,14,9,39,19,20,-16,-6
Pugh,33,2,169,2018-12-15T15:00:00Z,False,1,19,0,0,23,14,9,22,11,11,1,-2
Pugh,33,2,171,2018-12-22T15:00:00Z,True,1,2,0,0,23,14,9,21,14,7,2,7
Pugh,33,2,188,2018-12-26T15:00:00Z,False,1,16,0,0,26,17,9,42,15,27,-16,-6
Pugh,33,2,196,2018-12-30T16:30:00Z,False,1,13,0,0,26,17,9,32,18,14,-6,-9
Pugh,33,2,201,2019-01-02T19:45:00Z,True,1,17,0,0,26,17,9,28,16,12,-2,5
Pugh,33,2,215,2019-01-13T14:15:00Z,False,1,7,0,0,27,18,9,27,18,9,0,-9
Pugh,33,2,221,2019-01-19T15:00:00Z,True,1,18,0,0,27,18,9,31,17,14,-4,4
Pugh,33,2,231,2019-01-30T19:45:00Z,True,1,5,0,0,30,21,9,47,25,22,-17,-1
Pugh,33,2,242,2019-02-02T17:30:00Z,False,1,4,0,0,33,24,9,19,14,5,14,-5
Pugh,33,2,254,2019-02-09T15:00:00Z,False,1,11,0,0,33,24,9,62,32,30,-29,-23
Pugh,33,2,261,2019-02-23T15:00:00Z,True,1,19,0,0,33,24,9,39,21,18,-6,6
Pugh,33,2,270,2019-02-27T19:45:00Z,False,1,0,0,0,34,25,9,53,35,18,-19,-26
Pugh,33,2,280,2019-03-02T15:00:00Z,True,1,12,0,0,34,25,9,68,42,26,-34,-1
Pugh,33,2,294,2019-03-09T15:00:00Z,False,1,9,0,0,34,25,9,14,8,6,20,1
Pugh,33,2,300,2019-03-16T15:00:00Z,True,1,14,0,0,37,25,12,34,22,12,3,13
Pugh,33,2,316,2019-03-30T15:00:00Z,False,1,10,0,0,38,26,12,41,20,21,-3,-8
Pugh,33,2,320,2019-04-06T14:00:00Z,True,1,3,0,0,38,26,12,33,20,13,5,13
Pugh,33,2,330,2019-04-13T14:00:00Z,False,1,2,0,0,38,26,12,33,22,11,5,-10
Pugh,33,2,341,2019-04-20T14:00:00Z,True,1,8,0,0,41,26,15,20,18,2,21,24
Pugh,33,2,357,2019-04-27T14:00:00Z,False,1,15,0,0,41,26,15,37,21,16,4,-6
Pugh,33,2,361,2019-05-04T11:30:00Z,True,1,16,0,0,42,26,16,70,37,33,-28,-7
Pugh,33,2,372,2019-05-12T14:00:00Z,False,1,6,0,0,45,29,16,46,17,29,-1,-1
Surman,34,2,1,2018-08-11T14:00:00Z,True,1,4,90,3,0,0,0,0,0,0,0,0
Surman,34,2,19,2018-08-18T14:00:00Z,False,1,18,90,2,3,3,0,0,0,0,3,0
Surman,34,2,21,2018-08-25T14:00:00Z,True,1,7,75,2,6,3,3,4,3,1,2,2
Surman,34,2,33,2018-09-01T14:00:00Z,False,1,5,0,0,7,4,3,9,3,6,-2,0
Surman,34,2,40,2018-09-15T14:00:00Z,True,1,10,0,0,7,4,3,6,3,3,1,1
Surman,34,2,52,2018-09-22T14:00:00Z,False,1,3,90,2,10,7,3,1,0,1,9,3
Surman,34,2,61,2018-10-01T19:00:00Z,True,1,6,0,0,10,7,3,7,1,6,3,1
Surman,34,2,79,2018-10-06T14:00:00Z,False,1,17,12,0,13,10,3,13,9,4,0,-6
Surman,34,2,81,2018-10-20T14:00:00Z,True,1,15,0,0,16,10,6,5,2,3,11,7
Surman,34,2,93,2018-10-27T14:00:00Z,False,1,8,0,0,17,11,6,5,4,1,12,2
Surman,34,2,101,2018-11-03T12:30:00Z,True,1,13,1,1,20,11,9,17,10,7,3,4
Surman,34,2,118,2018-11-10T15:00:00Z,False,1,14,0,0,20,11,9,6,3,3,14,6
Surman,34,2,120,2018-11-25T13:30:00Z,True,1,0,0,0,20,11,9,24,14,10,-4,1
Surman,34,2,137,2018-12-01T15:00:00Z,False,1,12,90,2,20,11,9,35,21,14,-15,-12
Surman,34,2,140,2018-12-04T19:45:00Z,True,1,9,0,0,20,11,9,10,5,5,10,6
Surman,34,2,151,2018-12-08T12:30:00Z,True,1,11,90,2,23,14,9,39,19,20,-16,-6
Surman,34,2,169,2018-12-15T15:00:00Z,False,1,19,90,2,23,14,9,22,11,11,1,-2
Surman,34,2,171,2018-12-22T15:00:00Z,True,1,2,90,3,23,14,9,21,14,7,2,7
Surman,34,2,188,2018-12-26T15:00:00Z,False,1,16,90,2,26,17,9,42,15,27,-16,-6
Surman,34,2,196,2018-12-30T16:30:00Z,False,1,13,90,2,26,17,9,32,18,14,-6,-9
Surman,34,2,201,2019-01-02T19:45:00Z,True,1,17,0,0,26,17,9,28,16,12,-2,5
Surman,34,2,215,2019-01-13T14:15:00Z,False,1,7,0,0,27,18,9,27,18,9,0,-9
Surman,34,2,221,2019-01-19T15:00:00Z,True,1,18,0,0,27,18,9,31,17,14,-4,4
Surman,34,2,231,2019-01-30T19:45:00Z,True,1,5,90,2,30,21,9,47,25,22,-17,-1
Surman,34,2,242,2019-02-02T17:30:00Z,False,1,4,90,2,33,24,9,19,14,5,14,-5
Surman,34,2,254,2019-02-09T15:00:00Z,False,1,11,90,2,33,24,9,62,32,30,-29,-23
Surman,34,2,261,2019-02-23T15:00:00Z,True,1,19,0,0,33,24,9,39,21,18,-6,6
Surman,34,2,270,2019-02-27T19:45:00Z,False,1,0,90,2,34,25,9,53,35,18,-19,-26
Surman,34,2,280,2019-03-02T15:00:00Z,True,1,12,90,2,34,25,9,68,42,26,-34,-1
Surman,34,2,294,2019-03-09T15:00:00Z,False,1,9,90,3,34,25,9,14,8,6,20,1
Surman,34,2,300,2019-03-16T15:00:00Z,True,1,14,0,0,37,25,12,34,22,12,3,13
Surman,34,2,316,2019-03-30T15:00:00Z,False,1,10,0,0,38,26,12,41,20,21,-3,-8
Surman,34,2,320,2019-04-06T14:00:00Z,True,1,3,0,0,38,26,12,33,20,13,5,13
Surman,34,2,330,2019-04-13T14:00:00Z,False,1,2,0,0,38,26,12,33,22,11,5,-10
Surman,34,2,341,2019-04-20T14:00:00Z,True,1,8,0,0,41,26,15,20,18,2,21,24
Surman,34,2,357,2019-04-27T14:00:00Z,False,1,15,0,0,41,26,15,37,21,16,4,-6
Surman,34,2,361,2019-05-04T11:30:00Z,True,1,16,0,0,42,26,16,70,37,33,-28,-7
Surman,34,2,372,2019-05-12T14:00:00Z,False,1,6,0,0,45,29,16,46,17,29,-1,-1
Stanislas,35,2,1,2018-08-11T14:00:00Z,True,1,4,0,0,0,0,0,0,0,0,0,0
Stanislas,35,2,19,2018-08-18T14:00:00Z,False,1,18,0,0,3,3,0,0,0,0,3,0
Stanislas,35,2,21,2018-08-25T14:00:00Z,True,1,7,0,0,6,3,3,4,3,1,2,2
Stanislas,35,2,33,2018-09-01T14:00:00Z,False,1,5,0,0,7,4,3,9,3,6,-2,0
Stanislas,35,2,40,2018-09-15T14:00:00Z,True,1,10,0,0,7,4,3,6,3,3,1,1
Stanislas,35,2,52,2018-09-22T14:00:00Z,False,1,3,22,1,10,7,3,1,0,1,9,3
Stanislas,35,2,61,2018-10-01T19:00:00Z,True,1,6,6,9,10,7,3,7,1,6,3,1
Stanislas,35,2,79,2018-10-06T14:00:00Z,False,1,17,24,1,13,10,3,13,9,4,0,-6
Stanislas,35,2,81,2018-10-20T14:00:00Z,True,1,15,31,1,16,10,6,5,2,3,11,7
Stanislas,35,2,93,2018-10-27T14:00:00Z,False,1,8,4,1,17,11,6,5,4,1,12,2
Stanislas,35,2,101,2018-11-03T12:30:00Z,True,1,13,90,4,20,11,9,17,10,7,3,4
Stanislas,35,2,118,2018-11-10T15:00:00Z,False,1,14,0,0,20,11,9,6,3,3,14,6
Stanislas,35,2,120,2018-11-25T13:30:00Z,True,1,0,17,1,20,11,9,24,14,10,-4,1
Stanislas,35,2,137,2018-12-01T15:00:00Z,False,1,12,5,1,20,11,9,35,21,14,-15,-12
Stanislas,35,2,140,2018-12-04T19:45:00Z,True,1,9,28,1,20,11,9,10,5,5,10,6
Stanislas,35,2,151,2018-12-08T12:30:00Z,True,1,11,82,2,23,14,9,39,19,20,-16,-6
Stanislas,35,2,169,2018-12-15T15:00:00Z,False,1,19,79,2,23,14,9,22,11,11,1,-2
Stanislas,35,2,171,2018-12-22T15:00:00Z,True,1,2,64,3,23,14,9,21,14,7,2,7
Stanislas,35,2,188,2018-12-26T15:00:00Z,False,1,16,90,2,26,17,9,42,15,27,-16,-6
Stanislas,35,2,196,2018-12-30T16:30:00Z,False,1,13,90,2,26,17,9,32,18,14,-6,-9
Stanislas,35,2,201,2019-01-02T19:45:00Z,True,1,17,90,5,26,17,9,28,16,12,-2,5
Stanislas,35,2,215,2019-01-13T14:15:00Z,False,1,7,67,2,27,18,9,27,18,9,0,-9
Stanislas,35,2,221,2019-01-19T15:00:00Z,True,1,18,17,1,27,18,9,31,17,14,-4,4
Stanislas,35,2,231,2019-01-30T19:45:00Z,True,1,5,90,6,30,21,9,47,25,22,-17,-1
Stanislas,35,2,242,2019-02-02T17:30:00Z,False,1,4,61,2,33,24,9,19,14,5,14,-5
Stanislas,35,2,254,2019-02-09T15:00:00Z,False,1,11,0,0,33,24,9,62,32,30,-29,-23
Stanislas,35,2,261,2019-02-23T15:00:00Z,True,1,19,0,0,33,24,9,39,21,18,-6,6
Stanislas,35,2,270,2019-02-27T19:45:00Z,False,1,0,0,0,34,25,9,53,35,18,-19,-26
Stanislas,35,2,280,2019-03-02T15:00:00Z,True,1,12,0,0,34,25,9,68,42,26,-34,-1
Stanislas,35,2,294,2019-03-09T15:00:00Z,False,1,9,0,0,34,25,9,14,8,6,20,1
Stanislas,35,2,300,2019-03-16T15:00:00Z,True,1,14,0,0,37,25,12,34,22,12,3,13
Stanislas,35,2,316,2019-03-30T15:00:00Z,False,1,10,16,1,38,26,12,41,20,21,-3,-8
Stanislas,35,2,320,2019-04-06T14:00:00Z,True,1,3,19,1,38,26,12,33,20,13,5,13
Stanislas,35,2,330,2019-04-13T14:00:00Z,False,1,2,7,6,38,26,12,33,22,11,5,-10
Stanislas,35,2,341,2019-04-20T14:00:00Z,True,1,8,22,1,41,26,15,20,18,2,21,24
Stanislas,35,2,357,2019-04-27T14:00:00Z,False,1,15,0,0,41,26,15,37,21,16,4,-6
Stanislas,35,2,361,2019-05-04T11:30:00Z,True,1,16,0,0,42,26,16,70,37,33,-28,-7
Stanislas,35,2,372,2019-05-12T14:00:00Z,False,1,6,0,0,45,29,16,46,17,29,-1,-1
Gosling,36,2,1,2018-08-11T14:00:00Z,True,1,4,90,3,0,0,0,0,0,0,0,0
Gosling,36,2,19,2018-08-18T14:00:00Z,False,1,18,90,1,3,3,0,0,0,0,3,0
Gosling,36,2,21,2018-08-25T14:00:00Z,True,1,7,90,2,6,3,3,4,3,1,2,2
Gosling,36,2,33,2018-09-01T14:00:00Z,False,1,5,90,1,7,4,3,9,3,6,-2,0
Gosling,36,2,40,2018-09-15T14:00:00Z,True,1,10,90,1,7,4,3,6,3,3,1,1
Gosling,36,2,52,2018-09-22T14:00:00Z,False,1,3,0,0,10,7,3,1,0,1,9,3
Gosling,36,2,61,2018-10-01T19:00:00Z,True,1,6,32,1,10,7,3,7,1,6,3,1
Gosling,36,2,79,2018-10-06T14:00:00Z,False,1,17,20,1,13,10,3,13,9,4,0,-6
Gosling,36,2,81,2018-10-20T14:00:00Z,True,1,15,5,1,16,10,6,5,2,3,11,7
Gosling,36,2,93,2018-10-27T14:00:00Z,False,1,8,10,1,17,11,6,5,4,1,12,2
Gosling,36,2,101,2018-11-03T12:30:00Z,True,1,13,22,1,20,11,9,17,10,7,3,4
Gosling,36,2,118,2018-11-10T15:00:00Z,False,1,14,45,1,20,11,9,6,3,3,14,6
Gosling,36,2,120,2018-11-25T13:30:00Z,True,1,0,72,2,20,11,9,24,14,10,-4,1
Gosling,36,2,137,2018-12-01T15:00:00Z,False,1,12,0,0,20,11,9,35,21,14,-15,-12
Gosling,36,2,140,2018-12-04T19:45:00Z,True,1,9,0,0,20,11,9,10,5,5,10,6
Gosling,36,2,151,2018-12-08T12:30:00Z,True,1,11,0,0,23,14,9,39,19,20,-16,-6
Gosling,36,2,169,2018-12-15T15:00:00Z,False,1,19,0,0,23,14,9,22,11,11,1,-2
Gosling,36,2,171,2018-12-22T15:00:00Z,True,1,2,0,0,23,14,9,21,14,7,2,7
Gosling,36,2,188,2018-12-26T15:00:00Z,False,1,16,0,0,26,17,9,42,15,27,-16,-6
Gosling,36,2,196,2018-12-30T16:30:00Z,False,1,13,0,0,26,17,9,32,18,14,-6,-9
Gosling,36,2,201,2019-01-02T19:45:00Z,True,1,17,90,4,26,17,9,28,16,12,-2,5
Gosling,36,2,215,2019-01-13T14:15:00Z,False,1,7,90,2,27,18,9,27,18,9,0,-9
Gosling,36,2,221,2019-01-19T15:00:00Z,True,1,18,90,3,27,18,9,31,17,14,-4,4
Gosling,36,2,231,2019-01-30T19:45:00Z,True,1,5,90,3,30,21,9,47,25,22,-17,-1
Gosling,36,2,242,2019-02-02T17:30:00Z,False,1,4,68,2,33,24,9,19,14,5,14,-5
Gosling,36,2,254,2019-02-09T15:00:00Z,False,1,11,90,2,33,24,9,62,32,30,-29,-23
Gosling,36,2,261,2019-02-23T15:00:00Z,True,1,19,90,1,33,24,9,39,21,18,-6,6
Gosling,36,2,270,2019-02-27T19:45:00Z,False,1,0,90,5,34,25,9,53,35,18,-19,-26
Gosling,36,2,280,2019-03-02T15:00:00Z,True,1,12,0,0,34,25,9,68,42,26,-34,-1
Gosling,36,2,294,2019-03-09T15:00:00Z,False,1,9,0,0,34,25,9,14,8,6,20,1
Gosling,36,2,300,2019-03-16T15:00:00Z,True,1,14,0,0,37,25,12,34,22,12,3,13
Gosling,36,2,316,2019-03-30T15:00:00Z,False,1,10,90,1,38,26,12,41,20,21,-3,-8
Gosling,36,2,320,2019-04-06T14:00:00Z,True,1,3,58,1,38,26,12,33,20,13,5,13
Gosling,36,2,330,2019-04-13T14:00:00Z,False,1,2,90,7,38,26,12,33,22,11,5,-10
Gosling,36,2,341,2019-04-20T14:00:00Z,True,1,8,90,2,41,26,15,20,18,2,21,24
Gosling,36,2,357,2019-04-27T14:00:00Z,False,1,15,52,5,41,26,15,37,21,16,4,-6
Gosling,36,2,361,2019-05-04T11:30:00Z,True,1,16,0,0,42,26,16,70,37,33,-28,-7
Gosling,36,2,372,2019-05-12T14:00:00Z,False,1,6,0,0,45,29,16,46,17,29,-1,-1
Ibe,37,2,1,2018-08-11T14:00:00Z,True,1,4,0,0,0,0,0,0,0,0,0,0
Ibe,37,2,19,2018-08-18T14:00:00Z,False,1,18,0,0,3,3,0,0,0,0,3,0
Ibe,37,2,21,2018-08-25T14:00:00Z,True,1,7,26,1,6,3,3,4,3,1,2,2
Ibe,37,2,33,2018-09-01T14:00:00Z,False,1,5,10,1,7,4,3,9,3,6,-2,0
Ibe,37,2,40,2018-09-15T14:00:00Z,True,1,10,0,0,7,4,3,6,3,3,1,1
Ibe,37,2,52,2018-09-22T14:00:00Z,False,1,3,0,0,10,7,3,1,0,1,9,3
Ibe,37,2,61,2018-10-01T19:00:00Z,True,1,6,0,0,10,7,3,7,1,6,3,1
Ibe,37,2,79,2018-10-06T14:00:00Z,False,1,17,0,0,13,10,3,13,9,4,0,-6
Ibe,37,2,81,2018-10-20T14:00:00Z,True,1,15,13,1,16,10,6,5,2,3,11,7
Ibe,37,2,93,2018-10-27T14:00:00Z,False,1,8,0,0,17,11,6,5,4,1,12,2
Ibe,37,2,101,2018-11-03T12:30:00Z,True,1,13,16,1,20,11,9,17,10,7,3,4
Ibe,37,2,118,2018-11-10T15:00:00Z,False,1,14,81,2,20,11,9,6,3,3,14,6
Ibe,37,2,120,2018-11-25T13:30:00Z,True,1,0,0,0,20,11,9,24,14,10,-4,1
Ibe,37,2,137,2018-12-01T15:00:00Z,False,1,12,0,0,20,11,9,35,21,14,-15,-12
Ibe,37,2,140,2018-12-04T19:45:00Z,True,1,9,0,0,20,11,9,10,5,5,10,6
Ibe,37,2,151,2018-12-08T12:30:00Z,True,1,11,0,0,23,14,9,39,19,20,-16,-6
Ibe,37,2,169,2018-12-15T15:00:00Z,False,1,19,57,1,23,14,9,22,11,11,1,-2
Ibe,37,2,171,2018-12-22T15:00:00Z,True,1,2,1,1,23,14,9,21,14,7,2,7
Ibe,37,2,188,2018-12-26T15:00:00Z,False,1,16,0,0,26,17,9,42,15,27,-16,-6
Ibe,37,2,196,2018-12-30T16:30:00Z,False,1,13,90,2,26,17,9,32,18,14,-6,-9
Ibe,37,2,201,2019-01-02T19:45:00Z,True,1,17,9,1,26,17,9,28,16,12,-2,5
Ibe,37,2,215,2019-01-13T14:15:00Z,False,1,7,7,1,27,18,9,27,18,9,0,-9
Ibe,37,2,221,2019-01-19T15:00:00Z,True,1,18,0,0,27,18,9,31,17,14,-4,4
Ibe,37,2,231,2019-01-30T19:45:00Z,True,1,5,22,4,30,21,9,47,25,22,-17,-1
Ibe,37,2,242,2019-02-02T17:30:00Z,False,1,4,28,1,33,24,9,19,14,5,14,-5
Ibe,37,2,254,2019-02-09T15:00:00Z,False,1,11,58,1,33,24,9,62,32,30,-29,-23
Ibe,37,2,261,2019-02-23T15:00:00Z,True,1,19,90,2,33,24,9,39,21,18,-6,6
Ibe,37,2,270,2019-02-27T19:45:00Z,False,1,0,55,1,34,25,9,53,35,18,-19,-26
Ibe,37,2,280,2019-03-02T15:00:00Z,True,1,12,7,1,34,25,9,68,42,26,-34,-1
Ibe,37,2,294,2019-03-09T15:00:00Z,False,1,9,0,0,34,25,9,14,8,6,20,1
Ibe,37,2,300,2019-03-16T15:00:00Z,True,1,14,74,1,37,25,12,34,22,12,3,13
Ibe,37,2,316,2019-03-30T15:00:00Z,False,1,10,0,0,38,26,12,41,20,21,-3,-8
Ibe,37,2,320,2019-04-06T14:00:00Z,True,1,3,0,0,38,26,12,33,20,13,5,13
Ibe,37,2,330,2019-04-13T14:00:00Z,False,1,2,0,0,38,26,12,33,22,11,5,-10
Ibe,37,2,341,2019-04-20T14:00:00Z,True,1,8,0,0,41,26,15,20,18,2,21,24
Ibe,37,2,357,2019-04-27T14:00:00Z,False,1,15,0,0,41,26,15,37,21,16,4,-6
Ibe,37,2,361,2019-05-04T11:30:00Z,True,1,16,76,3,42,26,16,70,37,33,-28,-7
Ibe,37,2,372,2019-05-12T14:00:00Z,False,1,6,69,7,45,29,16,46,17,29,-1,-1
Lewis Cook,38,2,1,2018-08-11T14:00:00Z,True,1,4,0,0,0,0,0,0,0,0,0,0
Lewis Cook,38,2,19,2018-08-18T14:00:00Z,False,1,18,1,1,3,3,0,0,0,0,3,0
Lewis Cook,38,2,21,2018-08-25T14:00:00Z,True,1,7,14,1,6,3,3,4,3,1,2,2
Lewis Cook,38,2,33,2018-09-01T14:00:00Z,False,1,5,2,1,7,4,3,9,3,6,-2,0
Lewis Cook,38,2,40,2018-09-15T14:00:00Z,True,1,10,12,1,7,4,3,6,3,3,1,1
Lewis Cook,38,2,52,2018-09-22T14:00:00Z,False,1,3,0,0,10,7,3,1,0,1,9,3
Lewis Cook,38,2,61,2018-10-01T19:00:00Z,True,1,6,90,2,10,7,3,7,1,6,3,1
Lewis Cook,38,2,79,2018-10-06T14:00:00Z,False,1,17,77,3,13,10,3,13,9,4,0,-6
Lewis Cook,38,2,81,2018-10-20T14:00:00Z,True,1,15,90,3,16,10,6,5,2,3,11,7
Lewis Cook,38,2,93,2018-10-27T14:00:00Z,False,1,8,79,3,17,11,6,5,4,1,12,2
Lewis Cook,38,2,101,2018-11-03T12:30:00Z,True,1,13,67,2,20,11,9,17,10,7,3,4
Lewis Cook,38,2,118,2018-11-10T15:00:00Z,False,1,14,90,1,20,11,9,6,3,3,14,6
Lewis Cook,38,2,120,2018-11-25T13:30:00Z,True,1,0,17,1,20,11,9,24,14,10,-4,1
Lewis Cook,38,2,137,2018-12-01T15:00:00Z,False,1,12,90,2,20,11,9,35,21,14,-15,-12
Lewis Cook,38,2,140,2018-12-04T19:45:00Z,True,1,9,90,1,20,11,9,10,5,5,10,6
Lewis Cook,38,2,151,2018-12-08T12:30:00Z,True,1,11,0,0,23,14,9,39,19,20,-16,-6
Lewis Cook,38,2,169,2018-12-15T15:00:00Z,False,1,19,0,0,23,14,9,22,11,11,1,-2
Lewis Cook,38,2,171,2018-12-22T15:00:00Z,True,1,2,0,0,23,14,9,21,14,7,2,7
Lewis Cook,38,2,188,2018-12-26T15:00:00Z,False,1,16,0,0,26,17,9,42,15,27,-16,-6
Lewis Cook,38,2,196,2018-12-30T16:30:00Z,False,1,13,0,0,26,17,9,32,18,14,-6,-9
Lewis Cook,38,2,201,2019-01-02T19:45:00Z,True,1,17,0,0,26,17,9,28,16,12,-2,5
Lewis Cook,38,2,215,2019-01-13T14:15:00Z,False,1,7,0,0,27,18,9,27,18,9,0,-9
Lewis Cook,38,2,221,2019-01-19T15:00:00Z,True,1,18,0,0,27,18,9,31,17,14,-4,4
Lewis Cook,38,2,231,2019-01-30T19:45:00Z,True,1,5,0,0,30,21,9,47,25,22,-17,-1
Lewis Cook,38,2,242,2019-02-02T17:30:00Z,False,1,4,0,0,33,24,9,19,14,5,14,-5
Lewis Cook,38,2,254,2019-02-09T15:00:00Z,False,1,11,0,0,33,24,9,62,32,30,-29,-23
Lewis Cook,38,2,261,2019-02-23T15:00:00Z,True,1,19,0,0,33,24,9,39,21,18,-6,6
Lewis Cook,38,2,270,2019-02-27T19:45:00Z,False,1,0,0,0,34,25,9,53,35,18,-19,-26
Lewis Cook,38,2,280,2019-03-02T15:00:00Z,True,1,12,0,0,34,25,9,68,42,26,-34,-1
Lewis Cook,38,2,294,2019-03-09T15:00:00Z,False,1,9,0,0,34,25,9,14,8,6,20,1
Lewis Cook,38,2,300,2019-03-16T15:00:00Z,True,1,14,0,0,37,25,12,34,22,12,3,13
Lewis Cook,38,2,316,2019-03-30T15:00:00Z,False,1,10,0,0,38,26,12,41,20,21,-3,-8
Lewis Cook,38,2,320,2019-04-06T14:00:00Z,True,1,3,0,0,38,26,12,33,20,13,5,13
Lewis Cook,38,2,330,2019-04-13T14:00:00Z,False,1,2,0,0,38,26,12,33,22,11,5,-10
Lewis Cook,38,2,341,2019-04-20T14:00:00Z,True,1,8,0,0,41,26,15,20,18,2,21,24
Lewis Cook,38,2,357,2019-04-27T14:00:00Z,False,1,15,0,0,41,26,15,37,21,16,4,-6
Lewis Cook,38,2,361,2019-05-04T11:30:00Z,True,1,16,0,0,42,26,16,70,37,33,-28,-7
Lewis Cook,38,2,372,2019-05-12T14:00:00Z,False,1,6,0,0,45,29,16,46,17,29,-1,-1
Fraser,39,2,1,2018-08-11T14:00:00Z,True,1,4,90,11,0,0,0,0,0,0,0,0
Fraser,39,2,19,2018-08-18T14:00:00Z,False,1,18,90,6,3,3,0,0,0,0,3,0
Fraser,39,2,21,2018-08-25T14:00:00Z,True,1,7,90,2,6,3,3,4,3,1,2,2
Fraser,39,2,33,2018-09-01T14:00:00Z,False,1,5,90,2,7,4,3,9,3,6,-2,0
Fraser,39,2,40,2018-09-15T14:00:00Z,True,1,10,90,18,7,4,3,6,3,3,1,1
Fraser,39,2,52,2018-09-22T14:00:00Z,False,1,3,90,2,10,7,3,1,0,1,9,3
Fraser,39,2,61,2018-10-01T19:00:00Z,True,1,6,90,1,10,7,3,7,1,6,3,1
Fraser,39,2,79,2018-10-06T14:00:00Z,False,1,17,65,6,13,10,3,13,9,4,0,-6
Fraser,39,2,81,2018-10-20T14:00:00Z,True,1,15,76,3,16,10,6,5,2,3,11,7
Fraser,39,2,93,2018-10-27T14:00:00Z,False,1,8,88,11,17,11,6,5,4,1,12,2
Fraser,39,2,101,2018-11-03T12:30:00Z,True,1,13,73,2,20,11,9,17,10,7,3,4
Fraser,39,2,118,2018-11-10T15:00:00Z,False,1,14,90,6,20,11,9,6,3,3,14,6
Fraser,39,2,120,2018-11-25T13:30:00Z,True,1,0,90,2,20,11,9,24,14,10,-4,1
Fraser,39,2,137,2018-12-01T15:00:00Z,False,1,12,71,2,20,11,9,35,21,14,-15,-12
Fraser,39,2,140,2018-12-04T19:45:00Z,True,1,9,86,12,20,11,9,10,5,5,10,6
Fraser,39,2,151,2018-12-08T12:30:00Z,True,1,11,90,2,23,14,9,39,19,20,-16,-6
Fraser,39,2,169,2018-12-15T15:00:00Z,False,1,19,90,2,23,14,9,22,11,11,1,-2
Fraser,39,2,171,2018-12-22T15:00:00Z,True,1,2,25,4,23,14,9,21,14,7,2,7
Fraser,39,2,188,2018-12-26T15:00:00Z,False,1,16,90,2,26,17,9,42,15,27,-16,-6
Fraser,39,2,196,2018-12-30T16:30:00Z,False,1,13,24,1,26,17,9,32,18,14,-6,-9
Fraser,39,2,201,2019-01-02T19:45:00Z,True,1,17,81,12,26,17,9,28,16,12,-2,5
Fraser,39,2,215,2019-01-13T14:15:00Z,False,1,7,90,2,27,18,9,27,18,9,0,-9
Fraser,39,2,221,2019-01-19T15:00:00Z,True,1,18,90,3,27,18,9,31,17,14,-4,4
Fraser,39,2,231,2019-01-30T19:45:00Z,True,1,5,90,3,30,21,9,47,25,22,-17,-1
Fraser,39,2,242,2019-02-02T17:30:00Z,False,1,4,90,2,33,24,9,19,14,5,14,-5
Fraser,39,2,254,2019-02-09T15:00:00Z,False,1,11,90,2,33,24,9,62,32,30,-29,-23
Fraser,39,2,261,2019-02-23T15:00:00Z,True,1,19,90,3,33,24,9,39,21,18,-6,6
Fraser,39,2,270,2019-02-27T19:45:00Z,False,1,0,79,2,34,25,9,53,35,18,-19,-26
Fraser,39,2,280,2019-03-02T15:00:00Z,True,1,12,90,2,34,25,9,68,42,26,-34,-1
Fraser,39,2,294,2019-03-09T15:00:00Z,False,1,9,90,13,34,25,9,14,8,6,20,1
Fraser,39,2,300,2019-03-16T15:00:00Z,True,1,14,90,2,37,25,12,34,22,12,3,13
Fraser,39,2,316,2019-03-30T15:00:00Z,False,1,10,90,2,38,26,12,41,20,21,-3,-8
Fraser,39,2,320,2019-04-06T14:00:00Z,True,1,3,90,2,38,26,12,33,20,13,5,13
Fraser,39,2,330,2019-04-13T14:00:00Z,False,1,2,90,16,38,26,12,33,22,11,5,-10
Fraser,39,2,341,2019-04-20T14:00:00Z,True,1,8,90,2,41,26,15,20,18,2,21,24
Fraser,39,2,357,2019-04-27T14:00:00Z,False,1,15,67,5,41,26,15,37,21,16,4,-6
Fraser,39,2,361,2019-05-04T11:30:00Z,True,1,16,90,9,42,26,16,70,37,33,-28,-7
Fraser,39,2,372,2019-05-12T14:00:00Z,False,1,6,90,2,45,29,16,46,17,29,-1,-1
Hyndman,40,2,1,2018-08-11T14:00:00Z,True,1,4,0,0,0,0,0,0,0,0,0,0
Hyndman,40,2,19,2018-08-18T14:00:00Z,False,1,18,0,0,3,3,0,0,0,0,3,0
Hyndman,40,2,21,2018-08-25T14:00:00Z,True,1,7,0,0,6,3,3,4,3,1,2,2
Hyndman,40,2,33,2018-09-01T14:00:00Z,False,1,5,0,0,7,4,3,9,3,6,-2,0
Hyndman,40,2,40,2018-09-15T14:00:00Z,True,1,10,0,0,7,4,3,6,3,3,1,1
Hyndman,40,2,52,2018-09-22T14:00:00Z,False,1,3,0,0,10,7,3,1,0,1,9,3
Hyndman,40,2,61,2018-10-01T19:00:00Z,True,1,6,0,0,10,7,3,7,1,6,3,1
Hyndman,40,2,79,2018-10-06T14:00:00Z,False,1,17,0,0,13,10,3,13,9,4,0,-6
Hyndman,40,2,81,2018-10-20T14:00:00Z,True,1,15,0,0,16,10,6,5,2,3,11,7
Hyndman,40,2,93,2018-10-27T14:00:00Z,False,1,8,0,0,17,11,6,5,4,1,12,2
Hyndman,40,2,101,2018-11-03T12:30:00Z,True,1,13,0,0,20,11,9,17,10,7,3,4
Hyndman,40,2,118,2018-11-10T15:00:00Z,False,1,14,0,0,20,11,9,6,3,3,14,6
Hyndman,40,2,120,2018-11-25T13:30:00Z,True,1,0,0,0,20,11,9,24,14,10,-4,1
Hyndman,40,2,137,2018-12-01T15:00:00Z,False,1,12,0,0,20,11,9,35,21,14,-15,-12
Hyndman,40,2,140,2018-12-04T19:45:00Z,True,1,9,0,0,20,11,9,10,5,5,10,6
Hyndman,40,2,151,2018-12-08T12:30:00Z,True,1,11,0,0,23,14,9,39,19,20,-16,-6
Hyndman,40,2,169,2018-12-15T15:00:00Z,False,1,19,0,0,23,14,9,22,11,11,1,-2
Hyndman,40,2,171,2018-12-22T15:00:00Z,True,1,2,0,0,23,14,9,21,14,7,2,7
Hyndman,40,2,188,2018-12-26T15:00:00Z,False,1,16,0,0,26,17,9,42,15,27,-16,-6
Hyndman,40,2,196,2018-12-30T16:30:00Z,False,1,13,0,0,26,17,9,32,18,14,-6,-9
Hyndman,40,2,201,2019-01-02T19:45:00Z,True,1,17,0,0,26,17,9,28,16,12,-2,5
Hyndman,40,2,215,2019-01-13T14:15:00Z,False,1,7,0,0,27,18,9,27,18,9,0,-9
Hyndman,40,2,221,2019-01-19T15:00:00Z,True,1,18,0,0,27,18,9,31,17,14,-4,4
Hyndman,40,2,231,2019-01-30T19:45:00Z,True,1,5,0,0,30,21,9,47,25,22,-17,-1
Hyndman,40,2,242,2019-02-02T17:30:00Z,False,1,4,0,0,33,24,9,19,14,5,14,-5
Hyndman,40,2,254,2019-02-09T15:00:00Z,False,1,11,0,0,33,24,9,62,32,30,-29,-23
Hyndman,40,2,261,2019-02-23T15:00:00Z,True,1,19,0,0,33,24,9,39,21,18,-6,6
Hyndman,40,2,270,2019-02-27T19:45:00Z,False,1,0,0,0,34,25,9,53,35,18,-19,-26
Hyndman,40,2,280,2019-03-02T15:00:00Z,True,1,12,0,0,34,25,9,68,42,26,-34,-1
Hyndman,40,2,294,2019-03-09T15:00:00Z,False,1,9,0,0,34,25,9,14,8,6,20,1
Hyndman,40,2,300,2019-03-16T15:00:00Z,True,1,14,0,0,37,25,12,34,22,12,3,13
Hyndman,40,2,316,2019-03-30T15:00:00Z,False,1,10,0,0,38,26,12,41,20,21,-3,-8
Hyndman,40,2,320,2019-04-06T14:00:00Z,True,1,3,0,0,38,26,12,33,20,13,5,13
Hyndman,40,2,330,2019-04-13T14:00:00Z,False,1,2,0,0,38,26,12,33,22,11,5,-10
Hyndman,40,2,341,2019-04-20T14:00:00Z,True,1,8,0,0,41,26,15,20,18,2,21,24
Hyndman,40,2,357,2019-04-27T14:00:00Z,False,1,15,37,1,41,26,15,37,21,16,4,-6
Hyndman,40,2,361,2019-05-04T11:30:00Z,True,1,16,0,0,42,26,16,70,37,33,-28,-7
Hyndman,40,2,372,2019-05-12T14:00:00Z,False,1,6,0,0,45,29,16,46,17,29,-1,-1
Brooks,41,2,1,2018-08-11T14:00:00Z,True,1,4,66,3,0,0,0,0,0,0,0,0
Brooks,41,2,19,2018-08-18T14:00:00Z,False,1,18,77,2,3,3,0,0,0,0,3,0
Brooks,41,2,21,2018-08-25T14:00:00Z,True,1,7,64,2,6,3,3,4,3,1,2,2
Brooks,41,2,33,2018-09-01T14:00:00Z,False,1,5,0,0,7,4,3,9,3,6,-2,0
Brooks,41,2,40,2018-09-15T14:00:00Z,True,1,10,67,3,7,4,3,6,3,3,1,1
Brooks,41,2,52,2018-09-22T14:00:00Z,False,1,3,90,2,10,7,3,1,0,1,9,3
Brooks,41,2,61,2018-10-01T19:00:00Z,True,1,6,57,6,10,7,3,7,1,6,3,1
Brooks,41,2,79,2018-10-06T14:00:00Z,False,1,17,69,9,13,10,3,13,9,4,0,-6
Brooks,41,2,81,2018-10-20T14:00:00Z,True,1,15,58,1,16,10,6,5,2,3,11,7
Brooks,41,2,93,2018-10-27T14:00:00Z,False,1,8,85,8,17,11,6,5,4,1,12,2
Brooks,41,2,101,2018-11-03T12:30:00Z,True,1,13,90,2,20,11,9,17,10,7,3,4
Brooks,41,2,118,2018-11-10T15:00:00Z,False,1,14,90,2,20,11,9,6,3,3,14,6
Brooks,41,2,120,2018-11-25T13:30:00Z,True,1,0,72,5,20,11,9,24,14,10,-4,1
Brooks,41,2,137,2018-12-01T15:00:00Z,False,1,12,18,1,20,11,9,35,21,14,-15,-12
Brooks,41,2,140,2018-12-04T19:45:00Z,True,1,9,61,2,20,11,9,10,5,5,10,6
Brooks,41,2,151,2018-12-08T12:30:00Z,True,1,11,64,2,23,14,9,39,19,20,-16,-6
Brooks,41,2,169,2018-12-15T15:00:00Z,False,1,19,0,0,23,14,9,22,11,11,1,-2
Brooks,41,2,171,2018-12-22T15:00:00Z,True,1,2,90,15,23,14,9,21,14,7,2,7
Brooks,41,2,188,2018-12-26T15:00:00Z,False,1,16,73,2,26,17,9,42,15,27,-16,-6
Brooks,41,2,196,2018-12-30T16:30:00Z,False,1,13,65,5,26,17,9,32,18,14,-6,-9
Brooks,41,2,201,2019-01-02T19:45:00Z,True,1,17,90,2,26,17,9,28,16,12,-2,5
Brooks,41,2,215,2019-01-13T14:15:00Z,False,1,7,82,2,27,18,9,27,18,9,0,-9
Brooks,41,2,221,2019-01-19T15:00:00Z,True,1,18,90,6,27,18,9,31,17,14,-4,4
Brooks,41,2,231,2019-01-30T19:45:00Z,True,1,5,67,12,30,21,9,47,25,22,-17,-1
Brooks,41,2,242,2019-02-02T17:30:00Z,False,1,4,0,0,33,24,9,19,14,5,14,-5
Brooks,41,2,254,2019-02-09T15:00:00Z,False,1,11,0,0,33,24,9,62,32,30,-29,-23
Brooks,41,2,261,2019-02-23T15:00:00Z,True,1,19,0,0,33,24,9,39,21,18,-6,6
Brooks,41,2,270,2019-02-27T19:45:00Z,False,1,0,0,0,34,25,9,53,35,18,-19,-26
Brooks,41,2,280,2019-03-02T15:00:00Z,True,1,12,74,2,34,25,9,68,42,26,-34,-1
Brooks,41,2,294,2019-03-09T15:00:00Z,False,1,9,64,3,34,25,9,14,8,6,20,1
Brooks,41,2,300,2019-03-16T15:00:00Z,True,1,14,90,2,37,25,12,34,22,12,3,13
Brooks,41,2,316,2019-03-30T15:00:00Z,False,1,10,90,1,38,26,12,41,20,21,-3,-8
Brooks,41,2,320,2019-04-06T14:00:00Z,True,1,3,90,2,38,26,12,33,20,13,5,13
Brooks,41,2,330,2019-04-13T14:00:00Z,False,1,2,90,12,38,26,12,33,22,11,5,-10
Brooks,41,2,341,2019-04-20T14:00:00Z,True,1,8,90,2,41,26,15,20,18,2,21,24
Brooks,41,2,357,2019-04-27T14:00:00Z,False,1,15,90,5,41,26,15,37,21,16,4,-6
Brooks,41,2,361,2019-05-04T11:30:00Z,True,1,16,0,0,42,26,16,70,37,33,-28,-7
Brooks,41,2,372,2019-05-12T14:00:00Z,False,1,6,0,0,45,29,16,46,17,29,-1,-1
Wilson,42,3,1,2018-08-11T14:00:00Z,True,1,4,90,8,0,0,0,0,0,0,0,0
Wilson,42,3,19,2018-08-18T14:00:00Z,False,1,18,90,6,3,3,0,0,0,0,3,0
Wilson,42,3,21,2018-08-25T14:00:00Z,True,1,7,90,8,6,3,3,4,3,1,2,2
Wilson,42,3,33,2018-09-01T14:00:00Z,False,1,5,90,2,7,4,3,9,3,6,-2,0
Wilson,42,3,40,2018-09-15T14:00:00Z,True,1,10,90,4,7,4,3,6,3,3,1,1
Wilson,42,3,52,2018-09-22T14:00:00Z,False,1,3,67,2,10,7,3,1,0,1,9,3
Wilson,42,3,61,2018-10-01T19:00:00Z,True,1,6,90,5,10,7,3,7,1,6,3,1
Wilson,42,3,79,2018-10-06T14:00:00Z,False,1,17,90,14,13,10,3,13,9,4,0,-6
Wilson,42,3,81,2018-10-20T14:00:00Z,True,1,15,90,1,16,10,6,5,2,3,11,7
Wilson,42,3,93,2018-10-27T14:00:00Z,False,1,8,90,13,17,11,6,5,4,1,12,2
Wilson,42,3,101,2018-11-03T12:30:00Z,True,1,13,90,7,20,11,9,17,10,7,3,4
Wilson,42,3,118,2018-11-10T15:00:00Z,False,1,14,90,2,20,11,9,6,3,3,14,6
Wilson,42,3,120,2018-11-25T13:30:00Z,True,1,0,90,2,20,11,9,24,14,10,-4,1
Wilson,42,3,137,2018-12-01T15:00:00Z,False,1,12,84,6,20,11,9,35,21,14,-15,-12
Wilson,42,3,140,2018-12-04T19:45:00Z,True,1,9,90,12,20,11,9,10,5,5,10,6
Wilson,42,3,151,2018-12-08T12:30:00Z,True,1,11,0,0,23,14,9,39,19,20,-16,-6
Wilson,42,3,169,2018-12-15T15:00:00Z,False,1,19,32,1,23,14,9,22,11,11,1,-2
Wilson,42,3,171,2018-12-22T15:00:00Z,True,1,2,90,2,23,14,9,21,14,7,2,7
Wilson,42,3,188,2018-12-26T15:00:00Z,False,1,16,66,2,26,17,9,42,15,27,-16,-6
Wilson,42,3,196,2018-12-30T16:30:00Z,False,1,13,65,2,26,17,9,32,18,14,-6,-9
Wilson,42,3,201,2019-01-02T19:45:00Z,True,1,17,80,6,26,17,9,28,16,12,-2,5
Wilson,42,3,215,2019-01-13T14:15:00Z,False,1,7,0,0,27,18,9,27,18,9,0,-9
Wilson,42,3,221,2019-01-19T15:00:00Z,True,1,18,72,9,27,18,9,31,17,14,-4,4
Wilson,42,3,231,2019-01-30T19:45:00Z,True,1,5,0,0,30,21,9,47,25,22,-17,-1
Wilson,42,3,242,2019-02-02T17:30:00Z,False,1,4,0,0,33,24,9,19,14,5,14,-5
Wilson,42,3,254,2019-02-09T15:00:00Z,False,1,11,0,0,33,24,9,62,32,30,-29,-23
Wilson,42,3,261,2019-02-23T15:00:00Z,True,1,19,0,0,33,24,9,39,21,18,-6,6
Wilson,42,3,270,2019-02-27T19:45:00Z,False,1,0,0,0,34,25,9,53,35,18,-19,-26
Wilson,42,3,280,2019-03-02T15:00:00Z,True,1,12,0,0,34,25,9,68,42,26,-34,-1
Wilson,42,3,294,2019-03-09T15:00:00Z,False,1,9,90,11,34,25,9,14,8,6,20,1
Wilson,42,3,300,2019-03-16T15:00:00Z,True,1,14,90,2,37,25,12,34,22,12,3,13
Wilson,42,3,316,2019-03-30T15:00:00Z,False,1,10,90,2,38,26,12,41,20,21,-3,-8
Wilson,42,3,320,2019-04-06T14:00:00Z,True,1,3,90,2,38,26,12,33,20,13,5,13
Wilson,42,3,330,2019-04-13T14:00:00Z,False,1,2,82,15,38,26,12,33,22,11,5,-10
Wilson,42,3,341,2019-04-20T14:00:00Z,True,1,8,90,2,41,26,15,20,18,2,21,24
Wilson,42,3,357,2019-04-27T14:00:00Z,False,1,15,90,16,41,26,15,37,21,16,4,-6
Wilson,42,3,361,2019-05-04T11:30:00Z,True,1,16,90,2,42,26,16,70,37,33,-28,-7
Wilson,42,3,372,2019-05-12T14:00:00Z,False,1,6,90,2,45,29,16,46,17,29,-1,-1
Mousset,43,3,1,2018-08-11T14:00:00Z,True,1,4,1,1,0,0,0,0,0,0,0,0
Mousset,43,3,19,2018-08-18T14:00:00Z,False,1,18,0,0,3,3,0,0,0,0,3,0
Mousset,43,3,21,2018-08-25T14:00:00Z,True,1,7,1,1,6,3,3,4,3,1,2,2
Mousset,43,3,33,2018-09-01T14:00:00Z,False,1,5,10,1,7,4,3,9,3,6,-2,0
Mousset,43,3,40,2018-09-15T14:00:00Z,True,1,10,5,1,7,4,3,6,3,3,1,1
Mousset,43,3,52,2018-09-22T14:00:00Z,False,1,3,0,0,10,7,3,1,0,1,9,3
Mousset,43,3,61,2018-10-01T19:00:00Z,True,1,6,0,0,10,7,3,7,1,6,3,1
Mousset,43,3,79,2018-10-06T14:00:00Z,False,1,17,0,0,13,10,3,13,9,4,0,-6
Mousset,43,3,81,2018-10-20T14:00:00Z,True,1,15,0,0,16,10,6,5,2,3,11,7
Mousset,43,3,93,2018-10-27T14:00:00Z,False,1,8,0,0,17,11,6,5,4,1,12,2
Mousset,43,3,101,2018-11-03T12:30:00Z,True,1,13,0,0,20,11,9,17,10,7,3,4
Mousset,43,3,118,2018-11-10T15:00:00Z,False,1,14,0,0,20,11,9,6,3,3,14,6
Mousset,43,3,120,2018-11-25T13:30:00Z,True,1,0,8,1,20,11,9,24,14,10,-4,1
Mousset,43,3,137,2018-12-01T15:00:00Z,False,1,12,5,1,20,11,9,35,21,14,-15,-12
Mousset,43,3,140,2018-12-04T19:45:00Z,True,1,9,3,0,20,11,9,10,5,5,10,6
Mousset,43,3,151,2018-12-08T12:30:00Z,True,1,11,25,1,23,14,9,39,19,20,-16,-6
Mousset,43,3,169,2018-12-15T15:00:00Z,False,1,19,10,1,23,14,9,22,11,11,1,-2
Mousset,43,3,171,2018-12-22T15:00:00Z,True,1,2,4,1,23,14,9,21,14,7,2,7
Mousset,43,3,188,2018-12-26T15:00:00Z,False,1,16,23,1,26,17,9,42,15,27,-16,-6
Mousset,43,3,196,2018-12-30T16:30:00Z,False,1,13,24,1,26,17,9,32,18,14,-6,-9
Mousset,43,3,201,2019-01-02T19:45:00Z,True,1,17,8,1,26,17,9,28,16,12,-2,5
Mousset,43,3,215,2019-01-13T14:15:00Z,False,1,7,22,1,27,18,9,27,18,9,0,-9
Mousset,43,3,221,2019-01-19T15:00:00Z,True,1,18,1,1,27,18,9,31,17,14,-4,4
Mousset,43,3,231,2019-01-30T19:45:00Z,True,1,5,0,0,30,21,9,47,25,22,-17,-1
Mousset,43,3,242,2019-02-02T17:30:00Z,False,1,4,28,1,33,24,9,19,14,5,14,-5
Mousset,43,3,254,2019-02-09T15:00:00Z,False,1,11,17,1,33,24,9,62,32,30,-29,-23
Mousset,43,3,261,2019-02-23T15:00:00Z,True,1,19,1,1,33,24,9,39,21,18,-6,6
Mousset,43,3,270,2019-02-27T19:45:00Z,False,1,0,90,6,34,25,9,53,35,18,-19,-26
Mousset,43,3,280,2019-03-02T15:00:00Z,True,1,12,15,1,34,25,9,68,42,26,-34,-1
Mousset,43,3,294,2019-03-09T15:00:00Z,False,1,9,1,1,34,25,9,14,8,6,20,1
Mousset,43,3,300,2019-03-16T15:00:00Z,True,1,14,0,0,37,25,12,34,22,12,3,13
Mousset,43,3,316,2019-03-30T15:00:00Z,False,1,10,0,0,38,26,12,41,20,21,-3,-8
Mousset,43,3,320,2019-04-06T14:00:00Z,True,1,3,0,0,38,26,12,33,20,13,5,13
Mousset,43,3,330,2019-04-13T14:00:00Z,False,1,2,0,0,38,26,12,33,22,11,5,-10
Mousset,43,3,341,2019-04-20T14:00:00Z,True,1,8,14,1,41,26,15,20,18,2,21,24
Mousset,43,3,357,2019-04-27T14:00:00Z,False,1,15,0,0,41,26,15,37,21,16,4,-6
Mousset,43,3,361,2019-05-04T11:30:00Z,True,1,16,14,1,42,26,16,70,37,33,-28,-7
Mousset,43,3,372,2019-05-12T14:00:00Z,False,1,6,20,1,45,29,16,46,17,29,-1,-1
King,44,3,1,2018-08-11T14:00:00Z,True,1,4,90,2,0,0,0,0,0,0,0,0
King,44,3,19,2018-08-18T14:00:00Z,False,1,18,89,1,3,3,0,0,0,0,3,0
King,44,3,21,2018-08-25T14:00:00Z,True,1,7,90,9,6,3,3,4,3,1,2,2
King,44,3,33,2018-09-01T14:00:00Z,False,1,5,79,2,7,4,3,9,3,6,-2,0
King,44,3,40,2018-09-15T14:00:00Z,True,1,10,84,11,7,4,3,6,3,3,1,1
King,44,3,52,2018-09-22T14:00:00Z,False,1,3,90,2,10,7,3,1,0,1,9,3
King,44,3,61,2018-10-01T19:00:00Z,True,1,6,83,2,10,7,3,7,1,6,3,1
King,44,3,79,2018-10-06T14:00:00Z,False,1,17,90,13,13,10,3,13,9,4,0,-6
King,44,3,81,2018-10-20T14:00:00Z,True,1,15,84,2,16,10,6,5,2,3,11,7
King,44,3,93,2018-10-27T14:00:00Z,False,1,8,0,0,17,11,6,5,4,1,12,2
King,44,3,101,2018-11-03T12:30:00Z,True,1,13,0,0,20,11,9,17,10,7,3,4
King,44,3,118,2018-11-10T15:00:00Z,False,1,14,0,0,20,11,9,6,3,3,14,6
King,44,3,120,2018-11-25T13:30:00Z,True,1,0,81,7,20,11,9,24,14,10,-4,1
King,44,3,137,2018-12-01T15:00:00Z,False,1,12,84,2,20,11,9,35,21,14,-15,-12
King,44,3,140,2018-12-04T19:45:00Z,True,1,9,90,2,20,11,9,10,5,5,10,6
King,44,3,151,2018-12-08T12:30:00Z,True,1,11,90,2,23,14,9,39,19,20,-16,-6
King,44,3,169,2018-12-15T15:00:00Z,False,1,19,90,2,23,14,9,22,11,11,1,-2
King,44,3,171,2018-12-22T15:00:00Z,True,1,2,85,5,23,14,9,21,14,7,2,7
King,44,3,188,2018-12-26T15:00:00Z,False,1,16,16,1,26,17,9,42,15,27,-16,-6
King,44,3,196,2018-12-30T16:30:00Z,False,1,13,90,2,26,17,9,32,18,14,-6,-9
King,44,3,201,2019-01-02T19:45:00Z,True,1,17,90,2,26,17,9,28,16,12,-2,5
King,44,3,215,2019-01-13T14:15:00Z,False,1,7,90,2,27,18,9,27,18,9,0,-9
King,44,3,221,2019-01-19T15:00:00Z,True,1,18,90,8,27,18,9,31,17,14,-4,4
King,44,3,231,2019-01-30T19:45:00Z,True,1,5,90,16,30,21,9,47,25,22,-17,-1
King,44,3,242,2019-02-02T17:30:00Z,False,1,4,90,2,33,24,9,19,14,5,14,-5
King,44,3,254,2019-02-09T15:00:00Z,False,1,11,90,2,33,24,9,62,32,30,-29,-23
King,44,3,261,2019-02-23T15:00:00Z,True,1,19,90,7,33,24,9,39,21,18,-6,6
King,44,3,270,2019-02-27T19:45:00Z,False,1,0,90,1,34,25,9,53,35,18,-19,-26
King,44,3,280,2019-03-02T15:00:00Z,True,1,12,90,1,34,25,9,68,42,26,-34,-1
King,44,3,294,2019-03-09T15:00:00Z,False,1,9,90,2,34,25,9,14,8,6,20,1
King,44,3,300,2019-03-16T15:00:00Z,True,1,14,90,13,37,25,12,34,22,12,3,13
King,44,3,316,2019-03-30T15:00:00Z,False,1,10,73,2,38,26,12,41,20,21,-3,-8
King,44,3,320,2019-04-06T14:00:00Z,True,1,3,90,2,38,26,12,33,20,13,5,13
King,44,3,330,2019-04-13T14:00:00Z,False,1,2,75,2,38,26,12,33,22,11,5,-10
King,44,3,341,2019-04-20T14:00:00Z,True,1,8,60,2,41,26,15,20,18,2,21,24
King,44,3,357,2019-04-27T14:00:00Z,False,1,15,90,2,41,26,15,37,21,16,4,-6
King,44,3,361,2019-05-04T11:30:00Z,True,1,16,90,2,42,26,16,70,37,33,-28,-7
King,44,3,372,2019-05-12T14:00:00Z,False,1,6,90,6,45,29,16,46,17,29,-1,-1
Defoe,45,3,1,2018-08-11T14:00:00Z,True,1,4,1,1,0,0,0,0,0,0,0,0
Defoe,45,3,19,2018-08-18T14:00:00Z,False,1,18,0,0,3,3,0,0,0,0,3,0
Defoe,45,3,21,2018-08-25T14:00:00Z,True,1,7,0,0,6,3,3,4,3,1,2,2
Defoe,45,3,33,2018-09-01T14:00:00Z,False,1,5,0,0,7,4,3,9,3,6,-2,0
Defoe,45,3,40,2018-09-15T14:00:00Z,True,1,10,0,0,7,4,3,6,3,3,1,1
Defoe,45,3,52,2018-09-22T14:00:00Z,False,1,3,12,1,10,7,3,1,0,1,9,3
Defoe,45,3,61,2018-10-01T19:00:00Z,True,1,6,0,0,10,7,3,7,1,6,3,1
Defoe,45,3,79,2018-10-06T14:00:00Z,False,1,17,0,0,13,10,3,13,9,4,0,-6
Defoe,45,3,81,2018-10-20T14:00:00Z,True,1,15,0,0,16,10,6,5,2,3,11,7
Defoe,45,3,93,2018-10-27T14:00:00Z,False,1,8,1,1,17,11,6,5,4,1,12,2
Defoe,45,3,101,2018-11-03T12:30:00Z,True,1,13,0,0,20,11,9,17,10,7,3,4
Defoe,45,3,118,2018-11-10T15:00:00Z,False,1,14,8,1,20,11,9,6,3,3,14,6
Defoe,45,3,120,2018-11-25T13:30:00Z,True,1,0,0,0,20,11,9,24,14,10,-4,1
Defoe,45,3,137,2018-12-01T15:00:00Z,False,1,12,0,0,20,11,9,35,21,14,-15,-12
Defoe,45,3,140,2018-12-04T19:45:00Z,True,1,9,0,0,20,11,9,10,5,5,10,6
Defoe,45,3,151,2018-12-08T12:30:00Z,True,1,11,0,0,23,14,9,39,19,20,-16,-6
Defoe,45,3,169,2018-12-15T15:00:00Z,False,1,19,0,0,23,14,9,22,11,11,1,-2
Defoe,45,3,171,2018-12-22T15:00:00Z,True,1,2,0,0,23,14,9,21,14,7,2,7
Defoe,45,3,188,2018-12-26T15:00:00Z,False,1,16,0,0,26,17,9,42,15,27,-16,-6
Defoe,45,3,196,2018-12-30T16:30:00Z,False,1,13,0,0,26,17,9,32,18,14,-6,-9
Defoe,45,3,201,2019-01-02T19:45:00Z,True,1,17,0,0,26,17,9,28,16,12,-2,5
Defoe,45,3,215,2019-01-13T14:15:00Z,False,1,7,0,0,27,18,9,27,18,9,0,-9
Defoe,45,3,221,2019-01-19T15:00:00Z,True,1,18,0,0,27,18,9,31,17,14,-4,4
Defoe,45,3,231,2019-01-30T19:45:00Z,True,1,5,0,0,30,21,9,47,25,22,-17,-1
Defoe,45,3,242,2019-02-02T17:30:00Z,False,1,4,0,0,33,24,9,19,14,5,14,-5
Defoe,45,3,254,2019-02-09T15:00:00Z,False,1,11,0,0,33,24,9,62,32,30,-29,-23
Defoe,45,3,261,2019-02-23T15:00:00Z,True,1,19,0,0,33,24,9,39,21,18,-6,6
Defoe,45,3,270,2019-02-27T19:45:00Z,False,1,0,0,0,34,25,9,53,35,18,-19,-26
Defoe,45,3,280,2019-03-02T15:00:00Z,True,1,12,0,0,34,25,9,68,42,26,-34,-1
Defoe,45,3,294,2019-03-09T15:00:00Z,False,1,9,0,0,34,25,9,14,8,6,20,1
Defoe,45,3,300,2019-03-16T15:00:00Z,True,1,14,0,0,37,25,12,34,22,12,3,13
Defoe,45,3,316,2019-03-30T15:00:00Z,False,1,10,0,0,38,26,12,41,20,21,-3,-8
Defoe,45,3,320,2019-04-06T14:00:00Z,True,1,3,0,0,38,26,12,33,20,13,5,13
Defoe,45,3,330,2019-04-13T14:00:00Z,False,1,2,0,0,38,26,12,33,22,11,5,-10
Defoe,45,3,341,2019-04-20T14:00:00Z,True,1,8,0,0,41,26,15,20,18,2,21,24
Defoe,45,3,357,2019-04-27T14:00:00Z,False,1,15,0,0,41,26,15,37,21,16,4,-6
Defoe,45,3,361,2019-05-04T11:30:00Z,True,1,16,0,0,42,26,16,70,37,33,-28,-7
Defoe,45,3,372,2019-05-12T14:00:00Z,False,1,6,0,0,45,29,16,46,17,29,-1,-1
Ryan,46,0,8,2018-08-11T14:00:00Z,False,2,17,90,2,0,0,0,0,0,0,0,0
Ryan,46,0,10,2018-08-19T15:00:00Z,True,2,13,90,1,0,0,0,3,3,0,-3,0
Ryan,46,0,24,2018-08-25T16:30:00Z,False,2,11,90,4,3,3,0,6,3,3,-3,-3
Ryan,46,0,30,2018-09-01T14:00:00Z,True,2,8,90,2,3,3,0,3,3,0,0,3
Ryan,46,0,46,2018-09-17T19:00:00Z,False,2,15,90,1,4,4,0,4,1,3,0,-1
Ryan,46,0,51,2018-09-22T16:30:00Z,True,2,16,90,2,5,4,1,9,3,6,-4,-2
Ryan,46,0,66,2018-09-29T14:00:00Z,False,2,12,90,3,5,4,1,16,9,7,-11,-8
Ryan,46,0,70,2018-10-05T19:00:00Z,True,2,18,90,9,5,4,1,7,4,3,-2,1
Ryan,46,0,87,2018-10-20T14:00:00Z,False,2,14,90,11,8,7,1,2,0,2,6,1
Ryan,46,0,90,2018-10-27T14:00:00Z,True,2,19,90,10,11,7,4,15,8,7,-4,0
Ryan,46,0,104,2018-11-03T15:00:00Z,False,2,7,90,1,14,10,4,15,10,5,-1,-6
Ryan,46,0,111,2018-11-10T12:30:00Z,False,2,4,90,2,14,10,4,5,4,1,9,0
Ryan,46,0,121,2018-11-24T15:00:00Z,True,2,10,90,2,14,10,4,17,8,9,-3,1
Ryan,46,0,134,2018-12-01T15:00:00Z,False,2,9,90,2,15,11,4,10,5,5,5,-1
Ryan,46,0,141,2018-12-04T19:45:00Z,True,2,6,90,3,18,11,7,12,5,7,6,4
Ryan,46,0,152,2018-12-08T15:00:00Z,False,2,3,90,3,21,14,7,9,4,5,12,3
Ryan,46,0,160,2018-12-16T13:30:00Z,True,2,5,90,1,21,14,7,34,21,13,-13,1
Ryan,46,0,171,2018-12-22T15:00:00Z,False,2,1,90,1,21,14,7,23,14,9,-2,-7
Ryan,46,0,180,2018-12-26T17:15:00Z,True,2,0,90,3,21,14,7,37,23,14,-16,0
Ryan,46,0,190,2018-12-29T15:00:00Z,True,2,7,0,0,22,15,7,27,18,9,-5,6
Ryan,46,0,208,2019-01-02T19:45:00Z,False,2,18,0,0,25,18,7,27,13,14,-2,-6
Ryan,46,0,210,2019-01-12T15:00:00Z,True,2,11,0,0,26,18,8,54,28,26,-28,-8
Ryan,46,0,225,2019-01-19T15:00:00Z,False,2,13,0,0,26,18,8,41,21,20,-15,-13
Ryan,46,0,232,2019-01-29T19:45:00Z,False,2,8,90,1,26,18,8,14,12,2,12,-4
Ryan,46,0,240,2019-02-02T15:00:00Z,True,2,17,90,6,26,18,8,33,17,16,-7,2
Ryan,46,0,250,2019-02-09T17:30:00Z,True,2,3,90,0,27,19,8,24,14,10,3,9
Ryan,46,0,274,2019-02-26T19:45:00Z,False,2,10,90,1,27,19,8,32,14,18,-5,-6
Ryan,46,0,281,2019-03-02T15:00:00Z,True,2,9,90,9,27,19,8,14,8,6,13,13
Ryan,46,0,293,2019-03-09T12:30:00Z,False,2,6,90,1,30,22,8,33,13,20,-3,-5
Ryan,46,0,311,2019-03-30T15:00:00Z,True,2,15,90,2,33,22,11,30,18,12,3,10
Ryan,46,0,264,2019-04-03T18:45:00Z,False,2,5,90,1,33,22,11,60,32,28,-27,-21
Ryan,46,0,330,2019-04-13T14:00:00Z,True,2,1,90,0,33,22,11,38,26,12,-5,10
Ryan,46,0,301,2019-04-16T18:45:00Z,True,2,4,90,1,33,22,11,28,20,8,5,14
Ryan,46,0,349,2019-04-20T14:00:00Z,False,2,19,90,9,33,22,11,47,27,20,-14,-16
Ryan,46,0,327,2019-04-23T18:45:00Z,False,2,16,90,3,34,22,12,67,34,33,-33,-22
Ryan,46,0,350,2019-04-27T16:30:00Z,True,2,14,90,2,34,22,12,41,25,16,-7,6
Ryan,46,0,360,2019-05-05T15:30:00Z,False,2,0,90,4,35,23,12,66,44,22,-31,-32
Ryan,46,0,370,2019-05-12T14:00:00Z,True,2,12,90,1,36,23,13,95,54,41,-59,-18
Dunk,47,1,8,2018-08-11T14:00:00Z,False,2,17,90,1,0,0,0,0,0,0,0,0
Dunk,47,1,10,2018-08-19T15:00:00Z,True,2,13,19,1,0,0,0,3,3,0,-3,0
Dunk,47,1,24,2018-08-25T16:30:00Z,False,2,11,0,0,3,3,0,6,3,3,-3,-3
Dunk,47,1,30,2018-09-01T14:00:00Z,True,2,8,90,1,3,3,0,3,3,0,0,3
Dunk,47,1,46,2018-09-17T19:00:00Z,False,2,15,90,1,4,4,0,4,1,3,0,-1
Dunk,47,1,51,2018-09-22T16:30:00Z,True,2,16,90,1,5,4,1,9,3,6,-4,-2
Dunk,47,1,66,2018-09-29T14:00:00Z,False,2,12,90,1,5,4,1,16,9,7,-11,-8
Dunk,47,1,70,2018-10-05T19:00:00Z,True,2,18,90,6,5,4,1,7,4,3,-2,1
Dunk,47,1,87,2018-10-20T14:00:00Z,False,2,14,90,8,8,7,1,2,0,2,6,1
Dunk,47,1,90,2018-10-27T14:00:00Z,True,2,19,90,5,11,7,4,15,8,7,-4,0
Dunk,47,1,104,2018-11-03T15:00:00Z,False,2,7,90,6,14,10,4,15,10,5,-1,-6
Dunk,47,1,111,2018-11-10T12:30:00Z,False,2,4,90,9,14,10,4,5,4,1,9,0
Dunk,47,1,121,2018-11-24T15:00:00Z,True,2,10,90,3,14,10,4,17,8,9,-3,1
Dunk,47,1,134,2018-12-01T15:00:00Z,False,2,9,90,2,15,11,4,10,5,5,5,-1
Dunk,47,1,141,2018-12-04T19:45:00Z,True,2,6,90,2,18,11,7,12,5,7,6,4
Dunk,47,1,152,2018-12-08T15:00:00Z,False,2,3,90,2,21,14,7,9,4,5,12,3
Dunk,47,1,160,2018-12-16T13:30:00Z,True,2,5,90,0,21,14,7,34,21,13,-13,1
Dunk,47,1,171,2018-12-22T15:00:00Z,False,2,1,72,-2,21,14,7,23,14,9,-2,-7
Dunk,47,1,180,2018-12-26T17:15:00Z,True,2,0,0,0,21,14,7,37,23,14,-16,0
Dunk,47,1,190,2018-12-29T15:00:00Z,True,2,7,90,6,22,15,7,27,18,9,-5,6
Dunk,47,1,208,2019-01-02T19:45:00Z,False,2,18,90,1,25,18,7,27,13,14,-2,-6
Dunk,47,1,210,2019-01-12T15:00:00Z,True,2,11,90,2,26,18,8,54,28,26,-28,-8
Dunk,47,1,225,2019-01-19T15:00:00Z,False,2,13,90,1,26,18,8,41,21,20,-15,-13
Dunk,47,1,232,2019-01-29T19:45:00Z,False,2,8,90,-1,26,18,8,14,12,2,12,-4
Dunk,47,1,240,2019-02-02T15:00:00Z,True,2,17,90,6,26,18,8,33,17,16,-7,2
Dunk,47,1,250,2019-02-09T17:30:00Z,True,2,3,90,1,27,19,8,24,14,10,3,9
Dunk,47,1,274,2019-02-26T19:45:00Z,False,2,10,90,1,27,19,8,32,14,18,-5,-6
Dunk,47,1,281,2019-03-02T15:00:00Z,True,2,9,90,7,27,19,8,14,8,6,13,13
Dunk,47,1,293,2019-03-09T12:30:00Z,False,2,6,90,5,30,22,8,33,13,20,-3,-5
Dunk,47,1,311,2019-03-30T15:00:00Z,True,2,15,90,2,33,22,11,30,18,12,3,10
Dunk,47,1,264,2019-04-03T18:45:00Z,False,2,5,90,1,33,22,11,60,32,28,-27,-21
Dunk,47,1,330,2019-04-13T14:00:00Z,True,2,1,90,0,33,22,11,38,26,12,-5,10
Dunk,47,1,301,2019-04-16T18:45:00Z,True,2,4,90,1,33,22,11,28,20,8,5,14
Dunk,47,1,349,2019-04-20T14:00:00Z,False,2,19,90,6,33,22,11,47,27,20,-14,-16
Dunk,47,1,327,2019-04-23T18:45:00Z,False,2,16,90,2,34,22,12,67,34,33,-33,-22
Dunk,47,1,350,2019-04-27T16:30:00Z,True,2,14,90,2,34,22,12,41,25,16,-7,6
Dunk,47,1,360,2019-05-05T15:30:00Z,False,2,0,90,1,35,23,12,66,44,22,-31,-32
Dunk,47,1,370,2019-05-12T14:00:00Z,True,2,12,90,0,36,23,13,95,54,41,-59,-18
Duffy,48,1,8,2018-08-11T14:00:00Z,False,2,17,90,1,0,0,0,0,0,0,0,0
Duffy,48,1,10,2018-08-19T15:00:00Z,True,2,13,90,7,0,0,0,3,3,0,-3,0
Duffy,48,1,24,2018-08-25T16:30:00Z,False,2,11,90,2,3,3,0,6,3,3,-3,-3
Duffy,48,1,30,2018-09-01T14:00:00Z,True,2,8,90,1,3,3,0,3,3,0,0,3
Duffy,48,1,46,2018-09-17T19:00:00Z,False,2,15,90,12,4,4,0,4,1,3,0,-1
Duffy,48,1,51,2018-09-22T16:30:00Z,True,2,16,90,4,5,4,1,9,3,6,-4,-2
Duffy,48,1,66,2018-09-29T14:00:00Z,False,2,12,90,0,5,4,1,16,9,7,-11,-8
Duffy,48,1,70,2018-10-05T19:00:00Z,True,2,18,90,5,5,4,1,7,4,3,-2,1
Duffy,48,1,87,2018-10-20T14:00:00Z,False,2,14,90,7,8,7,1,2,0,2,6,1
Duffy,48,1,90,2018-10-27T14:00:00Z,True,2,19,90,6,11,7,4,15,8,7,-4,0
Duffy,48,1,104,2018-11-03T15:00:00Z,False,2,7,90,1,14,10,4,15,10,5,-1,-6
Duffy,48,1,111,2018-11-10T12:30:00Z,False,2,4,90,1,14,10,4,5,4,1,9,0
Duffy,48,1,121,2018-11-24T15:00:00Z,True,2,10,90,1,14,10,4,17,8,9,-3,1
Duffy,48,1,134,2018-12-01T15:00:00Z,False,2,9,90,10,15,11,4,10,5,5,5,-1
Duffy,48,1,141,2018-12-04T19:45:00Z,True,2,6,27,-2,18,11,7,12,5,7,6,4
Duffy,48,1,152,2018-12-08T15:00:00Z,False,2,3,0,0,21,14,7,9,4,5,12,3
Duffy,48,1,160,2018-12-16T13:30:00Z,True,2,5,0,0,21,14,7,34,21,13,-13,1
Duffy,48,1,171,2018-12-22T15:00:00Z,False,2,1,0,0,21,14,7,23,14,9,-2,-7
Duffy,48,1,180,2018-12-26T17:15:00Z,True,2,0,90,2,21,14,7,37,23,14,-16,0
Duffy,48,1,190,2018-12-29T15:00:00Z,True,2,7,90,6,22,15,7,27,18,9,-5,6
Duffy,48,1,208,2019-01-02T19:45:00Z,False,2,18,90,8,25,18,7,27,13,14,-2,-6
Duffy,48,1,210,2019-01-12T15:00:00Z,True,2,11,90,2,26,18,8,54,28,26,-28,-8
Duffy,48,1,225,2019-01-19T15:00:00Z,False,2,13,90,1,26,18,8,41,21,20,-15,-13
Duffy,48,1,232,2019-01-29T19:45:00Z,False,2,8,90,-1,26,18,8,14,12,2,12,-4
Duffy,48,1,240,2019-02-02T15:00:00Z,True,2,17,90,6,26,18,8,33,17,16,-7,2
Duffy,48,1,250,2019-02-09T17:30:00Z,True,2,3,90,7,27,19,8,24,14,10,3,9
Duffy,48,1,274,2019-02-26T19:45:00Z,False,2,10,90,1,27,19,8,32,14,18,-5,-6
Duffy,48,1,281,2019-03-02T15:00:00Z,True,2,9,90,9,27,19,8,14,8,6,13,13
Duffy,48,1,293,2019-03-09T12:30:00Z,False,2,6,90,2,30,22,8,33,13,20,-3,-5
Duffy,48,1,311,2019-03-30T15:00:00Z,True,2,15,90,2,33,22,11,30,18,12,3,10
Duffy,48,1,264,2019-04-03T18:45:00Z,False,2,5,90,1,33,22,11,60,32,28,-27,-21
Duffy,48,1,330,2019-04-13T14:00:00Z,True,2,1,90,0,33,22,11,38,26,12,-5,10
Duffy,48,1,301,2019-04-16T18:45:00Z,True,2,4,90,1,33,22,11,28,20,8,5,14
Duffy,48,1,349,2019-04-20T14:00:00Z,False,2,19,90,6,33,22,11,47,27,20,-14,-16
Duffy,48,1,327,2019-04-23T18:45:00Z,False,2,16,90,2,34,22,12,67,34,33,-33,-22
Duffy,48,1,350,2019-04-27T16:30:00Z,True,2,14,90,2,34,22,12,41,25,16,-7,6
Duffy,48,1,360,2019-05-05T15:30:00Z,False,2,0,90,2,35,23,12,66,44,22,-31,-32
Duffy,48,1,370,2019-05-12T14:00:00Z,True,2,12,90,0,36,23,13,95,54,41,-59,-18
Bruno,49,1,8,2018-08-11T14:00:00Z,False,2,17,25,1,0,0,0,0,0,0,0,0
Bruno,49,1,10,2018-08-19T15:00:00Z,True,2,13,0,0,0,0,0,3,3,0,-3,0
Bruno,49,1,24,2018-08-25T16:30:00Z,False,2,11,0,0,3,3,0,6,3,3,-3,-3
Bruno,49,1,30,2018-09-01T14:00:00Z,True,2,8,0,0,3,3,0,3,3,0,0,3
Bruno,49,1,46,2018-09-17T19:00:00Z,False,2,15,0,0,4,4,0,4,1,3,0,-1
Bruno,49,1,51,2018-09-22T16:30:00Z,True,2,16,0,0,5,4,1,9,3,6,-4,-2
Bruno,49,1,66,2018-09-29T14:00:00Z,False,2,12,0,0,5,4,1,16,9,7,-11,-8
Bruno,49,1,70,2018-10-05T19:00:00Z,True,2,18,90,7,5,4,1,7,4,3,-2,1
Bruno,49,1,87,2018-10-20T14:00:00Z,False,2,14,67,6,8,7,1,2,0,2,6,1
Bruno,49,1,90,2018-10-27T14:00:00Z,True,2,19,90,12,11,7,4,15,8,7,-4,0
Bruno,49,1,104,2018-11-03T15:00:00Z,False,2,7,90,1,14,10,4,15,10,5,-1,-6
Bruno,49,1,111,2018-11-10T12:30:00Z,False,2,4,0,0,14,10,4,5,4,1,9,0
Bruno,49,1,121,2018-11-24T15:00:00Z,True,2,10,90,1,14,10,4,17,8,9,-3,1
Bruno,49,1,134,2018-12-01T15:00:00Z,False,2,9,77,1,15,11,4,10,5,5,5,-1
Bruno,49,1,141,2018-12-04T19:45:00Z,True,2,6,0,0,18,11,7,12,5,7,6,4
Bruno,49,1,152,2018-12-08T15:00:00Z,False,2,3,90,2,21,14,7,9,4,5,12,3
Bruno,49,1,160,2018-12-16T13:30:00Z,True,2,5,0,0,21,14,7,34,21,13,-13,1
Bruno,49,1,171,2018-12-22T15:00:00Z,False,2,1,0,0,21,14,7,23,14,9,-2,-7
Bruno,49,1,180,2018-12-26T17:15:00Z,True,2,0,0,0,21,14,7,37,23,14,-16,0
Bruno,49,1,190,2018-12-29T15:00:00Z,True,2,7,0,0,22,15,7,27,18,9,-5,6
Bruno,49,1,208,2019-01-02T19:45:00Z,False,2,18,0,0,25,18,7,27,13,14,-2,-6
Bruno,49,1,210,2019-01-12T15:00:00Z,True,2,11,0,0,26,18,8,54,28,26,-28,-8
Bruno,49,1,225,2019-01-19T15:00:00Z,False,2,13,0,0,26,18,8,41,21,20,-15,-13
Bruno,49,1,232,2019-01-29T19:45:00Z,False,2,8,0,0,26,18,8,14,12,2,12,-4
Bruno,49,1,240,2019-02-02T15:00:00Z,True,2,17,0,0,26,18,8,33,17,16,-7,2
Bruno,49,1,250,2019-02-09T17:30:00Z,True,2,3,0,0,27,19,8,24,14,10,3,9
Bruno,49,1,274,2019-02-26T19:45:00Z,False,2,10,0,0,27,19,8,32,14,18,-5,-6
Bruno,49,1,281,2019-03-02T15:00:00Z,True,2,9,0,0,27,19,8,14,8,6,13,13
Bruno,49,1,293,2019-03-09T12:30:00Z,False,2,6,0,0,30,22,8,33,13,20,-3,-5
Bruno,49,1,311,2019-03-30T15:00:00Z,True,2,15,0,0,33,22,11,30,18,12,3,10
Bruno,49,1,264,2019-04-03T18:45:00Z,False,2,5,90,1,33,22,11,60,32,28,-27,-21
Bruno,49,1,330,2019-04-13T14:00:00Z,True,2,1,0,0,33,22,11,38,26,12,-5,10
Bruno,49,1,301,2019-04-16T18:45:00Z,True,2,4,90,1,33,22,11,28,20,8,5,14
Bruno,49,1,349,2019-04-20T14:00:00Z,False,2,19,69,9,33,22,11,47,27,20,-14,-16
Bruno,49,1,327,2019-04-23T18:45:00Z,False,2,16,0,0,34,22,12,67,34,33,-33,-22
Bruno,49,1,350,2019-04-27T16:30:00Z,True,2,14,90,2,34,22,12,41,25,16,-7,6
Bruno,49,1,360,2019-05-05T15:30:00Z,False,2,0,90,2,35,23,12,66,44,22,-31,-32
Bruno,49,1,370,2019-05-12T14:00:00Z,True,2,12,83,0,36,23,13,95,54,41,-59,-18
Bong,50,1,8,2018-08-11T14:00:00Z,False,2,17,64,1,0,0,0,0,0,0,0,0
Bong,50,1,10,2018-08-19T15:00:00Z,True,2,13,90,1,0,0,0,3,3,0,-3,0
Bong,50,1,24,2018-08-25T16:30:00Z,False,2,11,90,2,3,3,0,6,3,3,-3,-3
Bong,50,1,30,2018-09-01T14:00:00Z,True,2,8,90,1,3,3,0,3,3,0,0,3
Bong,50,1,46,2018-09-17T19:00:00Z,False,2,15,90,1,4,4,0,4,1,3,0,-1
Bong,50,1,51,2018-09-22T16:30:00Z,True,2,16,90,1,5,4,1,9,3,6,-4,-2
Bong,50,1,66,2018-09-29T14:00:00Z,False,2,12,90,1,5,4,1,16,9,7,-11,-8
Bong,50,1,70,2018-10-05T19:00:00Z,True,2,18,90,6,5,4,1,7,4,3,-2,1
Bong,50,1,87,2018-10-20T14:00:00Z,False,2,14,90,6,8,7,1,2,0,2,6,1
Bong,50,1,90,2018-10-27T14:00:00Z,True,2,19,90,6,11,7,4,15,8,7,-4,0
Bong,50,1,104,2018-11-03T15:00:00Z,False,2,7,90,1,14,10,4,15,10,5,-1,-6
Bong,50,1,111,2018-11-10T12:30:00Z,False,2,4,90,1,14,10,4,5,4,1,9,0
Bong,50,1,121,2018-11-24T15:00:00Z,True,2,10,0,0,14,10,4,17,8,9,-3,1
Bong,50,1,134,2018-12-01T15:00:00Z,False,2,9,0,0,15,11,4,10,5,5,5,-1
Bong,50,1,141,2018-12-04T19:45:00Z,True,2,6,0,0,18,11,7,12,5,7,6,4
Bong,50,1,152,2018-12-08T15:00:00Z,False,2,3,0,0,21,14,7,9,4,5,12,3
Bong,50,1,160,2018-12-16T13:30:00Z,True,2,5,0,0,21,14,7,34,21,13,-13,1
Bong,50,1,171,2018-12-22T15:00:00Z,False,2,1,14,1,21,14,7,23,14,9,-2,-7
Bong,50,1,180,2018-12-26T17:15:00Z,True,2,0,0,0,21,14,7,37,23,14,-16,0
Bong,50,1,190,2018-12-29T15:00:00Z,True,2,7,0,0,22,15,7,27,18,9,-5,6
Bong,50,1,208,2019-01-02T19:45:00Z,False,2,18,17,1,25,18,7,27,13,14,-2,-6
Bong,50,1,210,2019-01-12T15:00:00Z,True,2,11,90,2,26,18,8,54,28,26,-28,-8
Bong,50,1,225,2019-01-19T15:00:00Z,False,2,13,90,1,26,18,8,41,21,20,-15,-13
Bong,50,1,232,2019-01-29T19:45:00Z,False,2,8,90,0,26,18,8,14,12,2,12,-4
Bong,50,1,240,2019-02-02T15:00:00Z,True,2,17,90,6,26,18,8,33,17,16,-7,2
Bong,50,1,250,2019-02-09T17:30:00Z,True,2,3,90,1,27,19,8,24,14,10,3,9
Bong,50,1,274,2019-02-26T19:45:00Z,False,2,10,90,1,27,19,8,32,14,18,-5,-6
Bong,50,1,281,2019-03-02T15:00:00Z,True,2,9,0,0,27,19,8,14,8,6,13,13
Bong,50,1,293,2019-03-09T12:30:00Z,False,2,6,0,0,30,22,8,33,13,20,-3,-5
Bong,50,1,311,2019-03-30T15:00:00Z,True,2,15,0,0,33,22,11,30,18,12,3,10
Bong,50,1,264,2019-04-03T18:45:00Z,False,2,5,90,1,33,22,11,60,32,28,-27,-21
Bong,50,1,330,2019-04-13T14:00:00Z,True,2,1,0,0,33,22,11,38,26,12,-5,10
Bong,50,1,301,2019-04-16T18:45:00Z,True,2,4,0,0,33,22,11,28,20,8,5,14
Bong,50,1,349,2019-04-20T14:00:00Z,False,2,19,90,6,33,22,11,47,27,20,-14,-16
Bong,50,1,327,2019-04-23T18:45:00Z,False,2,16,0,0,34,22,12,67,34,33,-33,-22
Bong,50,1,350,2019-04-27T16:30:00Z,True,2,14,0,0,34,22,12,41,25,16,-7,6
Bong,50,1,360,2019-05-05T15:30:00Z,False,2,0,0,0,35,23,12,66,44,22,-31,-32
Bong,50,1,370,2019-05-12T14:00:00Z,True,2,12,0,0,36,23,13,95,54,41,-59,-18
Suttner,51,1,8,2018-08-11T14:00:00Z,False,2,17,0,0,0,0,0,0,0,0,0,0
Suttner,51,1,10,2018-08-19T15:00:00Z,True,2,13,0,0,0,0,0,3,3,0,-3,0
Suttner,51,1,24,2018-08-25T16:30:00Z,False,2,11,0,0,3,3,0,6,3,3,-3,-3
Suttner,51,1,30,2018-09-01T14:00:00Z,True,2,8,0,0,3,3,0,3,3,0,0,3
Suttner,51,1,46,2018-09-17T19:00:00Z,False,2,15,0,0,4,4,0,4,1,3,0,-1
Suttner,51,1,51,2018-09-22T16:30:00Z,True,2,16,0,0,5,4,1,9,3,6,-4,-2
Suttner,51,1,66,2018-09-29T14:00:00Z,False,2,12,0,0,5,4,1,16,9,7,-11,-8
Suttner,51,1,70,2018-10-05T19:00:00Z,True,2,18,0,0,5,4,1,7,4,3,-2,1
Suttner,51,1,87,2018-10-20T14:00:00Z,False,2,14,0,0,8,7,1,2,0,2,6,1
Suttner,51,1,90,2018-10-27T14:00:00Z,True,2,19,0,0,11,7,4,15,8,7,-4,0
Suttner,51,1,104,2018-11-03T15:00:00Z,False,2,7,0,0,14,10,4,15,10,5,-1,-6
Suttner,51,1,111,2018-11-10T12:30:00Z,False,2,4,0,0,14,10,4,5,4,1,9,0
Suttner,51,1,121,2018-11-24T15:00:00Z,True,2,10,0,0,14,10,4,17,8,9,-3,1
Suttner,51,1,134,2018-12-01T15:00:00Z,False,2,9,0,0,15,11,4,10,5,5,5,-1
Suttner,51,1,141,2018-12-04T19:45:00Z,True,2,6,0,0,18,11,7,12,5,7,6,4
Suttner,51,1,152,2018-12-08T15:00:00Z,False,2,3,0,0,21,14,7,9,4,5,12,3
Suttner,51,1,160,2018-12-16T13:30:00Z,True,2,5,0,0,21,14,7,34,21,13,-13,1
Suttner,51,1,171,2018-12-22T15:00:00Z,False,2,1,0,0,21,14,7,23,14,9,-2,-7
Suttner,51,1,180,2018-12-26T17:15:00Z,True,2,0,0,0,21,14,7,37,23,14,-16,0
Suttner,51,1,190,2018-12-29T15:00:00Z,True,2,7,0,0,22,15,7,27,18,9,-5,6
Suttner,51,1,208,2019-01-02T19:45:00Z,False,2,18,0,0,25,18,7,27,13,14,-2,-6
Suttner,51,1,210,2019-01-12T15:00:00Z,True,2,11,0,0,26,18,8,54,28,26,-28,-8
Suttner,51,1,225,2019-01-19T15:00:00Z,False,2,13,0,0,26,18,8,41,21,20,-15,-13
Suttner,51,1,232,2019-01-29T19:45:00Z,False,2,8,0,0,26,18,8,14,12,2,12,-4
Suttner,51,1,240,2019-02-02T15:00:00Z,True,2,17,0,0,26,18,8,33,17,16,-7,2
Suttner,51,1,250,2019-02-09T17:30:00Z,True,2,3,0,0,27,19,8,24,14,10,3,9
Suttner,51,1,274,2019-02-26T19:45:00Z,False,2,10,0,0,27,19,8,32,14,18,-5,-6
Suttner,51,1,281,2019-03-02T15:00:00Z,True,2,9,0,0,27,19,8,14,8,6,13,13
Suttner,51,1,293,2019-03-09T12:30:00Z,False,2,6,0,0,30,22,8,33,13,20,-3,-5
Suttner,51,1,311,2019-03-30T15:00:00Z,True,2,15,0,0,33,22,11,30,18,12,3,10
Suttner,51,1,264,2019-04-03T18:45:00Z,False,2,5,0,0,33,22,11,60,32,28,-27,-21
Suttner,51,1,330,2019-04-13T14:00:00Z,True,2,1,0,0,33,22,11,38,26,12,-5,10
Suttner,51,1,301,2019-04-16T18:45:00Z,True,2,4,0,0,33,22,11,28,20,8,5,14
Suttner,51,1,349,2019-04-20T14:00:00Z,False,2,19,0,0,33,22,11,47,27,20,-14,-16
Suttner,51,1,327,2019-04-23T18:45:00Z,False,2,16,0,0,34,22,12,67,34,33,-33,-22
Suttner,51,1,350,2019-04-27T16:30:00Z,True,2,14,0,0,34,22,12,41,25,16,-7,6
Suttner,51,1,360,2019-05-05T15:30:00Z,False,2,0,0,0,35,23,12,66,44,22,-31,-32
Suttner,51,1,370,2019-05-12T14:00:00Z,True,2,12,0,0,36,23,13,95,54,41,-59,-18
Schelotto,52,1,8,2018-08-11T14:00:00Z,False,2,17,0,0,0,0,0,0,0,0,0,0
Schelotto,52,1,10,2018-08-19T15:00:00Z,True,2,13,0,0,0,0,0,3,3,0,-3,0
Schelotto,52,1,24,2018-08-25T16:30:00Z,False,2,11,0,0,3,3,0,6,3,3,-3,-3
Schelotto,52,1,30,2018-09-01T14:00:00Z,True,2,8,0,0,3,3,0,3,3,0,0,3
Schelotto,52,1,46,2018-09-17T19:00:00Z,False,2,15,0,0,4,4,0,4,1,3,0,-1
Schelotto,52,1,51,2018-09-22T16:30:00Z,True,2,16,0,0,5,4,1,9,3,6,-4,-2
Schelotto,52,1,66,2018-09-29T14:00:00Z,False,2,12,0,0,5,4,1,16,9,7,-11,-8
Schelotto,52,1,70,2018-10-05T19:00:00Z,True,2,18,0,0,5,4,1,7,4,3,-2,1
Schelotto,52,1,87,2018-10-20T14:00:00Z,False,2,14,0,0,8,7,1,2,0,2,6,1
Schelotto,52,1,90,2018-10-27T14:00:00Z,True,2,19,0,0,11,7,4,15,8,7,-4,0
Schelotto,52,1,104,2018-11-03T15:00:00Z,False,2,7,0,0,14,10,4,15,10,5,-1,-6
Schelotto,52,1,111,2018-11-10T12:30:00Z,False,2,4,0,0,14,10,4,5,4,1,9,0
Schelotto,52,1,121,2018-11-24T15:00:00Z,True,2,10,0,0,14,10,4,17,8,9,-3,1
Schelotto,52,1,134,2018-12-01T15:00:00Z,False,2,9,0,0,15,11,4,10,5,5,5,-1
Schelotto,52,1,141,2018-12-04T19:45:00Z,True,2,6,0,0,18,11,7,12,5,7,6,4
Schelotto,52,1,152,2018-12-08T15:00:00Z,False,2,3,0,0,21,14,7,9,4,5,12,3
Schelotto,52,1,160,2018-12-16T13:30:00Z,True,2,5,0,0,21,14,7,34,21,13,-13,1
Schelotto,52,1,171,2018-12-22T15:00:00Z,False,2,1,0,0,21,14,7,23,14,9,-2,-7
Schelotto,52,1,180,2018-12-26T17:15:00Z,True,2,0,0,0,21,14,7,37,23,14,-16,0
Schelotto,52,1,190,2018-12-29T15:00:00Z,True,2,7,0,0,22,15,7,27,18,9,-5,6
Schelotto,52,1,208,2019-01-02T19:45:00Z,False,2,18,0,0,25,18,7,27,13,14,-2,-6
Schelotto,52,1,210,2019-01-12T15:00:00Z,True,2,11,0,0,26,18,8,54,28,26,-28,-8
Schelotto,52,1,225,2019-01-19T15:00:00Z,False,2,13,0,0,26,18,8,41,21,20,-15,-13
Schelotto,52,1,232,2019-01-29T19:45:00Z,False,2,8,0,0,26,18,8,14,12,2,12,-4
Schelotto,52,1,240,2019-02-02T15:00:00Z,True,2,17,0,0,26,18,8,33,17,16,-7,2
Schelotto,52,1,250,2019-02-09T17:30:00Z,True,2,3,0,0,27,19,8,24,14,10,3,9
Schelotto,52,1,274,2019-02-26T19:45:00Z,False,2,10,0,0,27,19,8,32,14,18,-5,-6
Schelotto,52,1,281,2019-03-02T15:00:00Z,True,2,9,0,0,27,19,8,14,8,6,13,13
Schelotto,52,1,293,2019-03-09T12:30:00Z,False,2,6,0,0,30,22,8,33,13,20,-3,-5
Schelotto,52,1,311,2019-03-30T15:00:00Z,True,2,15,0,0,33,22,11,30,18,12,3,10
Schelotto,52,1,264,2019-04-03T18:45:00Z,False,2,5,0,0,33,22,11,60,32,28,-27,-21
Schelotto,52,1,330,2019-04-13T14:00:00Z,True,2,1,0,0,33,22,11,38,26,12,-5,10
Schelotto,52,1,301,2019-04-16T18:45:00Z,True,2,4,0,0,33,22,11,28,20,8,5,14
Schelotto,52,1,349,2019-04-20T14:00:00Z,False,2,19,0,0,33,22,11,47,27,20,-14,-16
Schelotto,52,1,327,2019-04-23T18:45:00Z,False,2,16,0,0,34,22,12,67,34,33,-33,-22
Schelotto,52,1,350,2019-04-27T16:30:00Z,True,2,14,0,0,34,22,12,41,25,16,-7,6
Schelotto,52,1,360,2019-05-05T15:30:00Z,False,2,0,0,0,35,23,12,66,44,22,-31,-32
Schelotto,52,1,370,2019-05-12T14:00:00Z,True,2,12,0,0,36,23,13,95,54,41,-59,-18
Balogun,53,1,8,2018-08-11T14:00:00Z,False,2,17,0,0,0,0,0,0,0,0,0,0
Balogun,53,1,10,2018-08-19T15:00:00Z,True,2,13,70,1,0,0,0,3,3,0,-3,0
Balogun,53,1,24,2018-08-25T16:30:00Z,False,2,11,90,1,3,3,0,6,3,3,-3,-3
Balogun,53,1,30,2018-09-01T14:00:00Z,True,2,8,0,0,3,3,0,3,3,0,0,3
Balogun,53,1,46,2018-09-17T19:00:00Z,False,2,15,0,0,4,4,0,4,1,3,0,-1
Balogun,53,1,51,2018-09-22T16:30:00Z,True,2,16,0,0,5,4,1,9,3,6,-4,-2
Balogun,53,1,66,2018-09-29T14:00:00Z,False,2,12,0,0,5,4,1,16,9,7,-11,-8
Balogun,53,1,70,2018-10-05T19:00:00Z,True,2,18,0,0,5,4,1,7,4,3,-2,1
Balogun,53,1,87,2018-10-20T14:00:00Z,False,2,14,0,0,8,7,1,2,0,2,6,1
Balogun,53,1,90,2018-10-27T14:00:00Z,True,2,19,0,0,11,7,4,15,8,7,-4,0
Balogun,53,1,104,2018-11-03T15:00:00Z,False,2,7,0,0,14,10,4,15,10,5,-1,-6
Balogun,53,1,111,2018-11-10T12:30:00Z,False,2,4,0,0,14,10,4,5,4,1,9,0
Balogun,53,1,121,2018-11-24T15:00:00Z,True,2,10,0,0,14,10,4,17,8,9,-3,1
Balogun,53,1,134,2018-12-01T15:00:00Z,False,2,9,12,0,15,11,4,10,5,5,5,-1
Balogun,53,1,141,2018-12-04T19:45:00Z,True,2,6,59,7,18,11,7,12,5,7,6,4
Balogun,53,1,152,2018-12-08T15:00:00Z,False,2,3,90,2,21,14,7,9,4,5,12,3
Balogun,53,1,160,2018-12-16T13:30:00Z,True,2,5,90,1,21,14,7,34,21,13,-13,1
Balogun,53,1,171,2018-12-22T15:00:00Z,False,2,1,90,1,21,14,7,23,14,9,-2,-7
Balogun,53,1,180,2018-12-26T17:15:00Z,True,2,0,90,2,21,14,7,37,23,14,-16,0
Balogun,53,1,190,2018-12-29T15:00:00Z,True,2,7,0,0,22,15,7,27,18,9,-5,6
Balogun,53,1,208,2019-01-02T19:45:00Z,False,2,18,0,0,25,18,7,27,13,14,-2,-6
Balogun,53,1,210,2019-01-12T15:00:00Z,True,2,11,0,0,26,18,8,54,28,26,-28,-8
Balogun,53,1,225,2019-01-19T15:00:00Z,False,2,13,0,0,26,18,8,41,21,20,-15,-13
Balogun,53,1,232,2019-01-29T19:45:00Z,False,2,8,0,0,26,18,8,14,12,2,12,-4
Balogun,53,1,240,2019-02-02T15:00:00Z,True,2,17,0,0,26,18,8,33,17,16,-7,2
Balogun,53,1,250,2019-02-09T17:30:00Z,True,2,3,0,0,27,19,8,24,14,10,3,9
Balogun,53,1,274,2019-02-26T19:45:00Z,False,2,10,0,0,27,19,8,32,14,18,-5,-6
Balogun,53,1,281,2019-03-02T15:00:00Z,True,2,9,0,0,27,19,8,14,8,6,13,13
Balogun,53,1,293,2019-03-09T12:30:00Z,False,2,6,0,0,30,22,8,33,13,20,-3,-5
Balogun,53,1,311,2019-03-30T15:00:00Z,True,2,15,0,0,33,22,11,30,18,12,3,10
Balogun,53,1,264,2019-04-03T18:45:00Z,False,2,5,0,0,33,22,11,60,32,28,-27,-21
Balogun,53,1,330,2019-04-13T14:00:00Z,True,2,1,0,0,33,22,11,38,26,12,-5,10
Balogun,53,1,301,2019-04-16T18:45:00Z,True,2,4,0,0,33,22,11,28,20,8,5,14
Balogun,53,1,349,2019-04-20T14:00:00Z,False,2,19,0,0,33,22,11,47,27,20,-14,-16
Balogun,53,1,327,2019-04-23T18:45:00Z,False,2,16,0,0,34,22,12,67,34,33,-33,-22
Balogun,53,1,350,2019-04-27T16:30:00Z,True,2,14,0,0,34,22,12,41,25,16,-7,6
Balogun,53,1,360,2019-05-05T15:30:00Z,False,2,0,0,0,35,23,12,66,44,22,-31,-32
Balogun,53,1,370,2019-05-12T14:00:00Z,True,2,12,0,0,36,23,13,95,54,41,-59,-18
Knockaert,54,2,8,2018-08-11T14:00:00Z,False,2,17,90,2,0,0,0,0,0,0,0,0
Knockaert,54,2,10,2018-08-19T15:00:00Z,True,2,13,90,5,0,0,0,3,3,0,-3,0
Knockaert,54,2,24,2018-08-25T16:30:00Z,False,2,11,75,2,3,3,0,6,3,3,-3,-3
Knockaert,54,2,30,2018-09-01T14:00:00Z,True,2,8,74,6,3,3,0,3,3,0,0,3
Knockaert,54,2,46,2018-09-17T19:00:00Z,False,2,15,90,4,4,4,0,4,1,3,0,-1
Knockaert,54,2,51,2018-09-22T16:30:00Z,True,2,16,90,7,5,4,1,9,3,6,-4,-2
Knockaert,54,2,66,2018-09-29T14:00:00Z,False,2,12,78,1,5,4,1,16,9,7,-11,-8
Knockaert,54,2,70,2018-10-05T19:00:00Z,True,2,18,90,3,5,4,1,7,4,3,-2,1
Knockaert,54,2,87,2018-10-20T14:00:00Z,False,2,14,0,0,8,7,1,2,0,2,6,1
Knockaert,54,2,90,2018-10-27T14:00:00Z,True,2,19,9,0,11,7,4,15,8,7,-4,0
Knockaert,54,2,104,2018-11-03T15:00:00Z,False,2,7,27,1,14,10,4,15,10,5,-1,-6
Knockaert,54,2,111,2018-11-10T12:30:00Z,False,2,4,90,2,14,10,4,5,4,1,9,0
Knockaert,54,2,121,2018-11-24T15:00:00Z,True,2,10,72,6,14,10,4,17,8,9,-3,1
Knockaert,54,2,134,2018-12-01T15:00:00Z,False,2,9,0,0,15,11,4,10,5,5,5,-1
Knockaert,54,2,141,2018-12-04T19:45:00Z,True,2,6,41,1,18,11,7,12,5,7,6,4
Knockaert,54,2,152,2018-12-08T15:00:00Z,False,2,3,62,2,21,14,7,9,4,5,12,3
Knockaert,54,2,160,2018-12-16T13:30:00Z,True,2,5,82,2,21,14,7,34,21,13,-13,1
Knockaert,54,2,171,2018-12-22T15:00:00Z,False,2,1,20,1,21,14,7,23,14,9,-2,-7
Knockaert,54,2,180,2018-12-26T17:15:00Z,True,2,0,4,1,21,14,7,37,23,14,-16,0
Knockaert,54,2,190,2018-12-29T15:00:00Z,True,2,7,0,0,22,15,7,27,18,9,-5,6
Knockaert,54,2,208,2019-01-02T19:45:00Z,False,2,18,0,0,25,18,7,27,13,14,-2,-6
Knockaert,54,2,210,2019-01-12T15:00:00Z,True,2,11,24,1,26,18,8,54,28,26,-28,-8
Knockaert,54,2,225,2019-01-19T15:00:00Z,False,2,13,30,1,26,18,8,41,21,20,-15,-13
Knockaert,54,2,232,2019-01-29T19:45:00Z,False,2,8,19,1,26,18,8,14,12,2,12,-4
Knockaert,54,2,240,2019-02-02T15:00:00Z,True,2,17,0,0,26,18,8,33,17,16,-7,2
Knockaert,54,2,250,2019-02-09T17:30:00Z,True,2,3,42,4,27,19,8,24,14,10,3,9
Knockaert,54,2,274,2019-02-26T19:45:00Z,False,2,10,90,2,27,19,8,32,14,18,-5,-6
Knockaert,54,2,281,2019-03-02T15:00:00Z,True,2,9,90,6,27,19,8,14,8,6,13,13
Knockaert,54,2,293,2019-03-09T12:30:00Z,False,2,6,74,7,30,22,8,33,13,20,-3,-5
Knockaert,54,2,311,2019-03-30T15:00:00Z,True,2,15,90,2,33,22,11,30,18,12,3,10
Knockaert,54,2,264,2019-04-03T18:45:00Z,False,2,5,59,1,33,22,11,60,32,28,-27,-21
Knockaert,54,2,330,2019-04-13T14:00:00Z,True,2,1,67,-1,33,22,11,38,26,12,-5,10
Knockaert,54,2,301,2019-04-16T18:45:00Z,True,2,4,0,0,33,22,11,28,20,8,5,14
Knockaert,54,2,349,2019-04-20T14:00:00Z,False,2,19,0,0,33,22,11,47,27,20,-14,-16
Knockaert,54,2,327,2019-04-23T18:45:00Z,False,2,16,0,0,34,22,12,67,34,33,-33,-22
Knockaert,54,2,350,2019-04-27T16:30:00Z,True,2,14,24,1,34,22,12,41,25,16,-7,6
Knockaert,54,2,360,2019-05-05T15:30:00Z,False,2,0,45,1,35,23,12,66,44,22,-31,-32
Knockaert,54,2,370,2019-05-12T14:00:00Z,True,2,12,90,2,36,23,13,95,54,41,-59,-18
Stephens,55,2,8,2018-08-11T14:00:00Z,False,2,17,90,1,0,0,0,0,0,0,0,0
Stephens,55,2,10,2018-08-19T15:00:00Z,True,2,13,90,2,0,0,0,3,3,0,-3,0
Stephens,55,2,24,2018-08-25T16:30:00Z,False,2,11,90,2,3,3,0,6,3,3,-3,-3
Stephens,55,2,30,2018-09-01T14:00:00Z,True,2,8,90,1,3,3,0,3,3,0,0,3
Stephens,55,2,46,2018-09-17T19:00:00Z,False,2,15,90,1,4,4,0,4,1,3,0,-1
Stephens,55,2,51,2018-09-22T16:30:00Z,True,2,16,20,1,5,4,1,9,3,6,-4,-2
Stephens,55,2,66,2018-09-29T14:00:00Z,False,2,12,0,0,5,4,1,16,9,7,-11,-8
Stephens,55,2,70,2018-10-05T19:00:00Z,True,2,18,0,0,5,4,1,7,4,3,-2,1
Stephens,55,2,87,2018-10-20T14:00:00Z,False,2,14,90,3,8,7,1,2,0,2,6,1
Stephens,55,2,90,2018-10-27T14:00:00Z,True,2,19,90,3,11,7,4,15,8,7,-4,0
Stephens,55,2,104,2018-11-03T15:00:00Z,False,2,7,90,2,14,10,4,15,10,5,-1,-6
Stephens,55,2,111,2018-11-10T12:30:00Z,False,2,4,33,-2,14,10,4,5,4,1,9,0
Stephens,55,2,121,2018-11-24T15:00:00Z,True,2,10,0,0,14,10,4,17,8,9,-3,1
Stephens,55,2,134,2018-12-01T15:00:00Z,False,2,9,0,0,15,11,4,10,5,5,5,-1
Stephens,55,2,141,2018-12-04T19:45:00Z,True,2,6,0,0,18,11,7,12,5,7,6,4
Stephens,55,2,152,2018-12-08T15:00:00Z,False,2,3,11,1,21,14,7,9,4,5,12,3
Stephens,55,2,160,2018-12-16T13:30:00Z,True,2,5,90,2,21,14,7,34,21,13,-13,1
Stephens,55,2,171,2018-12-22T15:00:00Z,False,2,1,0,0,21,14,7,23,14,9,-2,-7
Stephens,55,2,180,2018-12-26T17:15:00Z,True,2,0,90,2,21,14,7,37,23,14,-16,0
Stephens,55,2,190,2018-12-29T15:00:00Z,True,2,7,90,3,22,15,7,27,18,9,-5,6
Stephens,55,2,208,2019-01-02T19:45:00Z,False,2,18,90,9,25,18,7,27,13,14,-2,-6
Stephens,55,2,210,2019-01-12T15:00:00Z,True,2,11,90,2,26,18,8,54,28,26,-28,-8
Stephens,55,2,225,2019-01-19T15:00:00Z,False,2,13,90,2,26,18,8,41,21,20,-15,-13
Stephens,55,2,232,2019-01-29T19:45:00Z,False,2,8,90,1,26,18,8,14,12,2,12,-4
Stephens,55,2,240,2019-02-02T15:00:00Z,True,2,17,0,0,26,18,8,33,17,16,-7,2
Stephens,55,2,250,2019-02-09T17:30:00Z,True,2,3,90,2,27,19,8,24,14,10,3,9
Stephens,55,2,274,2019-02-26T19:45:00Z,False,2,10,80,2,27,19,8,32,14,18,-5,-6
Stephens,55,2,281,2019-03-02T15:00:00Z,True,2,9,90,3,27,19,8,14,8,6,13,13
Stephens,55,2,293,2019-03-09T12:30:00Z,False,2,6,90,7,30,22,8,33,13,20,-3,-5
Stephens,55,2,311,2019-03-30T15:00:00Z,True,2,15,90,1,33,22,11,30,18,12,3,10
Stephens,55,2,264,2019-04-03T18:45:00Z,False,2,5,90,2,33,22,11,60,32,28,-27,-21
Stephens,55,2,330,2019-04-13T14:00:00Z,True,2,1,90,2,33,22,11,38,26,12,-5,10
Stephens,55,2,301,2019-04-16T18:45:00Z,True,2,4,90,2,33,22,11,28,20,8,5,14
Stephens,55,2,349,2019-04-20T14:00:00Z,False,2,19,90,2,33,22,11,47,27,20,-14,-16
Stephens,55,2,327,2019-04-23T18:45:00Z,False,2,16,90,2,34,22,12,67,34,33,-33,-22
Stephens,55,2,350,2019-04-27T16:30:00Z,True,2,14,90,2,34,22,12,41,25,16,-7,6
Stephens,55,2,360,2019-05-05T15:30:00Z,False,2,0,90,2,35,23,12,66,44,22,-31,-32
Stephens,55,2,370,2019-05-12T14:00:00Z,True,2,12,0,0,36,23,13,95,54,41,-59,-18
Kayal,56,2,8,2018-08-11T14:00:00Z,False,2,17,0,0,0,0,0,0,0,0,0,0
Kayal,56,2,10,2018-08-19T15:00:00Z,True,2,13,1,1,0,0,0,3,3,0,-3,0
Kayal,56,2,24,2018-08-25T16:30:00Z,False,2,11,0,0,3,3,0,6,3,3,-3,-3
Kayal,56,2,30,2018-09-01T14:00:00Z,True,2,8,0,0,3,3,0,3,3,0,0,3
Kayal,56,2,46,2018-09-17T19:00:00Z,False,2,15,0,0,4,4,0,4,1,3,0,-1
Kayal,56,2,51,2018-09-22T16:30:00Z,True,2,16,69,1,5,4,1,9,3,6,-4,-2
Kayal,56,2,66,2018-09-29T14:00:00Z,False,2,12,90,2,5,4,1,16,9,7,-11,-8
Kayal,56,2,70,2018-10-05T19:00:00Z,True,2,18,90,5,5,4,1,7,4,3,-2,1
Kayal,56,2,87,2018-10-20T14:00:00Z,False,2,14,90,7,8,7,1,2,0,2,6,1
Kayal,56,2,90,2018-10-27T14:00:00Z,True,2,19,90,2,11,7,4,15,8,7,-4,0
Kayal,56,2,104,2018-11-03T15:00:00Z,False,2,7,77,2,14,10,4,15,10,5,-1,-6
Kayal,56,2,111,2018-11-10T12:30:00Z,False,2,4,90,2,14,10,4,5,4,1,9,0
Kayal,56,2,121,2018-11-24T15:00:00Z,True,2,10,90,2,14,10,4,17,8,9,-3,1
Kayal,56,2,134,2018-12-01T15:00:00Z,False,2,9,1,1,15,11,4,10,5,5,5,-1
Kayal,56,2,141,2018-12-04T19:45:00Z,True,2,6,0,0,18,11,7,12,5,7,6,4
Kayal,56,2,152,2018-12-08T15:00:00Z,False,2,3,0,0,21,14,7,9,4,5,12,3
Kayal,56,2,160,2018-12-16T13:30:00Z,True,2,5,0,0,21,14,7,34,21,13,-13,1
Kayal,56,2,171,2018-12-22T15:00:00Z,False,2,1,0,0,21,14,7,23,14,9,-2,-7
Kayal,56,2,180,2018-12-26T17:15:00Z,True,2,0,0,0,21,14,7,37,23,14,-16,0
Kayal,56,2,190,2018-12-29T15:00:00Z,True,2,7,0,0,22,15,7,27,18,9,-5,6
Kayal,56,2,208,2019-01-02T19:45:00Z,False,2,18,0,0,25,18,7,27,13,14,-2,-6
Kayal,56,2,210,2019-01-12T15:00:00Z,True,2,11,11,1,26,18,8,54,28,26,-28,-8
Kayal,56,2,225,2019-01-19T15:00:00Z,False,2,13,8,1,26,18,8,41,21,20,-15,-13
Kayal,56,2,232,2019-01-29T19:45:00Z,False,2,8,0,0,26,18,8,14,12,2,12,-4
Kayal,56,2,240,2019-02-02T15:00:00Z,True,2,17,0,0,26,18,8,33,17,16,-7,2
Kayal,56,2,250,2019-02-09T17:30:00Z,True,2,3,0,0,27,19,8,24,14,10,3,9
Kayal,56,2,274,2019-02-26T19:45:00Z,False,2,10,0,0,27,19,8,32,14,18,-5,-6
Kayal,56,2,281,2019-03-02T15:00:00Z,True,2,9,5,1,27,19,8,14,8,6,13,13
Kayal,56,2,293,2019-03-09T12:30:00Z,False,2,6,0,0,30,22,8,33,13,20,-3,-5
Kayal,56,2,311,2019-03-30T15:00:00Z,True,2,15,0,0,33,22,11,30,18,12,3,10
Kayal,56,2,264,2019-04-03T18:45:00Z,False,2,5,0,0,33,22,11,60,32,28,-27,-21
Kayal,56,2,330,2019-04-13T14:00:00Z,True,2,1,0,0,33,22,11,38,26,12,-5,10
Kayal,56,2,301,2019-04-16T18:45:00Z,True,2,4,0,0,33,22,11,28,20,8,5,14
Kayal,56,2,349,2019-04-20T14:00:00Z,False,2,19,80,3,33,22,11,47,27,20,-14,-16
Kayal,56,2,327,2019-04-23T18:45:00Z,False,2,16,4,1,34,22,12,67,34,33,-33,-22
Kayal,56,2,350,2019-04-27T16:30:00Z,True,2,14,48,1,34,22,12,41,25,16,-7,6
Kayal,56,2,360,2019-05-05T15:30:00Z,False,2,0,1,1,35,23,12,66,44,22,-31,-32
Kayal,56,2,370,2019-05-12T14:00:00Z,True,2,12,90,2,36,23,13,95,54,41,-59,-18
March,57,2,8,2018-08-11T14:00:00Z,False,2,17,70,2,0,0,0,0,0,0,0,0
March,57,2,10,2018-08-19T15:00:00Z,True,2,13,90,5,0,0,0,3,3,0,-3,0
March,57,2,24,2018-08-25T16:30:00Z,False,2,11,74,2,3,3,0,6,3,3,-3,-3
March,57,2,30,2018-09-01T14:00:00Z,True,2,8,90,2,3,3,0,3,3,0,0,3
March,57,2,46,2018-09-17T19:00:00Z,False,2,15,70,2,4,4,0,4,1,3,0,-1
March,57,2,51,2018-09-22T16:30:00Z,True,2,16,72,2,5,4,1,9,3,6,-4,-2
March,57,2,66,2018-09-29T14:00:00Z,False,2,12,82,2,5,4,1,16,9,7,-11,-8
March,57,2,70,2018-10-05T19:00:00Z,True,2,18,85,3,5,4,1,7,4,3,-2,1
March,57,2,87,2018-10-20T14:00:00Z,False,2,14,90,3,8,7,1,2,0,2,6,1
March,57,2,90,2018-10-27T14:00:00Z,True,2,19,70,3,11,7,4,15,8,7,-4,0
March,57,2,104,2018-11-03T15:00:00Z,False,2,7,69,6,14,10,4,15,10,5,-1,-6
March,57,2,111,2018-11-10T12:30:00Z,False,2,4,38,4,14,10,4,5,4,1,9,0
March,57,2,121,2018-11-24T15:00:00Z,True,2,10,17,1,14,10,4,17,8,9,-3,1
March,57,2,134,2018-12-01T15:00:00Z,False,2,9,90,11,15,11,4,10,5,5,5,-1
March,57,2,141,2018-12-04T19:45:00Z,True,2,6,90,2,18,11,7,12,5,7,6,4
March,57,2,152,2018-12-08T15:00:00Z,False,2,3,90,2,21,14,7,9,4,5,12,3
March,57,2,160,2018-12-16T13:30:00Z,True,2,5,90,8,21,14,7,34,21,13,-13,1
March,57,2,171,2018-12-22T15:00:00Z,False,2,1,90,2,21,14,7,23,14,9,-2,-7
March,57,2,180,2018-12-26T17:15:00Z,True,2,0,90,2,21,14,7,37,23,14,-16,0
March,57,2,190,2018-12-29T15:00:00Z,True,2,7,90,3,22,15,7,27,18,9,-5,6
March,57,2,208,2019-01-02T19:45:00Z,False,2,18,90,1,25,18,7,27,13,14,-2,-6
March,57,2,210,2019-01-12T15:00:00Z,True,2,11,65,2,26,18,8,54,28,26,-28,-8
March,57,2,225,2019-01-19T15:00:00Z,False,2,13,59,1,26,18,8,41,21,20,-15,-13
March,57,2,232,2019-01-29T19:45:00Z,False,2,8,90,2,26,18,8,14,12,2,12,-4
March,57,2,240,2019-02-02T15:00:00Z,True,2,17,90,3,26,18,8,33,17,16,-7,2
March,57,2,250,2019-02-09T17:30:00Z,True,2,3,47,1,27,19,8,24,14,10,3,9
March,57,2,274,2019-02-26T19:45:00Z,False,2,10,66,2,27,19,8,32,14,18,-5,-6
March,57,2,281,2019-03-02T15:00:00Z,True,2,9,0,0,27,19,8,14,8,6,13,13
March,57,2,293,2019-03-09T12:30:00Z,False,2,6,15,1,30,22,8,33,13,20,-3,-5
March,57,2,311,2019-03-30T15:00:00Z,True,2,15,28,1,33,22,11,30,18,12,3,10
March,57,2,264,2019-04-03T18:45:00Z,False,2,5,30,1,33,22,11,60,32,28,-27,-21
March,57,2,330,2019-04-13T14:00:00Z,True,2,1,0,0,33,22,11,38,26,12,-5,10
March,57,2,301,2019-04-16T18:45:00Z,True,2,4,90,2,33,22,11,28,20,8,5,14
March,57,2,349,2019-04-20T14:00:00Z,False,2,19,90,3,33,22,11,47,27,20,-14,-16
March,57,2,327,2019-04-23T18:45:00Z,False,2,16,17,1,34,22,12,67,34,33,-33,-22
March,57,2,350,2019-04-27T16:30:00Z,True,2,14,45,1,34,22,12,41,25,16,-7,6
March,57,2,360,2019-05-05T15:30:00Z,False,2,0,90,5,35,23,12,66,44,22,-31,-32
March,57,2,370,2019-05-12T14:00:00Z,True,2,12,0,0,36,23,13,95,54,41,-59,-18
Gro,58,2,8,2018-08-11T14:00:00Z,False,2,17,59,1,0,0,0,0,0,0,0,0
Gro,58,2,10,2018-08-19T15:00:00Z,True,2,13,89,10,0,0,0,3,3,0,-3,0
Gro,58,2,24,2018-08-25T16:30:00Z,False,2,11,10,1,3,3,0,6,3,3,-3,-3
Gro,58,2,30,2018-09-01T14:00:00Z,True,2,8,59,-1,3,3,0,3,3,0,0,3
Gro,58,2,46,2018-09-17T19:00:00Z,False,2,15,0,0,4,4,0,4,1,3,0,-1
Gro,58,2,51,2018-09-22T16:30:00Z,True,2,16,0,0,5,4,1,9,3,6,-4,-2
Gro,58,2,66,2018-09-29T14:00:00Z,False,2,12,0,0,5,4,1,16,9,7,-11,-8
Gro,58,2,70,2018-10-05T19:00:00Z,True,2,18,0,0,5,4,1,7,4,3,-2,1
Gro,58,2,87,2018-10-20T14:00:00Z,False,2,14,0,0,8,7,1,2,0,2,6,1
Gro,58,2,90,2018-10-27T14:00:00Z,True,2,19,0,0,11,7,4,15,8,7,-4,0
Gro,58,2,104,2018-11-03T15:00:00Z,False,2,7,0,0,14,10,4,15,10,5,-1,-6
Gro,58,2,111,2018-11-10T12:30:00Z,False,2,4,0,0,14,10,4,5,4,1,9,0
Gro,58,2,121,2018-11-24T15:00:00Z,True,2,10,81,2,14,10,4,17,8,9,-3,1
Gro,58,2,134,2018-12-01T15:00:00Z,False,2,9,90,2,15,11,4,10,5,5,5,-1
Gro,58,2,141,2018-12-04T19:45:00Z,True,2,6,30,1,18,11,7,12,5,7,6,4
Gro,58,2,152,2018-12-08T15:00:00Z,False,2,3,78,2,21,14,7,9,4,5,12,3
Gro,58,2,160,2018-12-16T13:30:00Z,True,2,5,80,2,21,14,7,34,21,13,-13,1
Gro,58,2,171,2018-12-22T15:00:00Z,False,2,1,75,2,21,14,7,23,14,9,-2,-7
Gro,58,2,180,2018-12-26T17:15:00Z,True,2,0,90,2,21,14,7,37,23,14,-16,0
Gro,58,2,190,2018-12-29T15:00:00Z,True,2,7,90,3,22,15,7,27,18,9,-5,6
Gro,58,2,208,2019-01-02T19:45:00Z,False,2,18,90,5,25,18,7,27,13,14,-2,-6
Gro,58,2,210,2019-01-12T15:00:00Z,True,2,11,78,2,26,18,8,54,28,26,-28,-8
Gro,58,2,225,2019-01-19T15:00:00Z,False,2,13,81,10,26,18,8,41,21,20,-15,-13
Gro,58,2,232,2019-01-29T19:45:00Z,False,2,8,76,5,26,18,8,14,12,2,12,-4
Gro,58,2,240,2019-02-02T15:00:00Z,True,2,17,90,6,26,18,8,33,17,16,-7,2
Gro,58,2,250,2019-02-09T17:30:00Z,True,2,3,65,2,27,19,8,24,14,10,3,9
Gro,58,2,274,2019-02-26T19:45:00Z,False,2,10,50,1,27,19,8,32,14,18,-5,-6
Gro,58,2,281,2019-03-02T15:00:00Z,True,2,9,0,0,27,19,8,14,8,6,13,13
Gro,58,2,293,2019-03-09T12:30:00Z,False,2,6,0,0,30,22,8,33,13,20,-3,-5
Gro,58,2,311,2019-03-30T15:00:00Z,True,2,15,0,0,33,22,11,30,18,12,3,10
Gro,58,2,264,2019-04-03T18:45:00Z,False,2,5,0,0,33,22,11,60,32,28,-27,-21
Gro,58,2,330,2019-04-13T14:00:00Z,True,2,1,0,0,33,22,11,38,26,12,-5,10
Gro,58,2,301,2019-04-16T18:45:00Z,True,2,4,53,1,33,22,11,28,20,8,5,14
Gro,58,2,349,2019-04-20T14:00:00Z,False,2,19,90,3,33,22,11,47,27,20,-14,-16
Gro,58,2,327,2019-04-23T18:45:00Z,False,2,16,90,2,34,22,12,67,34,33,-33,-22
Gro,58,2,350,2019-04-27T16:30:00Z,True,2,14,90,10,34,22,12,41,25,16,-7,6
Gro,58,2,360,2019-05-05T15:30:00Z,False,2,0,90,1,35,23,12,66,44,22,-31,-32
Gro,58,2,370,2019-05-12T14:00:00Z,True,2,12,90,5,36,23,13,95,54,41,-59,-18
Propper,59,2,8,2018-08-11T14:00:00Z,False,2,17,90,2,0,0,0,0,0,0,0,0
Propper,59,2,10,2018-08-19T15:00:00Z,True,2,13,90,2,0,0,0,3,3,0,-3,0
Propper,59,2,24,2018-08-25T16:30:00Z,False,2,11,90,2,3,3,0,6,3,3,-3,-3
Propper,59,2,30,2018-09-01T14:00:00Z,True,2,8,73,1,3,3,0,3,3,0,0,3
Propper,59,2,46,2018-09-17T19:00:00Z,False,2,15,90,2,4,4,0,4,1,3,0,-1
Propper,59,2,51,2018-09-22T16:30:00Z,True,2,16,90,2,5,4,1,9,3,6,-4,-2
Propper,59,2,66,2018-09-29T14:00:00Z,False,2,12,90,2,5,4,1,16,9,7,-11,-8
Propper,59,2,70,2018-10-05T19:00:00Z,True,2,18,79,3,5,4,1,7,4,3,-2,1
Propper,59,2,87,2018-10-20T14:00:00Z,False,2,14,0,0,8,7,1,2,0,2,6,1
Propper,59,2,90,2018-10-27T14:00:00Z,True,2,19,0,0,11,7,4,15,8,7,-4,0
Propper,59,2,104,2018-11-03T15:00:00Z,False,2,7,0,0,14,10,4,15,10,5,-1,-6
Propper,59,2,111,2018-11-10T12:30:00Z,False,2,4,0,0,14,10,4,5,4,1,9,0
Propper,59,2,121,2018-11-24T15:00:00Z,True,2,10,90,2,14,10,4,17,8,9,-3,1
Propper,59,2,134,2018-12-01T15:00:00Z,False,2,9,90,2,15,11,4,10,5,5,5,-1
Propper,59,2,141,2018-12-04T19:45:00Z,True,2,6,90,2,18,11,7,12,5,7,6,4
Propper,59,2,152,2018-12-08T15:00:00Z,False,2,3,90,2,21,14,7,9,4,5,12,3
Propper,59,2,160,2018-12-16T13:30:00Z,True,2,5,90,2,21,14,7,34,21,13,-13,1
Propper,59,2,171,2018-12-22T15:00:00Z,False,2,1,90,2,21,14,7,23,14,9,-2,-7
Propper,59,2,180,2018-12-26T17:15:00Z,True,2,0,90,2,21,14,7,37,23,14,-16,0
Propper,59,2,190,2018-12-29T15:00:00Z,True,2,7,90,3,22,15,7,27,18,9,-5,6
Propper,59,2,208,2019-01-02T19:45:00Z,False,2,18,90,2,25,18,7,27,13,14,-2,-6
Propper,59,2,210,2019-01-12T15:00:00Z,True,2,11,90,2,26,18,8,54,28,26,-28,-8
Propper,59,2,225,2019-01-19T15:00:00Z,False,2,13,90,5,26,18,8,41,21,20,-15,-13
Propper,59,2,232,2019-01-29T19:45:00Z,False,2,8,90,2,26,18,8,14,12,2,12,-4
Propper,59,2,240,2019-02-02T15:00:00Z,True,2,17,90,2,26,18,8,33,17,16,-7,2
Propper,59,2,250,2019-02-09T17:30:00Z,True,2,3,90,2,27,19,8,24,14,10,3,9
Propper,59,2,274,2019-02-26T19:45:00Z,False,2,10,90,10,27,19,8,32,14,18,-5,-6
Propper,59,2,281,2019-03-02T15:00:00Z,True,2,9,90,3,27,19,8,14,8,6,13,13
Propper,59,2,293,2019-03-09T12:30:00Z,False,2,6,90,2,30,22,8,33,13,20,-3,-5
Propper,59,2,311,2019-03-30T15:00:00Z,True,2,15,73,2,33,22,11,30,18,12,3,10
Propper,59,2,264,2019-04-03T18:45:00Z,False,2,5,90,2,33,22,11,60,32,28,-27,-21
Propper,59,2,330,2019-04-13T14:00:00Z,True,2,1,62,2,33,22,11,38,26,12,-5,10
Propper,59,2,301,2019-04-16T18:45:00Z,True,2,4,90,2,33,22,11,28,20,8,5,14
Propper,59,2,349,2019-04-20T14:00:00Z,False,2,19,9,1,33,22,11,47,27,20,-14,-16
Propper,59,2,327,2019-04-23T18:45:00Z,False,2,16,0,0,34,22,12,67,34,33,-33,-22
Propper,59,2,350,2019-04-27T16:30:00Z,True,2,14,0,0,34,22,12,41,25,16,-7,6
Propper,59,2,360,2019-05-05T15:30:00Z,False,2,0,0,0,35,23,12,66,44,22,-31,-32
Propper,59,2,370,2019-05-12T14:00:00Z,True,2,12,0,0,36,23,13,95,54,41,-59,-18
Izquierdo,60,2,8,2018-08-11T14:00:00Z,False,2,17,0,0,0,0,0,0,0,0,0,0
Izquierdo,60,2,10,2018-08-19T15:00:00Z,True,2,13,0,0,0,0,0,3,3,0,-3,0
Izquierdo,60,2,24,2018-08-25T16:30:00Z,False,2,11,0,0,3,3,0,6,3,3,-3,-3
Izquierdo,60,2,30,2018-09-01T14:00:00Z,True,2,8,0,0,3,3,0,3,3,0,0,3
Izquierdo,60,2,46,2018-09-17T19:00:00Z,False,2,15,0,0,4,4,0,4,1,3,0,-1
Izquierdo,60,2,51,2018-09-22T16:30:00Z,True,2,16,0,0,5,4,1,9,3,6,-4,-2
Izquierdo,60,2,66,2018-09-29T14:00:00Z,False,2,12,7,1,5,4,1,16,9,7,-11,-8
Izquierdo,60,2,70,2018-10-05T19:00:00Z,True,2,18,19,1,5,4,1,7,4,3,-2,1
Izquierdo,60,2,87,2018-10-20T14:00:00Z,False,2,14,79,6,8,7,1,2,0,2,6,1
Izquierdo,60,2,90,2018-10-27T14:00:00Z,True,2,19,80,3,11,7,4,15,8,7,-4,0
Izquierdo,60,2,104,2018-11-03T15:00:00Z,False,2,7,62,2,14,10,4,15,10,5,-1,-6
Izquierdo,60,2,111,2018-11-10T12:30:00Z,False,2,4,90,2,14,10,4,5,4,1,9,0
Izquierdo,60,2,121,2018-11-24T15:00:00Z,True,2,10,90,1,14,10,4,17,8,9,-3,1
Izquierdo,60,2,134,2018-12-01T15:00:00Z,False,2,9,90,2,15,11,4,10,5,5,5,-1
Izquierdo,60,2,141,2018-12-04T19:45:00Z,True,2,6,48,4,18,11,7,12,5,7,6,4
Izquierdo,60,2,152,2018-12-08T15:00:00Z,False,2,3,0,0,21,14,7,9,4,5,12,3
Izquierdo,60,2,160,2018-12-16T13:30:00Z,True,2,5,0,0,21,14,7,34,21,13,-13,1
Izquierdo,60,2,171,2018-12-22T15:00:00Z,False,2,1,0,0,21,14,7,23,14,9,-2,-7
Izquierdo,60,2,180,2018-12-26T17:15:00Z,True,2,0,0,0,21,14,7,37,23,14,-16,0
Izquierdo,60,2,190,2018-12-29T15:00:00Z,True,2,7,0,0,22,15,7,27,18,9,-5,6
Izquierdo,60,2,208,2019-01-02T19:45:00Z,False,2,18,0,0,25,18,7,27,13,14,-2,-6
Izquierdo,60,2,210,2019-01-12T15:00:00Z,True,2,11,0,0,26,18,8,54,28,26,-28,-8
Izquierdo,60,2,225,2019-01-19T15:00:00Z,False,2,13,0,0,26,18,8,41,21,20,-15,-13
Izquierdo,60,2,232,2019-01-29T19:45:00Z,False,2,8,0,0,26,18,8,14,12,2,12,-4
Izquierdo,60,2,240,2019-02-02T15:00:00Z,True,2,17,0,0,26,18,8,33,17,16,-7,2
Izquierdo,60,2,250,2019-02-09T17:30:00Z,True,2,3,0,0,27,19,8,24,14,10,3,9
Izquierdo,60,2,274,2019-02-26T19:45:00Z,False,2,10,9,1,27,19,8,32,14,18,-5,-6
Izquierdo,60,2,281,2019-03-02T15:00:00Z,True,2,9,12,1,27,19,8,14,8,6,13,13
Izquierdo,60,2,293,2019-03-09T12:30:00Z,False,2,6,0,0,30,22,8,33,13,20,-3,-5
Izquierdo,60,2,311,2019-03-30T15:00:00Z,True,2,15,0,0,33,22,11,30,18,12,3,10
Izquierdo,60,2,264,2019-04-03T18:45:00Z,False,2,5,0,0,33,22,11,60,32,28,-27,-21
Izquierdo,60,2,330,2019-04-13T14:00:00Z,True,2,1,27,1,33,22,11,38,26,12,-5,10
Izquierdo,60,2,301,2019-04-16T18:45:00Z,True,2,4,21,1,33,22,11,28,20,8,5,14
Izquierdo,60,2,349,2019-04-20T14:00:00Z,False,2,19,90,3,33,22,11,47,27,20,-14,-16
Izquierdo,60,2,327,2019-04-23T18:45:00Z,False,2,16,0,0,34,22,12,67,34,33,-33,-22
Izquierdo,60,2,350,2019-04-27T16:30:00Z,True,2,14,65,2,34,22,12,41,25,16,-7,6
Izquierdo,60,2,360,2019-05-05T15:30:00Z,False,2,0,0,0,35,23,12,66,44,22,-31,-32
Izquierdo,60,2,370,2019-05-12T14:00:00Z,True,2,12,0,0,36,23,13,95,54,41,-59,-18
Murray,61,3,8,2018-08-11T14:00:00Z,False,2,17,90,2,0,0,0,0,0,0,0,0
Murray,61,3,10,2018-08-19T15:00:00Z,True,2,13,90,5,0,0,0,3,3,0,-3,0
Murray,61,3,24,2018-08-25T16:30:00Z,False,2,11,90,2,3,3,0,6,3,3,-3,-3
Murray,61,3,30,2018-09-01T14:00:00Z,True,2,8,90,12,3,3,0,3,3,0,0,3
Murray,61,3,46,2018-09-17T19:00:00Z,False,2,15,90,6,4,4,0,4,1,3,0,-1
Murray,61,3,51,2018-09-22T16:30:00Z,True,2,16,90,2,5,4,1,9,3,6,-4,-2
Murray,61,3,66,2018-09-29T14:00:00Z,False,2,12,17,1,5,4,1,16,9,7,-11,-8
Murray,61,3,70,2018-10-05T19:00:00Z,True,2,18,90,9,5,4,1,7,4,3,-2,1
Murray,61,3,87,2018-10-20T14:00:00Z,False,2,14,15,1,8,7,1,2,0,2,6,1
Murray,61,3,90,2018-10-27T14:00:00Z,True,2,19,90,7,11,7,4,15,8,7,-4,0
Murray,61,3,104,2018-11-03T15:00:00Z,False,2,7,90,2,14,10,4,15,10,5,-1,-6
Murray,61,3,111,2018-11-10T12:30:00Z,False,2,4,62,2,14,10,4,5,4,1,9,0
Murray,61,3,121,2018-11-24T15:00:00Z,True,2,10,88,8,14,10,4,17,8,9,-3,1
Murray,61,3,134,2018-12-01T15:00:00Z,False,2,9,11,1,15,11,4,10,5,5,5,-1
Murray,61,3,141,2018-12-04T19:45:00Z,True,2,6,34,7,18,11,7,12,5,7,6,4
Murray,61,3,152,2018-12-08T15:00:00Z,False,2,3,27,1,21,14,7,9,4,5,12,3
Murray,61,3,160,2018-12-16T13:30:00Z,True,2,5,59,1,21,14,7,34,21,13,-13,1
Murray,61,3,171,2018-12-22T15:00:00Z,False,2,1,10,1,21,14,7,23,14,9,-2,-7
Murray,61,3,180,2018-12-26T17:15:00Z,True,2,0,78,1,21,14,7,37,23,14,-16,0
Murray,61,3,190,2018-12-29T15:00:00Z,True,2,7,16,1,22,15,7,27,18,9,-5,6
Murray,61,3,208,2019-01-02T19:45:00Z,False,2,18,81,2,25,18,7,27,13,14,-2,-6
Murray,61,3,210,2019-01-12T15:00:00Z,True,2,11,65,2,26,18,8,54,28,26,-28,-8
Murray,61,3,225,2019-01-19T15:00:00Z,False,2,13,59,1,26,18,8,41,21,20,-15,-13
Murray,61,3,232,2019-01-29T19:45:00Z,False,2,8,90,12,26,18,8,14,12,2,12,-4
Murray,61,3,240,2019-02-02T15:00:00Z,True,2,17,71,2,26,18,8,33,17,16,-7,2
Murray,61,3,250,2019-02-09T17:30:00Z,True,2,3,90,2,27,19,8,24,14,10,3,9
Murray,61,3,274,2019-02-26T19:45:00Z,False,2,10,90,2,27,19,8,32,14,18,-5,-6
Murray,61,3,281,2019-03-02T15:00:00Z,True,2,9,56,0,27,19,8,14,8,6,13,13
Murray,61,3,293,2019-03-09T12:30:00Z,False,2,6,90,5,30,22,8,33,13,20,-3,-5
Murray,61,3,311,2019-03-30T15:00:00Z,True,2,15,90,2,33,22,11,30,18,12,3,10
Murray,61,3,264,2019-04-03T18:45:00Z,False,2,5,20,1,33,22,11,60,32,28,-27,-21
Murray,61,3,330,2019-04-13T14:00:00Z,True,2,1,32,1,33,22,11,38,26,12,-5,10
Murray,61,3,301,2019-04-16T18:45:00Z,True,2,4,90,2,33,22,11,28,20,8,5,14
Murray,61,3,349,2019-04-20T14:00:00Z,False,2,19,90,2,33,22,11,47,27,20,-14,-16
Murray,61,3,327,2019-04-23T18:45:00Z,False,2,16,26,1,34,22,12,67,34,33,-33,-22
Murray,61,3,350,2019-04-27T16:30:00Z,True,2,14,90,5,34,22,12,41,25,16,-7,6
Murray,61,3,360,2019-05-05T15:30:00Z,False,2,0,77,9,35,23,12,66,44,22,-31,-32
Murray,61,3,370,2019-05-12T14:00:00Z,True,2,12,67,6,36,23,13,95,54,41,-59,-18
Hemed,62,3,8,2018-08-11T14:00:00Z,False,2,17,0,0,0,0,0,0,0,0,0,0
Hemed,62,3,10,2018-08-19T15:00:00Z,True,2,13,0,0,0,0,0,3,3,0,-3,0
Hemed,62,3,24,2018-08-25T16:30:00Z,False,2,11,0,0,3,3,0,6,3,3,-3,-3
Hemed,62,3,30,2018-09-01T14:00:00Z,True,2,8,0,0,3,3,0,3,3,0,0,3
Hemed,62,3,46,2018-09-17T19:00:00Z,False,2,15,0,0,4,4,0,4,1,3,0,-1
Hemed,62,3,51,2018-09-22T16:30:00Z,True,2,16,0,0,5,4,1,9,3,6,-4,-2
Hemed,62,3,66,2018-09-29T14:00:00Z,False,2,12,0,0,5,4,1,16,9,7,-11,-8
Hemed,62,3,70,2018-10-05T19:00:00Z,True,2,18,0,0,5,4,1,7,4,3,-2,1
Hemed,62,3,87,2018-10-20T14:00:00Z,False,2,14,0,0,8,7,1,2,0,2,6,1
Hemed,62,3,90,2018-10-27T14:00:00Z,True,2,19,0,0,11,7,4,15,8,7,-4,0
Hemed,62,3,104,2018-11-03T15:00:00Z,False,2,7,0,0,14,10,4,15,10,5,-1,-6
Hemed,62,3,111,2018-11-10T12:30:00Z,False,2,4,0,0,14,10,4,5,4,1,9,0
Hemed,62,3,121,2018-11-24T15:00:00Z,True,2,10,0,0,14,10,4,17,8,9,-3,1
Hemed,62,3,134,2018-12-01T15:00:00Z,False,2,9,0,0,15,11,4,10,5,5,5,-1
Hemed,62,3,141,2018-12-04T19:45:00Z,True,2,6,0,0,18,11,7,12,5,7,6,4
Hemed,62,3,152,2018-12-08T15:00:00Z,False,2,3,0,0,21,14,7,9,4,5,12,3
Hemed,62,3,160,2018-12-16T13:30:00Z,True,2,5,0,0,21,14,7,34,21,13,-13,1
Hemed,62,3,171,2018-12-22T15:00:00Z,False,2,1,0,0,21,14,7,23,14,9,-2,-7
Hemed,62,3,180,2018-12-26T17:15:00Z,True,2,0,0,0,21,14,7,37,23,14,-16,0
Hemed,62,3,190,2018-12-29T15:00:00Z,True,2,7,0,0,22,15,7,27,18,9,-5,6
Hemed,62,3,208,2019-01-02T19:45:00Z,False,2,18,0,0,25,18,7,27,13,14,-2,-6
Hemed,62,3,210,2019-01-12T15:00:00Z,True,2,11,0,0,26,18,8,54,28,26,-28,-8
Hemed,62,3,225,2019-01-19T15:00:00Z,False,2,13,0,0,26,18,8,41,21,20,-15,-13
Hemed,62,3,232,2019-01-29T19:45:00Z,False,2,8,0,0,26,18,8,14,12,2,12,-4
Hemed,62,3,240,2019-02-02T15:00:00Z,True,2,17,0,0,26,18,8,33,17,16,-7,2
Hemed,62,3,250,2019-02-09T17:30:00Z,True,2,3,0,0,27,19,8,24,14,10,3,9
Hemed,62,3,274,2019-02-26T19:45:00Z,False,2,10,0,0,27,19,8,32,14,18,-5,-6
Hemed,62,3,281,2019-03-02T15:00:00Z,True,2,9,0,0,27,19,8,14,8,6,13,13
Hemed,62,3,293,2019-03-09T12:30:00Z,False,2,6,0,0,30,22,8,33,13,20,-3,-5
Hemed,62,3,311,2019-03-30T15:00:00Z,True,2,15,0,0,33,22,11,30,18,12,3,10
Hemed,62,3,264,2019-04-03T18:45:00Z,False,2,5,0,0,33,22,11,60,32,28,-27,-21
Hemed,62,3,330,2019-04-13T14:00:00Z,True,2,1,0,0,33,22,11,38,26,12,-5,10
Hemed,62,3,301,2019-04-16T18:45:00Z,True,2,4,0,0,33,22,11,28,20,8,5,14
Hemed,62,3,349,2019-04-20T14:00:00Z,False,2,19,0,0,33,22,11,47,27,20,-14,-16
Hemed,62,3,327,2019-04-23T18:45:00Z,False,2,16,0,0,34,22,12,67,34,33,-33,-22
Hemed,62,3,350,2019-04-27T16:30:00Z,True,2,14,0,0,34,22,12,41,25,16,-7,6
Hemed,62,3,360,2019-05-05T15:30:00Z,False,2,0,0,0,35,23,12,66,44,22,-31,-32
Hemed,62,3,370,2019-05-12T14:00:00Z,True,2,12,0,0,36,23,13,95,54,41,-59,-18
Baldock,63,3,8,2018-08-11T14:00:00Z,False,2,17,0,0,0,0,0,0,0,0,0,0
Baldock,63,3,10,2018-08-19T15:00:00Z,True,2,13,0,0,0,0,0,3,3,0,-3,0
Baldock,63,3,24,2018-08-25T16:30:00Z,False,2,11,0,0,3,3,0,6,3,3,-3,-3
Baldock,63,3,30,2018-09-01T14:00:00Z,True,2,8,0,0,3,3,0,3,3,0,0,3
Baldock,63,3,46,2018-09-17T19:00:00Z,False,2,15,0,0,4,4,0,4,1,3,0,-1
Baldock,63,3,51,2018-09-22T16:30:00Z,True,2,16,0,0,5,4,1,9,3,6,-4,-2
Baldock,63,3,66,2018-09-29T14:00:00Z,False,2,12,0,0,5,4,1,16,9,7,-11,-8
Baldock,63,3,70,2018-10-05T19:00:00Z,True,2,18,0,0,5,4,1,7,4,3,-2,1
Baldock,63,3,87,2018-10-20T14:00:00Z,False,2,14,0,0,8,7,1,2,0,2,6,1
Baldock,63,3,90,2018-10-27T14:00:00Z,True,2,19,0,0,11,7,4,15,8,7,-4,0
Baldock,63,3,104,2018-11-03T15:00:00Z,False,2,7,0,0,14,10,4,15,10,5,-1,-6
Baldock,63,3,111,2018-11-10T12:30:00Z,False,2,4,0,0,14,10,4,5,4,1,9,0
Baldock,63,3,121,2018-11-24T15:00:00Z,True,2,10,0,0,14,10,4,17,8,9,-3,1
Baldock,63,3,134,2018-12-01T15:00:00Z,False,2,9,0,0,15,11,4,10,5,5,5,-1
Baldock,63,3,141,2018-12-04T19:45:00Z,True,2,6,0,0,18,11,7,12,5,7,6,4
Baldock,63,3,152,2018-12-08T15:00:00Z,False,2,3,0,0,21,14,7,9,4,5,12,3
Baldock,63,3,160,2018-12-16T13:30:00Z,True,2,5,0,0,21,14,7,34,21,13,-13,1
Baldock,63,3,171,2018-12-22T15:00:00Z,False,2,1,0,0,21,14,7,23,14,9,-2,-7
Baldock,63,3,180,2018-12-26T17:15:00Z,True,2,0,0,0,21,14,7,37,23,14,-16,0
Baldock,63,3,190,2018-12-29T15:00:00Z,True,2,7,0,0,22,15,7,27,18,9,-5,6
Baldock,63,3,208,2019-01-02T19:45:00Z,False,2,18,0,0,25,18,7,27,13,14,-2,-6
Baldock,63,3,210,2019-01-12T15:00:00Z,True,2,11,0,0,26,18,8,54,28,26,-28,-8
Baldock,63,3,225,2019-01-19T15:00:00Z,False,2,13,0,0,26,18,8,41,21,20,-15,-13
Baldock,63,3,232,2019-01-29T19:45:00Z,False,2,8,0,0,26,18,8,14,12,2,12,-4
Baldock,63,3,240,2019-02-02T15:00:00Z,True,2,17,0,0,26,18,8,33,17,16,-7,2
Baldock,63,3,250,2019-02-09T17:30:00Z,True,2,3,0,0,27,19,8,24,14,10,3,9
Baldock,63,3,274,2019-02-26T19:45:00Z,False,2,10,0,0,27,19,8,32,14,18,-5,-6
Baldock,63,3,281,2019-03-02T15:00:00Z,True,2,9,0,0,27,19,8,14,8,6,13,13
Baldock,63,3,293,2019-03-09T12:30:00Z,False,2,6,0,0,30,22,8,33,13,20,-3,-5
Baldock,63,3,311,2019-03-30T15:00:00Z,True,2,15,0,0,33,22,11,30,18,12,3,10
Baldock,63,3,264,2019-04-03T18:45:00Z,False,2,5,0,0,33,22,11,60,32,28,-27,-21
Baldock,63,3,330,2019-04-13T14:00:00Z,True,2,1,0,0,33,22,11,38,26,12,-5,10
Baldock,63,3,301,2019-04-16T18:45:00Z,True,2,4,0,0,33,22,11,28,20,8,5,14
Baldock,63,3,349,2019-04-20T14:00:00Z,False,2,19,0,0,33,22,11,47,27,20,-14,-16
Baldock,63,3,327,2019-04-23T18:45:00Z,False,2,16,0,0,34,22,12,67,34,33,-33,-22
Baldock,63,3,350,2019-04-27T16:30:00Z,True,2,14,0,0,34,22,12,41,25,16,-7,6
Baldock,63,3,360,2019-05-05T15:30:00Z,False,2,0,0,0,35,23,12,66,44,22,-31,-32
Baldock,63,3,370,2019-05-12T14:00:00Z,True,2,12,0,0,36,23,13,95,54,41,-59,-18
Locadia,64,3,8,2018-08-11T14:00:00Z,False,2,17,0,0,0,0,0,0,0,0,0,0
Locadia,64,3,10,2018-08-19T15:00:00Z,True,2,13,1,1,0,0,0,3,3,0,-3,0
Locadia,64,3,24,2018-08-25T16:30:00Z,False,2,11,15,1,3,3,0,6,3,3,-3,-3
Locadia,64,3,30,2018-09-01T14:00:00Z,True,2,8,16,1,3,3,0,3,3,0,0,3
Locadia,64,3,46,2018-09-17T19:00:00Z,False,2,15,14,0,4,4,0,4,1,3,0,-1
Locadia,64,3,51,2018-09-22T16:30:00Z,True,2,16,11,1,5,4,1,9,3,6,-4,-2
Locadia,64,3,66,2018-09-29T14:00:00Z,False,2,12,72,2,5,4,1,16,9,7,-11,-8
Locadia,64,3,70,2018-10-05T19:00:00Z,True,2,18,4,1,5,4,1,7,4,3,-2,1
Locadia,64,3,87,2018-10-20T14:00:00Z,False,2,14,74,2,8,7,1,2,0,2,6,1
Locadia,64,3,90,2018-10-27T14:00:00Z,True,2,19,0,0,11,7,4,15,8,7,-4,0
Locadia,64,3,104,2018-11-03T15:00:00Z,False,2,7,0,0,14,10,4,15,10,5,-1,-6
Locadia,64,3,111,2018-11-10T12:30:00Z,False,2,4,0,0,14,10,4,5,4,1,9,0
Locadia,64,3,121,2018-11-24T15:00:00Z,True,2,10,1,1,14,10,4,17,8,9,-3,1
Locadia,64,3,134,2018-12-01T15:00:00Z,False,2,9,0,0,15,11,4,10,5,5,5,-1
Locadia,64,3,141,2018-12-04T19:45:00Z,True,2,6,0,0,18,11,7,12,5,7,6,4
Locadia,64,3,152,2018-12-08T15:00:00Z,False,2,3,27,1,21,14,7,9,4,5,12,3
Locadia,64,3,160,2018-12-16T13:30:00Z,True,2,5,7,1,21,14,7,34,21,13,-13,1
Locadia,64,3,171,2018-12-22T15:00:00Z,False,2,1,69,2,21,14,7,23,14,9,-2,-7
Locadia,64,3,180,2018-12-26T17:15:00Z,True,2,0,85,9,21,14,7,37,23,14,-16,0
Locadia,64,3,190,2018-12-29T15:00:00Z,True,2,7,90,9,22,15,7,27,18,9,-5,6
Locadia,64,3,208,2019-01-02T19:45:00Z,False,2,18,90,2,25,18,7,27,13,14,-2,-6
Locadia,64,3,210,2019-01-12T15:00:00Z,True,2,11,90,2,26,18,8,54,28,26,-28,-8
Locadia,64,3,225,2019-01-19T15:00:00Z,False,2,13,90,2,26,18,8,41,21,20,-15,-13
Locadia,64,3,232,2019-01-29T19:45:00Z,False,2,8,71,2,26,18,8,14,12,2,12,-4
Locadia,64,3,240,2019-02-02T15:00:00Z,True,2,17,90,2,26,18,8,33,17,16,-7,2
Locadia,64,3,250,2019-02-09T17:30:00Z,True,2,3,65,2,27,19,8,24,14,10,3,9
Locadia,64,3,274,2019-02-26T19:45:00Z,False,2,10,23,1,27,19,8,32,14,18,-5,-6
Locadia,64,3,281,2019-03-02T15:00:00Z,True,2,9,0,0,27,19,8,14,8,6,13,13
Locadia,64,3,293,2019-03-09T12:30:00Z,False,2,6,1,1,30,22,8,33,13,20,-3,-5
Locadia,64,3,311,2019-03-30T15:00:00Z,True,2,15,16,1,33,22,11,30,18,12,3,10
Locadia,64,3,264,2019-04-03T18:45:00Z,False,2,5,0,0,33,22,11,60,32,28,-27,-21
Locadia,64,3,330,2019-04-13T14:00:00Z,True,2,1,90,2,33,22,11,38,26,12,-5,10
Locadia,64,3,301,2019-04-16T18:45:00Z,True,2,4,0,0,33,22,11,28,20,8,5,14
Locadia,64,3,349,2019-04-20T14:00:00Z,False,2,19,0,0,33,22,11,47,27,20,-14,-16
Locadia,64,3,327,2019-04-23T18:45:00Z,False,2,16,90,2,34,22,12,67,34,33,-33,-22
Locadia,64,3,350,2019-04-27T16:30:00Z,True,2,14,0,0,34,22,12,41,25,16,-7,6
Locadia,64,3,360,2019-05-05T15:30:00Z,False,2,0,0,0,35,23,12,66,44,22,-31,-32
Locadia,64,3,370,2019-05-12T14:00:00Z,True,2,12,23,1,36,23,13,95,54,41,-59,-18
Andone,65,3,8,2018-08-11T14:00:00Z,False,2,17,0,0,0,0,0,0,0,0,0,0
Andone,65,3,10,2018-08-19T15:00:00Z,True,2,13,0,0,0,0,0,3,3,0,-3,0
Andone,65,3,24,2018-08-25T16:30:00Z,False,2,11,0,0,3,3,0,6,3,3,-3,-3
Andone,65,3,30,2018-09-01T14:00:00Z,True,2,8,0,0,3,3,0,3,3,0,0,3
Andone,65,3,46,2018-09-17T19:00:00Z,False,2,15,0,0,4,4,0,4,1,3,0,-1
Andone,65,3,51,2018-09-22T16:30:00Z,True,2,16,0,0,5,4,1,9,3,6,-4,-2
Andone,65,3,66,2018-09-29T14:00:00Z,False,2,12,0,0,5,4,1,16,9,7,-11,-8
Andone,65,3,70,2018-10-05T19:00:00Z,True,2,18,0,0,5,4,1,7,4,3,-2,1
Andone,65,3,87,2018-10-20T14:00:00Z,False,2,14,0,0,8,7,1,2,0,2,6,1
Andone,65,3,90,2018-10-27T14:00:00Z,True,2,19,0,0,11,7,4,15,8,7,-4,0
Andone,65,3,104,2018-11-03T15:00:00Z,False,2,7,13,1,14,10,4,15,10,5,-1,-6
Andone,65,3,111,2018-11-10T12:30:00Z,False,2,4,27,1,14,10,4,5,4,1,9,0
Andone,65,3,121,2018-11-24T15:00:00Z,True,2,10,8,1,14,10,4,17,8,9,-3,1
Andone,65,3,134,2018-12-01T15:00:00Z,False,2,9,78,7,15,11,4,10,5,5,5,-1
Andone,65,3,141,2018-12-04T19:45:00Z,True,2,6,55,6,18,11,7,12,5,7,6,4
Andone,65,3,152,2018-12-08T15:00:00Z,False,2,3,62,2,21,14,7,9,4,5,12,3
Andone,65,3,160,2018-12-16T13:30:00Z,True,2,5,30,0,21,14,7,34,21,13,-13,1
Andone,65,3,171,2018-12-22T15:00:00Z,False,2,1,79,2,21,14,7,23,14,9,-2,-7
Andone,65,3,180,2018-12-26T17:15:00Z,True,2,0,11,1,21,14,7,37,23,14,-16,0
Andone,65,3,190,2018-12-29T15:00:00Z,True,2,7,73,2,22,15,7,27,18,9,-5,6
Andone,65,3,208,2019-01-02T19:45:00Z,False,2,18,8,1,25,18,7,27,13,14,-2,-6
Andone,65,3,210,2019-01-12T15:00:00Z,True,2,11,24,1,26,18,8,54,28,26,-28,-8
Andone,65,3,225,2019-01-19T15:00:00Z,False,2,13,30,1,26,18,8,41,21,20,-15,-13
Andone,65,3,232,2019-01-29T19:45:00Z,False,2,8,13,1,26,18,8,14,12,2,12,-4
Andone,65,3,240,2019-02-02T15:00:00Z,True,2,17,18,1,26,18,8,33,17,16,-7,2
Andone,65,3,250,2019-02-09T17:30:00Z,True,2,3,0,0,27,19,8,24,14,10,3,9
Andone,65,3,274,2019-02-26T19:45:00Z,False,2,10,0,0,27,19,8,32,14,18,-5,-6
Andone,65,3,281,2019-03-02T15:00:00Z,True,2,9,33,4,27,19,8,14,8,6,13,13
Andone,65,3,293,2019-03-09T12:30:00Z,False,2,6,0,0,30,22,8,33,13,20,-3,-5
Andone,65,3,311,2019-03-30T15:00:00Z,True,2,15,0,0,33,22,11,30,18,12,3,10
Andone,65,3,264,2019-04-03T18:45:00Z,False,2,5,69,2,33,22,11,60,32,28,-27,-21
Andone,65,3,330,2019-04-13T14:00:00Z,True,2,1,57,0,33,22,11,38,26,12,-5,10
Andone,65,3,301,2019-04-16T18:45:00Z,True,2,4,36,1,33,22,11,28,20,8,5,14
Andone,65,3,349,2019-04-20T14:00:00Z,False,2,19,0,0,33,22,11,47,27,20,-14,-16
Andone,65,3,327,2019-04-23T18:45:00Z,False,2,16,63,1,34,22,12,67,34,33,-33,-22
Andone,65,3,350,2019-04-27T16:30:00Z,True,2,14,45,0,34,22,12,41,25,16,-7,6
Andone,65,3,360,2019-05-05T15:30:00Z,False,2,0,12,1,35,23,12,66,44,22,-31,-32
Andone,65,3,370,2019-05-12T14:00:00Z,True,2,12,22,1,36,23,13,95,54,41,-59,-18
Heaton,66,0,7,2018-08-12T12:30:00Z,False,3,15,0,0,0,0,0,0,0,0,0,0
Heaton,66,0,11,2018-08-19T12:30:00Z,True,3,17,0,0,1,0,1,3,3,0,-2,0
Heaton,66,0,22,2018-08-26T15:00:00Z,False,3,8,0,0,1,0,1,0,0,0,1,1
Heaton,66,0,31,2018-09-02T15:00:00Z,True,3,13,0,0,1,0,1,3,3,0,-2,0
Heaton,66,0,49,2018-09-16T12:30:00Z,False,3,19,0,0,1,0,1,5,2,3,-4,-1
Heaton,66,0,52,2018-09-22T14:00:00Z,True,3,1,0,0,1,0,1,10,7,3,-9,-3
Heaton,66,0,62,2018-09-30T15:00:00Z,False,3,4,0,0,4,3,1,2,1,1,2,0
Heaton,66,0,71,2018-10-06T14:00:00Z,True,3,9,0,0,7,3,4,2,1,1,5,2
Heaton,66,0,86,2018-10-20T14:00:00Z,False,3,12,0,0,8,4,4,20,12,8,-12,-8
Heaton,66,0,91,2018-10-28T13:30:00Z,True,3,5,0,0,8,4,4,21,11,10,-13,-6
Heaton,66,0,108,2018-11-03T15:00:00Z,False,3,18,0,0,8,4,4,8,4,4,0,0
Heaton,66,0,115,2018-11-10T15:00:00Z,False,3,10,0,0,8,4,4,16,7,9,-8,-3
Heaton,66,0,122,2018-11-26T20:30:00Z,True,3,14,0,0,9,4,5,9,6,3,0,1
Heaton,66,0,133,2018-12-01T15:00:00Z,False,3,6,0,0,9,4,5,9,2,7,0,3
Heaton,66,0,142,2018-12-05T19:45:00Z,True,3,11,0,0,9,4,5,36,19,17,-27,-13
Heaton,66,0,152,2018-12-08T15:00:00Z,True,3,2,0,0,9,4,5,21,14,7,-12,-3
Heaton,66,0,167,2018-12-15T15:00:00Z,False,3,16,0,0,12,7,5,36,12,24,-24,-7
Heaton,66,0,170,2018-12-22T12:30:00Z,False,3,0,0,0,12,7,5,34,20,14,-22,-15
Heaton,66,0,181,2018-12-26T15:00:00Z,True,3,7,0,0,12,7,5,24,18,6,-12,1
Heaton,66,0,191,2018-12-30T14:15:00Z,True,3,18,90,9,12,7,5,27,13,14,-15,-7
Heaton,66,0,205,2019-01-02T19:45:00Z,False,3,9,90,1,15,10,5,10,5,5,5,0
Heaton,66,0,211,2019-01-12T15:00:00Z,True,3,8,90,2,18,10,8,14,12,2,4,8
Heaton,66,0,228,2019-01-19T15:00:00Z,False,3,17,90,8,21,13,8,32,16,16,-11,-8
Heaton,66,0,234,2019-01-29T20:00:00Z,False,3,13,90,3,22,13,9,44,24,20,-22,-15
Heaton,66,0,241,2019-02-02T15:00:00Z,True,3,15,90,3,23,13,10,23,12,11,0,2
Heaton,66,0,250,2019-02-09T17:30:00Z,False,3,2,90,3,24,14,10,27,19,8,-3,-9
Heaton,66,0,262,2019-02-23T12:30:00Z,True,3,16,90,3,27,14,13,60,27,33,-33,-19
Heaton,66,0,278,2019-02-26T20:00:00Z,False,3,14,90,1,30,17,13,28,16,12,2,-3
Heaton,66,0,282,2019-03-02T15:00:00Z,True,3,6,90,1,30,17,13,30,13,17,0,0
Heaton,66,0,296,2019-03-10T12:00:00Z,False,3,11,90,0,30,17,13,70,38,32,-40,-25
Heaton,66,0,302,2019-03-16T15:00:00Z,True,3,10,90,1,30,17,13,38,20,18,-8,-1
Heaton,66,0,312,2019-03-30T15:00:00Z,True,3,19,90,6,30,17,13,44,24,20,-14,-3
Heaton,66,0,320,2019-04-06T14:00:00Z,False,3,1,90,2,33,20,13,38,26,12,-5,-13
Heaton,66,0,331,2019-04-13T14:00:00Z,True,3,4,90,7,36,20,16,28,20,8,8,12
Heaton,66,0,343,2019-04-22T19:00:00Z,False,3,5,90,2,39,23,16,66,38,28,-27,-22
Heaton,66,0,351,2019-04-28T13:05:00Z,True,3,12,90,3,40,23,17,89,51,38,-49,-15
Heaton,66,0,364,2019-05-03T19:00:00Z,False,3,7,90,2,40,23,17,50,31,19,-10,-14
Heaton,66,0,371,2019-05-12T14:00:00Z,True,3,0,90,1,40,23,17,67,45,22,-27,1
Pope,67,0,7,2018-08-12T12:30:00Z,False,3,15,0,0,0,0,0,0,0,0,0,0
Pope,67,0,11,2018-08-19T12:30:00Z,True,3,17,0,0,1,0,1,3,3,0,-2,0
Pope,67,0,22,2018-08-26T15:00:00Z,False,3,8,0,0,1,0,1,0,0,0,1,1
Pope,67,0,31,2018-09-02T15:00:00Z,True,3,13,0,0,1,0,1,3,3,0,-2,0
Pope,67,0,49,2018-09-16T12:30:00Z,False,3,19,0,0,1,0,1,5,2,3,-4,-1
Pope,67,0,52,2018-09-22T14:00:00Z,True,3,1,0,0,1,0,1,10,7,3,-9,-3
Pope,67,0,62,2018-09-30T15:00:00Z,False,3,4,0,0,4,3,1,2,1,1,2,0
Pope,67,0,71,2018-10-06T14:00:00Z,True,3,9,0,0,7,3,4,2,1,1,5,2
Pope,67,0,86,2018-10-20T14:00:00Z,False,3,12,0,0,8,4,4,20,12,8,-12,-8
Pope,67,0,91,2018-10-28T13:30:00Z,True,3,5,0,0,8,4,4,21,11,10,-13,-6
Pope,67,0,108,2018-11-03T15:00:00Z,False,3,18,0,0,8,4,4,8,4,4,0,0
Pope,67,0,115,2018-11-10T15:00:00Z,False,3,10,0,0,8,4,4,16,7,9,-8,-3
Pope,67,0,122,2018-11-26T20:30:00Z,True,3,14,0,0,9,4,5,9,6,3,0,1
Pope,67,0,133,2018-12-01T15:00:00Z,False,3,6,0,0,9,4,5,9,2,7,0,3
Pope,67,0,142,2018-12-05T19:45:00Z,True,3,11,0,0,9,4,5,36,19,17,-27,-13
Pope,67,0,152,2018-12-08T15:00:00Z,True,3,2,0,0,9,4,5,21,14,7,-12,-3
Pope,67,0,167,2018-12-15T15:00:00Z,False,3,16,0,0,12,7,5,36,12,24,-24,-7
Pope,67,0,170,2018-12-22T12:30:00Z,False,3,0,0,0,12,7,5,34,20,14,-22,-15
Pope,67,0,181,2018-12-26T15:00:00Z,True,3,7,0,0,12,7,5,24,18,6,-12,1
Pope,67,0,191,2018-12-30T14:15:00Z,True,3,18,0,0,12,7,5,27,13,14,-15,-7
Pope,67,0,205,2019-01-02T19:45:00Z,False,3,9,0,0,15,10,5,10,5,5,5,0
Pope,67,0,211,2019-01-12T15:00:00Z,True,3,8,0,0,18,10,8,14,12,2,4,8
Pope,67,0,228,2019-01-19T15:00:00Z,False,3,17,0,0,21,13,8,32,16,16,-11,-8
Pope,67,0,234,2019-01-29T20:00:00Z,False,3,13,0,0,22,13,9,44,24,20,-22,-15
Pope,67,0,241,2019-02-02T15:00:00Z,True,3,15,0,0,23,13,10,23,12,11,0,2
Pope,67,0,250,2019-02-09T17:30:00Z,False,3,2,0,0,24,14,10,27,19,8,-3,-9
Pope,67,0,262,2019-02-23T12:30:00Z,True,3,16,0,0,27,14,13,60,27,33,-33,-19
Pope,67,0,278,2019-02-26T20:00:00Z,False,3,14,0,0,30,17,13,28,16,12,2,-3
Pope,67,0,282,2019-03-02T15:00:00Z,True,3,6,0,0,30,17,13,30,13,17,0,0
Pope,67,0,296,2019-03-10T12:00:00Z,False,3,11,0,0,30,17,13,70,38,32,-40,-25
Pope,67,0,302,2019-03-16T15:00:00Z,True,3,10,0,0,30,17,13,38,20,18,-8,-1
Pope,67,0,312,2019-03-30T15:00:00Z,True,3,19,0,0,30,17,13,44,24,20,-14,-3
Pope,67,0,320,2019-04-06T14:00:00Z,False,3,1,0,0,33,20,13,38,26,12,-5,-13
Pope,67,0,331,2019-04-13T14:00:00Z,True,3,4,0,0,36,20,16,28,20,8,8,12
Pope,67,0,343,2019-04-22T19:00:00Z,False,3,5,0,0,39,23,16,66,38,28,-27,-22
Pope,67,0,351,2019-04-28T13:05:00Z,True,3,12,0,0,40,23,17,89,51,38,-49,-15
Pope,67,0,364,2019-05-03T19:00:00Z,False,3,7,0,0,40,23,17,50,31,19,-10,-14
Pope,67,0,371,2019-05-12T14:00:00Z,True,3,0,0,0,40,23,17,67,45,22,-27,1
Lowton,68,1,7,2018-08-12T12:30:00Z,False,3,15,90,6,0,0,0,0,0,0,0,0
Lowton,68,1,11,2018-08-19T12:30:00Z,True,3,17,90,1,1,0,1,3,3,0,-2,0
Lowton,68,1,22,2018-08-26T15:00:00Z,False,3,8,90,0,1,0,1,0,0,0,1,1
Lowton,68,1,31,2018-09-02T15:00:00Z,True,3,13,0,0,1,0,1,3,3,0,-2,0
Lowton,68,1,49,2018-09-16T12:30:00Z,False,3,19,0,0,1,0,1,5,2,3,-4,-1
Lowton,68,1,52,2018-09-22T14:00:00Z,True,3,1,90,5,1,0,1,10,7,3,-9,-3
Lowton,68,1,62,2018-09-30T15:00:00Z,False,3,4,90,1,4,3,1,2,1,1,2,0
Lowton,68,1,71,2018-10-06T14:00:00Z,True,3,9,90,1,7,3,4,2,1,1,5,2
Lowton,68,1,86,2018-10-20T14:00:00Z,False,3,12,90,0,8,4,4,20,12,8,-12,-8
Lowton,68,1,91,2018-10-28T13:30:00Z,True,3,5,90,0,8,4,4,21,11,10,-13,-6
Lowton,68,1,108,2018-11-03T15:00:00Z,False,3,18,90,-1,8,4,4,8,4,4,0,0
Lowton,68,1,115,2018-11-10T15:00:00Z,False,3,10,90,6,8,4,4,16,7,9,-8,-3
Lowton,68,1,122,2018-11-26T20:30:00Z,True,3,14,90,1,9,4,5,9,6,3,0,1
Lowton,68,1,133,2018-12-01T15:00:00Z,False,3,6,90,1,9,4,5,9,2,7,0,3
Lowton,68,1,142,2018-12-05T19:45:00Z,True,3,11,0,0,9,4,5,36,19,17,-27,-13
Lowton,68,1,152,2018-12-08T15:00:00Z,True,3,2,0,0,9,4,5,21,14,7,-12,-3
Lowton,68,1,167,2018-12-15T15:00:00Z,False,3,16,0,0,12,7,5,36,12,24,-24,-7
Lowton,68,1,170,2018-12-22T12:30:00Z,False,3,0,7,1,12,7,5,34,20,14,-22,-15
Lowton,68,1,181,2018-12-26T15:00:00Z,True,3,7,90,-1,12,7,5,24,18,6,-12,1
Lowton,68,1,191,2018-12-30T14:15:00Z,True,3,18,0,0,12,7,5,27,13,14,-15,-7
Lowton,68,1,205,2019-01-02T19:45:00Z,False,3,9,31,1,15,10,5,10,5,5,5,0
Lowton,68,1,211,2019-01-12T15:00:00Z,True,3,8,0,0,18,10,8,14,12,2,4,8
Lowton,68,1,228,2019-01-19T15:00:00Z,False,3,17,0,0,21,13,8,32,16,16,-11,-8
Lowton,68,1,234,2019-01-29T20:00:00Z,False,3,13,0,0,22,13,9,44,24,20,-22,-15
Lowton,68,1,241,2019-02-02T15:00:00Z,True,3,15,0,0,23,13,10,23,12,11,0,2
Lowton,68,1,250,2019-02-09T17:30:00Z,False,3,2,0,0,24,14,10,27,19,8,-3,-9
Lowton,68,1,262,2019-02-23T12:30:00Z,True,3,16,0,0,27,14,13,60,27,33,-33,-19
Lowton,68,1,278,2019-02-26T20:00:00Z,False,3,14,0,0,30,17,13,28,16,12,2,-3
Lowton,68,1,282,2019-03-02T15:00:00Z,True,3,6,0,0,30,17,13,30,13,17,0,0
Lowton,68,1,296,2019-03-10T12:00:00Z,False,3,11,0,0,30,17,13,70,38,32,-40,-25
Lowton,68,1,302,2019-03-16T15:00:00Z,True,3,10,0,0,30,17,13,38,20,18,-8,-1
Lowton,68,1,312,2019-03-30T15:00:00Z,True,3,19,0,0,30,17,13,44,24,20,-14,-3
Lowton,68,1,320,2019-04-06T14:00:00Z,False,3,1,90,2,33,20,13,38,26,12,-5,-13
Lowton,68,1,331,2019-04-13T14:00:00Z,True,3,4,90,7,36,20,16,28,20,8,8,12
Lowton,68,1,343,2019-04-22T19:00:00Z,False,3,5,90,1,39,23,16,66,38,28,-27,-22
Lowton,68,1,351,2019-04-28T13:05:00Z,True,3,12,90,1,40,23,17,89,51,38,-49,-15
Lowton,68,1,364,2019-05-03T19:00:00Z,False,3,7,90,1,40,23,17,50,31,19,-10,-14
Lowton,68,1,371,2019-05-12T14:00:00Z,True,3,0,90,0,40,23,17,67,45,22,-27,1
Mee,69,1,7,2018-08-12T12:30:00Z,False,3,15,90,8,0,0,0,0,0,0,0,0
Mee,69,1,11,2018-08-19T12:30:00Z,True,3,17,90,1,1,0,1,3,3,0,-2,0
Mee,69,1,22,2018-08-26T15:00:00Z,False,3,8,90,3,1,0,1,0,0,0,1,1
Mee,69,1,31,2018-09-02T15:00:00Z,True,3,13,90,1,1,0,1,3,3,0,-2,0
Mee,69,1,49,2018-09-16T12:30:00Z,False,3,19,90,2,1,0,1,5,2,3,-4,-1
Mee,69,1,52,2018-09-22T14:00:00Z,True,3,1,90,6,1,0,1,10,7,3,-9,-3
Mee,69,1,62,2018-09-30T15:00:00Z,False,3,4,90,2,4,3,1,2,1,1,2,0
Mee,69,1,71,2018-10-06T14:00:00Z,True,3,9,90,1,7,3,4,2,1,1,5,2
Mee,69,1,86,2018-10-20T14:00:00Z,False,3,12,90,0,8,4,4,20,12,8,-12,-8
Mee,69,1,91,2018-10-28T13:30:00Z,True,3,5,90,0,8,4,4,21,11,10,-13,-6
Mee,69,1,108,2018-11-03T15:00:00Z,False,3,18,90,0,8,4,4,8,4,4,0,0
Mee,69,1,115,2018-11-10T15:00:00Z,False,3,10,90,6,8,4,4,16,7,9,-8,-3
Mee,69,1,122,2018-11-26T20:30:00Z,True,3,14,90,2,9,4,5,9,6,3,0,1
Mee,69,1,133,2018-12-01T15:00:00Z,False,3,6,90,0,9,4,5,9,2,7,0,3
Mee,69,1,142,2018-12-05T19:45:00Z,True,3,11,90,1,9,4,5,36,19,17,-27,-13
Mee,69,1,152,2018-12-08T15:00:00Z,True,3,2,90,8,9,4,5,21,14,7,-12,-3
Mee,69,1,167,2018-12-15T15:00:00Z,False,3,16,90,2,12,7,5,36,12,24,-24,-7
Mee,69,1,170,2018-12-22T12:30:00Z,False,3,0,90,0,12,7,5,34,20,14,-22,-15
Mee,69,1,181,2018-12-26T15:00:00Z,True,3,7,90,0,12,7,5,24,18,6,-12,1
Mee,69,1,191,2018-12-30T14:15:00Z,True,3,18,90,6,12,7,5,27,13,14,-15,-7
Mee,69,1,205,2019-01-02T19:45:00Z,False,3,9,90,1,15,10,5,10,5,5,5,0
Mee,69,1,211,2019-01-12T15:00:00Z,True,3,8,90,2,18,10,8,14,12,2,4,8
Mee,69,1,228,2019-01-19T15:00:00Z,False,3,17,90,5,21,13,8,32,16,16,-11,-8
Mee,69,1,234,2019-01-29T20:00:00Z,False,3,13,90,1,22,13,9,44,24,20,-22,-15
Mee,69,1,241,2019-02-02T15:00:00Z,True,3,15,90,1,23,13,10,23,12,11,0,2
Mee,69,1,250,2019-02-09T17:30:00Z,False,3,2,90,2,24,14,10,27,19,8,-3,-9
Mee,69,1,262,2019-02-23T12:30:00Z,True,3,16,90,2,27,14,13,60,27,33,-33,-19
Mee,69,1,278,2019-02-26T20:00:00Z,False,3,14,90,0,30,17,13,28,16,12,2,-3
Mee,69,1,282,2019-03-02T15:00:00Z,True,3,6,90,0,30,17,13,30,13,17,0,0
Mee,69,1,296,2019-03-10T12:00:00Z,False,3,11,90,0,30,17,13,70,38,32,-40,-25
Mee,69,1,302,2019-03-16T15:00:00Z,True,3,10,90,1,30,17,13,38,20,18,-8,-1
Mee,69,1,312,2019-03-30T15:00:00Z,True,3,19,90,7,30,17,13,44,24,20,-14,-3
Mee,69,1,320,2019-04-06T14:00:00Z,False,3,1,90,1,33,20,13,38,26,12,-5,-13
Mee,69,1,331,2019-04-13T14:00:00Z,True,3,4,90,6,36,20,16,28,20,8,8,12
Mee,69,1,343,2019-04-22T19:00:00Z,False,3,5,90,1,39,23,16,66,38,28,-27,-22
Mee,69,1,351,2019-04-28T13:05:00Z,True,3,12,90,2,40,23,17,89,51,38,-49,-15
Mee,69,1,364,2019-05-03T19:00:00Z,False,3,7,90,-1,40,23,17,50,31,19,-10,-14
Mee,69,1,371,2019-05-12T14:00:00Z,True,3,0,90,1,40,23,17,67,45,22,-27,1
Ward,70,1,7,2018-08-12T12:30:00Z,False,3,15,90,6,0,0,0,0,0,0,0,0
Ward,70,1,11,2018-08-19T12:30:00Z,True,3,17,73,0,1,0,1,3,3,0,-2,0
Ward,70,1,22,2018-08-26T15:00:00Z,False,3,8,65,1,1,0,1,0,0,0,1,1
Ward,70,1,31,2018-09-02T15:00:00Z,True,3,13,0,0,1,0,1,3,3,0,-2,0
Ward,70,1,49,2018-09-16T12:30:00Z,False,3,19,0,0,1,0,1,5,2,3,-4,-1
Ward,70,1,52,2018-09-22T14:00:00Z,True,3,1,0,0,1,0,1,10,7,3,-9,-3
Ward,70,1,62,2018-09-30T15:00:00Z,False,3,4,0,0,4,3,1,2,1,1,2,0
Ward,70,1,71,2018-10-06T14:00:00Z,True,3,9,0,0,7,3,4,2,1,1,5,2
Ward,70,1,86,2018-10-20T14:00:00Z,False,3,12,0,0,8,4,4,20,12,8,-12,-8
Ward,70,1,91,2018-10-28T13:30:00Z,True,3,5,0,0,8,4,4,21,11,10,-13,-6
Ward,70,1,108,2018-11-03T15:00:00Z,False,3,18,0,0,8,4,4,8,4,4,0,0
Ward,70,1,115,2018-11-10T15:00:00Z,False,3,10,0,0,8,4,4,16,7,9,-8,-3
Ward,70,1,122,2018-11-26T20:30:00Z,True,3,14,0,0,9,4,5,9,6,3,0,1
Ward,70,1,133,2018-12-01T15:00:00Z,False,3,6,0,0,9,4,5,9,2,7,0,3
Ward,70,1,142,2018-12-05T19:45:00Z,True,3,11,0,0,9,4,5,36,19,17,-27,-13
Ward,70,1,152,2018-12-08T15:00:00Z,True,3,2,0,0,9,4,5,21,14,7,-12,-3
Ward,70,1,167,2018-12-15T15:00:00Z,False,3,16,0,0,12,7,5,36,12,24,-24,-7
Ward,70,1,170,2018-12-22T12:30:00Z,False,3,0,0,0,12,7,5,34,20,14,-22,-15
Ward,70,1,181,2018-12-26T15:00:00Z,True,3,7,0,0,12,7,5,24,18,6,-12,1
Ward,70,1,191,2018-12-30T14:15:00Z,True,3,18,0,0,12,7,5,27,13,14,-15,-7
Ward,70,1,205,2019-01-02T19:45:00Z,False,3,9,0,0,15,10,5,10,5,5,5,0
Ward,70,1,211,2019-01-12T15:00:00Z,True,3,8,0,0,18,10,8,14,12,2,4,8
Ward,70,1,228,2019-01-19T15:00:00Z,False,3,17,0,0,21,13,8,32,16,16,-11,-8
Ward,70,1,234,2019-01-29T20:00:00Z,False,3,13,0,0,22,13,9,44,24,20,-22,-15
Ward,70,1,241,2019-02-02T15:00:00Z,True,3,15,0,0,23,13,10,23,12,11,0,2
Ward,70,1,250,2019-02-09T17:30:00Z,False,3,2,0,0,24,14,10,27,19,8,-3,-9
Ward,70,1,262,2019-02-23T12:30:00Z,True,3,16,0,0,27,14,13,60,27,33,-33,-19
Ward,70,1,278,2019-02-26T20:00:00Z,False,3,14,0,0,30,17,13,28,16,12,2,-3
Ward,70,1,282,2019-03-02T15:00:00Z,True,3,6,0,0,30,17,13,30,13,17,0,0
Ward,70,1,296,2019-03-10T12:00:00Z,False,3,11,0,0,30,17,13,70,38,32,-40,-25
Ward,70,1,302,2019-03-16T15:00:00Z,True,3,10,0,0,30,17,13,38,20,18,-8,-1
Ward,70,1,312,2019-03-30T15:00:00Z,True,3,19,0,0,30,17,13,44,24,20,-14,-3
Ward,70,1,320,2019-04-06T14:00:00Z,False,3,1,0,0,33,20,13,38,26,12,-5,-13
Ward,70,1,331,2019-04-13T14:00:00Z,True,3,4,0,0,36,20,16,28,20,8,8,12
Ward,70,1,343,2019-04-22T19:00:00Z,False,3,5,0,0,39,23,16,66,38,28,-27,-22
Ward,70,1,351,2019-04-28T13:05:00Z,True,3,12,0,0,40,23,17,89,51,38,-49,-15
Ward,70,1,364,2019-05-03T19:00:00Z,False,3,7,0,0,40,23,17,50,31,19,-10,-14
Ward,70,1,371,2019-05-12T14:00:00Z,True,3,0,0,0,40,23,17,67,45,22,-27,1
Tarkowski,71,1,7,2018-08-12T12:30:00Z,False,3,15,90,7,0,0,0,0,0,0,0,0
Tarkowski,71,1,11,2018-08-19T12:30:00Z,True,3,17,90,7,1,0,1,3,3,0,-2,0
Tarkowski,71,1,22,2018-08-26T15:00:00Z,False,3,8,90,5,1,0,1,0,0,0,1,1
Tarkowski,71,1,31,2018-09-02T15:00:00Z,True,3,13,90,1,1,0,1,3,3,0,-2,0
Tarkowski,71,1,49,2018-09-16T12:30:00Z,False,3,19,90,2,1,0,1,5,2,3,-4,-1
Tarkowski,71,1,52,2018-09-22T14:00:00Z,True,3,1,90,6,1,0,1,10,7,3,-9,-3
Tarkowski,71,1,62,2018-09-30T15:00:00Z,False,3,4,26,1,4,3,1,2,1,1,2,0
Tarkowski,71,1,71,2018-10-06T14:00:00Z,True,3,9,90,2,7,3,4,2,1,1,5,2
Tarkowski,71,1,86,2018-10-20T14:00:00Z,False,3,12,90,0,8,4,4,20,12,8,-12,-8
Tarkowski,71,1,91,2018-10-28T13:30:00Z,True,3,5,90,-1,8,4,4,21,11,10,-13,-6
Tarkowski,71,1,108,2018-11-03T15:00:00Z,False,3,18,90,-1,8,4,4,8,4,4,0,0
Tarkowski,71,1,115,2018-11-10T15:00:00Z,False,3,10,0,0,8,4,4,16,7,9,-8,-3
Tarkowski,71,1,122,2018-11-26T20:30:00Z,True,3,14,0,0,9,4,5,9,6,3,0,1
Tarkowski,71,1,133,2018-12-01T15:00:00Z,False,3,6,0,0,9,4,5,9,2,7,0,3
Tarkowski,71,1,142,2018-12-05T19:45:00Z,True,3,11,90,1,9,4,5,36,19,17,-27,-13
Tarkowski,71,1,152,2018-12-08T15:00:00Z,True,3,2,90,14,9,4,5,21,14,7,-12,-3
Tarkowski,71,1,167,2018-12-15T15:00:00Z,False,3,16,90,2,12,7,5,36,12,24,-24,-7
Tarkowski,71,1,170,2018-12-22T12:30:00Z,False,3,0,90,1,12,7,5,34,20,14,-22,-15
Tarkowski,71,1,181,2018-12-26T15:00:00Z,True,3,7,90,3,12,7,5,24,18,6,-12,1
Tarkowski,71,1,191,2018-12-30T14:15:00Z,True,3,18,90,6,12,7,5,27,13,14,-15,-7
Tarkowski,71,1,205,2019-01-02T19:45:00Z,False,3,9,90,2,15,10,5,10,5,5,5,0
Tarkowski,71,1,211,2019-01-12T15:00:00Z,True,3,8,90,1,18,10,8,14,12,2,4,8
Tarkowski,71,1,228,2019-01-19T15:00:00Z,False,3,17,90,6,21,13,8,32,16,16,-11,-8
Tarkowski,71,1,234,2019-01-29T20:00:00Z,False,3,13,90,1,22,13,9,44,24,20,-22,-15
Tarkowski,71,1,241,2019-02-02T15:00:00Z,True,3,15,90,2,23,13,10,23,12,11,0,2
Tarkowski,71,1,250,2019-02-09T17:30:00Z,False,3,2,90,2,24,14,10,27,19,8,-3,-9
Tarkowski,71,1,262,2019-02-23T12:30:00Z,True,3,16,90,2,27,14,13,60,27,33,-33,-19
Tarkowski,71,1,278,2019-02-26T20:00:00Z,False,3,14,90,1,30,17,13,28,16,12,2,-3
Tarkowski,71,1,282,2019-03-02T15:00:00Z,True,3,6,90,1,30,17,13,30,13,17,0,0
Tarkowski,71,1,296,2019-03-10T12:00:00Z,False,3,11,90,0,30,17,13,70,38,32,-40,-25
Tarkowski,71,1,302,2019-03-16T15:00:00Z,True,3,10,90,1,30,17,13,38,20,18,-8,-1
Tarkowski,71,1,312,2019-03-30T15:00:00Z,True,3,19,90,12,30,17,13,44,24,20,-14,-3
Tarkowski,71,1,320,2019-04-06T14:00:00Z,False,3,1,90,2,33,20,13,38,26,12,-5,-13
Tarkowski,71,1,331,2019-04-13T14:00:00Z,True,3,4,90,5,36,20,16,28,20,8,8,12
Tarkowski,71,1,343,2019-04-22T19:00:00Z,False,3,5,90,1,39,23,16,66,38,28,-27,-22
Tarkowski,71,1,351,2019-04-28T13:05:00Z,True,3,12,90,2,40,23,17,89,51,38,-49,-15
Tarkowski,71,1,364,2019-05-03T19:00:00Z,False,3,7,90,0,40,23,17,50,31,19,-10,-14
Tarkowski,71,1,371,2019-05-12T14:00:00Z,True,3,0,90,0,40,23,17,67,45,22,-27,1
Long,72,1,7,2018-08-12T12:30:00Z,False,3,15,0,0,0,0,0,0,0,0,0,0
Long,72,1,11,2018-08-19T12:30:00Z,True,3,17,0,0,1,0,1,3,3,0,-2,0
Long,72,1,22,2018-08-26T15:00:00Z,False,3,8,0,0,1,0,1,0,0,0,1,1
Long,72,1,31,2018-09-02T15:00:00Z,True,3,13,0,0,1,0,1,3,3,0,-2,0
Long,72,1,49,2018-09-16T12:30:00Z,False,3,19,0,0,1,0,1,5,2,3,-4,-1
Long,72,1,52,2018-09-22T14:00:00Z,True,3,1,0,0,1,0,1,10,7,3,-9,-3
Long,72,1,62,2018-09-30T15:00:00Z,False,3,4,63,2,4,3,1,2,1,1,2,0
Long,72,1,71,2018-10-06T14:00:00Z,True,3,9,0,0,7,3,4,2,1,1,5,2
Long,72,1,86,2018-10-20T14:00:00Z,False,3,12,0,0,8,4,4,20,12,8,-12,-8
Long,72,1,91,2018-10-28T13:30:00Z,True,3,5,0,0,8,4,4,21,11,10,-13,-6
Long,72,1,108,2018-11-03T15:00:00Z,False,3,18,0,0,8,4,4,8,4,4,0,0
Long,72,1,115,2018-11-10T15:00:00Z,False,3,10,90,6,8,4,4,16,7,9,-8,-3
Long,72,1,122,2018-11-26T20:30:00Z,True,3,14,90,1,9,4,5,9,6,3,0,1
Long,72,1,133,2018-12-01T15:00:00Z,False,3,6,90,1,9,4,5,9,2,7,0,3
Long,72,1,142,2018-12-05T19:45:00Z,True,3,11,0,0,9,4,5,36,19,17,-27,-13
Long,72,1,152,2018-12-08T15:00:00Z,True,3,2,0,0,9,4,5,21,14,7,-12,-3
Long,72,1,167,2018-12-15T15:00:00Z,False,3,16,90,2,12,7,5,36,12,24,-24,-7
Long,72,1,170,2018-12-22T12:30:00Z,False,3,0,90,4,12,7,5,34,20,14,-22,-15
Long,72,1,181,2018-12-26T15:00:00Z,True,3,7,0,0,12,7,5,24,18,6,-12,1
Long,72,1,191,2018-12-30T14:15:00Z,True,3,18,0,0,12,7,5,27,13,14,-15,-7
Long,72,1,205,2019-01-02T19:45:00Z,False,3,9,0,0,15,10,5,10,5,5,5,0
Long,72,1,211,2019-01-12T15:00:00Z,True,3,8,0,0,18,10,8,14,12,2,4,8
Long,72,1,228,2019-01-19T15:00:00Z,False,3,17,0,0,21,13,8,32,16,16,-11,-8
Long,72,1,234,2019-01-29T20:00:00Z,False,3,13,0,0,22,13,9,44,24,20,-22,-15
Long,72,1,241,2019-02-02T15:00:00Z,True,3,15,0,0,23,13,10,23,12,11,0,2
Long,72,1,250,2019-02-09T17:30:00Z,False,3,2,0,0,24,14,10,27,19,8,-3,-9
Long,72,1,262,2019-02-23T12:30:00Z,True,3,16,0,0,27,14,13,60,27,33,-33,-19
Long,72,1,278,2019-02-26T20:00:00Z,False,3,14,0,0,30,17,13,28,16,12,2,-3
Long,72,1,282,2019-03-02T15:00:00Z,True,3,6,0,0,30,17,13,30,13,17,0,0
Long,72,1,296,2019-03-10T12:00:00Z,False,3,11,0,0,30,17,13,70,38,32,-40,-25
Long,72,1,302,2019-03-16T15:00:00Z,True,3,10,0,0,30,17,13,38,20,18,-8,-1
Long,72,1,312,2019-03-30T15:00:00Z,True,3,19,0,0,30,17,13,44,24,20,-14,-3
Long,72,1,320,2019-04-06T14:00:00Z,False,3,1,0,0,33,20,13,38,26,12,-5,-13
Long,72,1,331,2019-04-13T14:00:00Z,True,3,4,0,0,36,20,16,28,20,8,8,12
Long,72,1,343,2019-04-22T19:00:00Z,False,3,5,0,0,39,23,16,66,38,28,-27,-22
Long,72,1,351,2019-04-28T13:05:00Z,True,3,12,0,0,40,23,17,89,51,38,-49,-15
Long,72,1,364,2019-05-03T19:00:00Z,False,3,7,0,0,40,23,17,50,31,19,-10,-14
Long,72,1,371,2019-05-12T14:00:00Z,True,3,0,0,0,40,23,17,67,45,22,-27,1
Taylor,73,1,7,2018-08-12T12:30:00Z,False,3,15,3,1,0,0,0,0,0,0,0,0
Taylor,73,1,11,2018-08-19T12:30:00Z,True,3,17,16,1,1,0,1,3,3,0,-2,0
Taylor,73,1,22,2018-08-26T15:00:00Z,False,3,8,71,1,1,0,1,0,0,0,1,1
Taylor,73,1,31,2018-09-02T15:00:00Z,True,3,13,90,1,1,0,1,3,3,0,-2,0
Taylor,73,1,49,2018-09-16T12:30:00Z,False,3,19,90,1,1,0,1,5,2,3,-4,-1
Taylor,73,1,52,2018-09-22T14:00:00Z,True,3,1,90,6,1,0,1,10,7,3,-9,-3
Taylor,73,1,62,2018-09-30T15:00:00Z,False,3,4,90,2,4,3,1,2,1,1,2,0
Taylor,73,1,71,2018-10-06T14:00:00Z,True,3,9,90,2,7,3,4,2,1,1,5,2
Taylor,73,1,86,2018-10-20T14:00:00Z,False,3,12,90,0,8,4,4,20,12,8,-12,-8
Taylor,73,1,91,2018-10-28T13:30:00Z,True,3,5,90,0,8,4,4,21,11,10,-13,-6
Taylor,73,1,108,2018-11-03T15:00:00Z,False,3,18,90,0,8,4,4,8,4,4,0,0
Taylor,73,1,115,2018-11-10T15:00:00Z,False,3,10,90,7,8,4,4,16,7,9,-8,-3
Taylor,73,1,122,2018-11-26T20:30:00Z,True,3,14,90,1,9,4,5,9,6,3,0,1
Taylor,73,1,133,2018-12-01T15:00:00Z,False,3,6,90,1,9,4,5,9,2,7,0,3
Taylor,73,1,142,2018-12-05T19:45:00Z,True,3,11,90,1,9,4,5,36,19,17,-27,-13
Taylor,73,1,152,2018-12-08T15:00:00Z,True,3,2,90,6,9,4,5,21,14,7,-12,-3
Taylor,73,1,167,2018-12-15T15:00:00Z,False,3,16,90,2,12,7,5,36,12,24,-24,-7
Taylor,73,1,170,2018-12-22T12:30:00Z,False,3,0,90,1,12,7,5,34,20,14,-22,-15
Taylor,73,1,181,2018-12-26T15:00:00Z,True,3,7,90,0,12,7,5,24,18,6,-12,1
Taylor,73,1,191,2018-12-30T14:15:00Z,True,3,18,90,6,12,7,5,27,13,14,-15,-7
Taylor,73,1,205,2019-01-02T19:45:00Z,False,3,9,90,2,15,10,5,10,5,5,5,0
Taylor,73,1,211,2019-01-12T15:00:00Z,True,3,8,90,2,18,10,8,14,12,2,4,8
Taylor,73,1,228,2019-01-19T15:00:00Z,False,3,17,90,6,21,13,8,32,16,16,-11,-8
Taylor,73,1,234,2019-01-29T20:00:00Z,False,3,13,90,0,22,13,9,44,24,20,-22,-15
Taylor,73,1,241,2019-02-02T15:00:00Z,True,3,15,90,2,23,13,10,23,12,11,0,2
Taylor,73,1,250,2019-02-09T17:30:00Z,False,3,2,90,2,24,14,10,27,19,8,-3,-9
Taylor,73,1,262,2019-02-23T12:30:00Z,True,3,16,90,2,27,14,13,60,27,33,-33,-19
Taylor,73,1,278,2019-02-26T20:00:00Z,False,3,14,90,1,30,17,13,28,16,12,2,-3
Taylor,73,1,282,2019-03-02T15:00:00Z,True,3,6,90,1,30,17,13,30,13,17,0,0
Taylor,73,1,296,2019-03-10T12:00:00Z,False,3,11,90,0,30,17,13,70,38,32,-40,-25
Taylor,73,1,302,2019-03-16T15:00:00Z,True,3,10,90,4,30,17,13,38,20,18,-8,-1
Taylor,73,1,312,2019-03-30T15:00:00Z,True,3,19,90,7,30,17,13,44,24,20,-14,-3
Taylor,73,1,320,2019-04-06T14:00:00Z,False,3,1,90,2,33,20,13,38,26,12,-5,-13
Taylor,73,1,331,2019-04-13T14:00:00Z,True,3,4,90,6,36,20,16,28,20,8,8,12
Taylor,73,1,343,2019-04-22T19:00:00Z,False,3,5,90,1,39,23,16,66,38,28,-27,-22
Taylor,73,1,351,2019-04-28T13:05:00Z,True,3,12,90,2,40,23,17,89,51,38,-49,-15
Taylor,73,1,364,2019-05-03T19:00:00Z,False,3,7,90,1,40,23,17,50,31,19,-10,-14
Taylor,73,1,371,2019-05-12T14:00:00Z,True,3,0,90,1,40,23,17,67,45,22,-27,1
Bardsley,74,1,7,2018-08-12T12:30:00Z,False,3,15,0,0,0,0,0,0,0,0,0,0
Bardsley,74,1,11,2018-08-19T12:30:00Z,True,3,17,0,0,1,0,1,3,3,0,-2,0
Bardsley,74,1,22,2018-08-26T15:00:00Z,False,3,8,0,0,1,0,1,0,0,0,1,1
Bardsley,74,1,31,2018-09-02T15:00:00Z,True,3,13,90,0,1,0,1,3,3,0,-2,0
Bardsley,74,1,49,2018-09-16T12:30:00Z,False,3,19,90,1,1,0,1,5,2,3,-4,-1
Bardsley,74,1,52,2018-09-22T14:00:00Z,True,3,1,0,0,1,0,1,10,7,3,-9,-3
Bardsley,74,1,62,2018-09-30T15:00:00Z,False,3,4,0,0,4,3,1,2,1,1,2,0
Bardsley,74,1,71,2018-10-06T14:00:00Z,True,3,9,0,0,7,3,4,2,1,1,5,2
Bardsley,74,1,86,2018-10-20T14:00:00Z,False,3,12,0,0,8,4,4,20,12,8,-12,-8
Bardsley,74,1,91,2018-10-28T13:30:00Z,True,3,5,0,0,8,4,4,21,11,10,-13,-6
Bardsley,74,1,108,2018-11-03T15:00:00Z,False,3,18,0,0,8,4,4,8,4,4,0,0
Bardsley,74,1,115,2018-11-10T15:00:00Z,False,3,10,0,0,8,4,4,16,7,9,-8,-3
Bardsley,74,1,122,2018-11-26T20:30:00Z,True,3,14,0,0,9,4,5,9,6,3,0,1
Bardsley,74,1,133,2018-12-01T15:00:00Z,False,3,6,0,0,9,4,5,9,2,7,0,3
Bardsley,74,1,142,2018-12-05T19:45:00Z,True,3,11,90,1,9,4,5,36,19,17,-27,-13
Bardsley,74,1,152,2018-12-08T15:00:00Z,True,3,2,90,5,9,4,5,21,14,7,-12,-3
Bardsley,74,1,167,2018-12-15T15:00:00Z,False,3,16,90,1,12,7,5,36,12,24,-24,-7
Bardsley,74,1,170,2018-12-22T12:30:00Z,False,3,0,82,1,12,7,5,34,20,14,-22,-15
Bardsley,74,1,181,2018-12-26T15:00:00Z,True,3,7,0,0,12,7,5,24,18,6,-12,1
Bardsley,74,1,191,2018-12-30T14:15:00Z,True,3,18,90,6,12,7,5,27,13,14,-15,-7
Bardsley,74,1,205,2019-01-02T19:45:00Z,False,3,9,58,0,15,10,5,10,5,5,5,0
Bardsley,74,1,211,2019-01-12T15:00:00Z,True,3,8,90,2,18,10,8,14,12,2,4,8
Bardsley,74,1,228,2019-01-19T15:00:00Z,False,3,17,90,5,21,13,8,32,16,16,-11,-8
Bardsley,74,1,234,2019-01-29T20:00:00Z,False,3,13,90,1,22,13,9,44,24,20,-22,-15
Bardsley,74,1,241,2019-02-02T15:00:00Z,True,3,15,90,1,23,13,10,23,12,11,0,2
Bardsley,74,1,250,2019-02-09T17:30:00Z,False,3,2,90,2,24,14,10,27,19,8,-3,-9
Bardsley,74,1,262,2019-02-23T12:30:00Z,True,3,16,90,1,27,14,13,60,27,33,-33,-19
Bardsley,74,1,278,2019-02-26T20:00:00Z,False,3,14,90,1,30,17,13,28,16,12,2,-3
Bardsley,74,1,282,2019-03-02T15:00:00Z,True,3,6,90,-1,30,17,13,30,13,17,0,0
Bardsley,74,1,296,2019-03-10T12:00:00Z,False,3,11,90,0,30,17,13,70,38,32,-40,-25
Bardsley,74,1,302,2019-03-16T15:00:00Z,True,3,10,90,0,30,17,13,38,20,18,-8,-1
Bardsley,74,1,312,2019-03-30T15:00:00Z,True,3,19,90,6,30,17,13,44,24,20,-14,-3
Bardsley,74,1,320,2019-04-06T14:00:00Z,False,3,1,0,0,33,20,13,38,26,12,-5,-13
Bardsley,74,1,331,2019-04-13T14:00:00Z,True,3,4,0,0,36,20,16,28,20,8,8,12
Bardsley,74,1,343,2019-04-22T19:00:00Z,False,3,5,0,0,39,23,16,66,38,28,-27,-22
Bardsley,74,1,351,2019-04-28T13:05:00Z,True,3,12,0,0,40,23,17,89,51,38,-49,-15
Bardsley,74,1,364,2019-05-03T19:00:00Z,False,3,7,0,0,40,23,17,50,31,19,-10,-14
Bardsley,74,1,371,2019-05-12T14:00:00Z,True,3,0,0,0,40,23,17,67,45,22,-27,1
Gudmundsson,75,2,7,2018-08-12T12:30:00Z,False,3,15,86,3,0,0,0,0,0,0,0,0
Gudmundsson,75,2,11,2018-08-19T12:30:00Z,True,3,17,90,5,1,0,1,3,3,0,-2,0
Gudmundsson,75,2,22,2018-08-26T15:00:00Z,False,3,8,18,1,1,0,1,0,0,0,1,1
Gudmundsson,75,2,31,2018-09-02T15:00:00Z,True,3,13,0,0,1,0,1,3,3,0,-2,0
Gudmundsson,75,2,49,2018-09-16T12:30:00Z,False,3,19,90,1,1,0,1,5,2,3,-4,-1
Gudmundsson,75,2,52,2018-09-22T14:00:00Z,True,3,1,90,9,1,0,1,10,7,3,-9,-3
Gudmundsson,75,2,62,2018-09-30T15:00:00Z,False,3,4,90,13,4,3,1,2,1,1,2,0
Gudmundsson,75,2,71,2018-10-06T14:00:00Z,True,3,9,90,7,7,3,4,2,1,1,5,2
Gudmundsson,75,2,86,2018-10-20T14:00:00Z,False,3,12,90,2,8,4,4,20,12,8,-12,-8
Gudmundsson,75,2,91,2018-10-28T13:30:00Z,True,3,5,90,1,8,4,4,21,11,10,-13,-6
Gudmundsson,75,2,108,2018-11-03T15:00:00Z,False,3,18,90,7,8,4,4,8,4,4,0,0
Gudmundsson,75,2,115,2018-11-10T15:00:00Z,False,3,10,64,3,8,4,4,16,7,9,-8,-3
Gudmundsson,75,2,122,2018-11-26T20:30:00Z,True,3,14,0,0,9,4,5,9,6,3,0,1
Gudmundsson,75,2,133,2018-12-01T15:00:00Z,False,3,6,90,2,9,4,5,9,2,7,0,3
Gudmundsson,75,2,142,2018-12-05T19:45:00Z,True,3,11,90,2,9,4,5,36,19,17,-27,-13
Gudmundsson,75,2,152,2018-12-08T15:00:00Z,True,3,2,71,3,9,4,5,21,14,7,-12,-3
Gudmundsson,75,2,167,2018-12-15T15:00:00Z,False,3,16,0,0,12,7,5,36,12,24,-24,-7
Gudmundsson,75,2,170,2018-12-22T12:30:00Z,False,3,0,0,0,12,7,5,34,20,14,-22,-15
Gudmundsson,75,2,181,2018-12-26T15:00:00Z,True,3,7,27,1,12,7,5,24,18,6,-12,1
Gudmundsson,75,2,191,2018-12-30T14:15:00Z,True,3,18,90,3,12,7,5,27,13,14,-15,-7
Gudmundsson,75,2,205,2019-01-02T19:45:00Z,False,3,9,90,2,15,10,5,10,5,5,5,0
Gudmundsson,75,2,211,2019-01-12T15:00:00Z,True,3,8,0,0,18,10,8,14,12,2,4,8
Gudmundsson,75,2,228,2019-01-19T15:00:00Z,False,3,17,0,0,21,13,8,32,16,16,-11,-8
Gudmundsson,75,2,234,2019-01-29T20:00:00Z,False,3,13,12,1,22,13,9,44,24,20,-22,-15
Gudmundsson,75,2,241,2019-02-02T15:00:00Z,True,3,15,32,1,23,13,10,23,12,11,0,2
Gudmundsson,75,2,250,2019-02-09T17:30:00Z,False,3,2,0,0,24,14,10,27,19,8,-3,-9
Gudmundsson,75,2,262,2019-02-23T12:30:00Z,True,3,16,10,4,27,14,13,60,27,33,-33,-19
Gudmundsson,75,2,278,2019-02-26T20:00:00Z,False,3,14,90,2,30,17,13,28,16,12,2,-3
Gudmundsson,75,2,282,2019-03-02T15:00:00Z,True,3,6,45,1,30,17,13,30,13,17,0,0
Gudmundsson,75,2,296,2019-03-10T12:00:00Z,False,3,11,11,7,30,17,13,70,38,32,-40,-25
Gudmundsson,75,2,302,2019-03-16T15:00:00Z,True,3,10,78,2,30,17,13,38,20,18,-8,-1
Gudmundsson,75,2,312,2019-03-30T15:00:00Z,True,3,19,3,1,30,17,13,44,24,20,-14,-3
Gudmundsson,75,2,320,2019-04-06T14:00:00Z,False,3,1,8,1,33,20,13,38,26,12,-5,-13
Gudmundsson,75,2,331,2019-04-13T14:00:00Z,True,3,4,0,0,36,20,16,28,20,8,8,12
Gudmundsson,75,2,343,2019-04-22T19:00:00Z,False,3,5,0,0,39,23,16,66,38,28,-27,-22
Gudmundsson,75,2,351,2019-04-28T13:05:00Z,True,3,12,14,1,40,23,17,89,51,38,-49,-15
Gudmundsson,75,2,364,2019-05-03T19:00:00Z,False,3,7,68,2,40,23,17,50,31,19,-10,-14
Gudmundsson,75,2,371,2019-05-12T14:00:00Z,True,3,0,26,4,40,23,17,67,45,22,-27,1
Defour,76,2,7,2018-08-12T12:30:00Z,False,3,15,0,0,0,0,0,0,0,0,0,0
Defour,76,2,11,2018-08-19T12:30:00Z,True,3,17,0,0,1,0,1,3,3,0,-2,0
Defour,76,2,22,2018-08-26T15:00:00Z,False,3,8,0,0,1,0,1,0,0,0,1,1
Defour,76,2,31,2018-09-02T15:00:00Z,True,3,13,0,0,1,0,1,3,3,0,-2,0
Defour,76,2,49,2018-09-16T12:30:00Z,False,3,19,0,0,1,0,1,5,2,3,-4,-1
Defour,76,2,52,2018-09-22T14:00:00Z,True,3,1,0,0,1,0,1,10,7,3,-9,-3
Defour,76,2,62,2018-09-30T15:00:00Z,False,3,4,0,0,4,3,1,2,1,1,2,0
Defour,76,2,71,2018-10-06T14:00:00Z,True,3,9,0,0,7,3,4,2,1,1,5,2
Defour,76,2,86,2018-10-20T14:00:00Z,False,3,12,74,2,8,4,4,20,12,8,-12,-8
Defour,76,2,91,2018-10-28T13:30:00Z,True,3,5,90,2,8,4,4,21,11,10,-13,-6
Defour,76,2,108,2018-11-03T15:00:00Z,False,3,18,90,2,8,4,4,8,4,4,0,0
Defour,76,2,115,2018-11-10T15:00:00Z,False,3,10,54,1,8,4,4,16,7,9,-8,-3
Defour,76,2,122,2018-11-26T20:30:00Z,True,3,14,82,2,9,4,5,9,6,3,0,1
Defour,76,2,133,2018-12-01T15:00:00Z,False,3,6,59,1,9,4,5,9,2,7,0,3
Defour,76,2,142,2018-12-05T19:45:00Z,True,3,11,0,0,9,4,5,36,19,17,-27,-13
Defour,76,2,152,2018-12-08T15:00:00Z,True,3,2,0,0,9,4,5,21,14,7,-12,-3
Defour,76,2,167,2018-12-15T15:00:00Z,False,3,16,0,0,12,7,5,36,12,24,-24,-7
Defour,76,2,170,2018-12-22T12:30:00Z,False,3,0,0,0,12,7,5,34,20,14,-22,-15
Defour,76,2,181,2018-12-26T15:00:00Z,True,3,7,0,0,12,7,5,24,18,6,-12,1
Defour,76,2,191,2018-12-30T14:15:00Z,True,3,18,0,0,12,7,5,27,13,14,-15,-7
Defour,76,2,205,2019-01-02T19:45:00Z,False,3,9,0,0,15,10,5,10,5,5,5,0
Defour,76,2,211,2019-01-12T15:00:00Z,True,3,8,0,0,18,10,8,14,12,2,4,8
Defour,76,2,228,2019-01-19T15:00:00Z,False,3,17,0,0,21,13,8,32,16,16,-11,-8
Defour,76,2,234,2019-01-29T20:00:00Z,False,3,13,0,0,22,13,9,44,24,20,-22,-15
Defour,76,2,241,2019-02-02T15:00:00Z,True,3,15,0,0,23,13,10,23,12,11,0,2
Defour,76,2,250,2019-02-09T17:30:00Z,False,3,2,0,0,24,14,10,27,19,8,-3,-9
Defour,76,2,262,2019-02-23T12:30:00Z,True,3,16,0,0,27,14,13,60,27,33,-33,-19
Defour,76,2,278,2019-02-26T20:00:00Z,False,3,14,0,0,30,17,13,28,16,12,2,-3
Defour,76,2,282,2019-03-02T15:00:00Z,True,3,6,0,0,30,17,13,30,13,17,0,0
Defour,76,2,296,2019-03-10T12:00:00Z,False,3,11,0,0,30,17,13,70,38,32,-40,-25
Defour,76,2,302,2019-03-16T15:00:00Z,True,3,10,0,0,30,17,13,38,20,18,-8,-1
Defour,76,2,312,2019-03-30T15:00:00Z,True,3,19,0,0,30,17,13,44,24,20,-14,-3
Defour,76,2,320,2019-04-06T14:00:00Z,False,3,1,0,0,33,20,13,38,26,12,-5,-13
Defour,76,2,331,2019-04-13T14:00:00Z,True,3,4,0,0,36,20,16,28,20,8,8,12
Defour,76,2,343,2019-04-22T19:00:00Z,False,3,5,0,0,39,23,16,66,38,28,-27,-22
Defour,76,2,351,2019-04-28T13:05:00Z,True,3,12,0,0,40,23,17,89,51,38,-49,-15
Defour,76,2,364,2019-05-03T19:00:00Z,False,3,7,0,0,40,23,17,50,31,19,-10,-14
Defour,76,2,371,2019-05-12T14:00:00Z,True,3,0,0,0,40,23,17,67,45,22,-27,1
Hendrick,77,2,7,2018-08-12T12:30:00Z,False,3,15,75,3,0,0,0,0,0,0,0,0
Hendrick,77,2,11,2018-08-19T12:30:00Z,True,3,17,69,2,1,0,1,3,3,0,-2,0
Hendrick,77,2,22,2018-08-26T15:00:00Z,False,3,8,90,7,1,0,1,0,0,0,1,1
Hendrick,77,2,31,2018-09-02T15:00:00Z,True,3,13,57,1,1,0,1,3,3,0,-2,0
Hendrick,77,2,49,2018-09-16T12:30:00Z,False,3,19,78,2,1,0,1,5,2,3,-4,-1
Hendrick,77,2,52,2018-09-22T14:00:00Z,True,3,1,0,0,1,0,1,10,7,3,-9,-3
Hendrick,77,2,62,2018-09-30T15:00:00Z,False,3,4,0,0,4,3,1,2,1,1,2,0
Hendrick,77,2,71,2018-10-06T14:00:00Z,True,3,9,17,1,7,3,4,2,1,1,5,2
Hendrick,77,2,86,2018-10-20T14:00:00Z,False,3,12,90,1,8,4,4,20,12,8,-12,-8
Hendrick,77,2,91,2018-10-28T13:30:00Z,True,3,5,64,1,8,4,4,21,11,10,-13,-6
Hendrick,77,2,108,2018-11-03T15:00:00Z,False,3,18,0,0,8,4,4,8,4,4,0,0
Hendrick,77,2,115,2018-11-10T15:00:00Z,False,3,10,35,1,8,4,4,16,7,9,-8,-3
Hendrick,77,2,122,2018-11-26T20:30:00Z,True,3,14,8,1,9,4,5,9,6,3,0,1
Hendrick,77,2,133,2018-12-01T15:00:00Z,False,3,6,90,2,9,4,5,9,2,7,0,3
Hendrick,77,2,142,2018-12-05T19:45:00Z,True,3,11,0,0,9,4,5,36,19,17,-27,-13
Hendrick,77,2,152,2018-12-08T15:00:00Z,True,3,2,5,1,9,4,5,21,14,7,-12,-3
Hendrick,77,2,167,2018-12-15T15:00:00Z,False,3,16,1,1,12,7,5,36,12,24,-24,-7
Hendrick,77,2,170,2018-12-22T12:30:00Z,False,3,0,90,2,12,7,5,34,20,14,-22,-15
Hendrick,77,2,181,2018-12-26T15:00:00Z,True,3,7,62,2,12,7,5,24,18,6,-12,1
Hendrick,77,2,191,2018-12-30T14:15:00Z,True,3,18,0,0,12,7,5,27,13,14,-15,-7
Hendrick,77,2,205,2019-01-02T19:45:00Z,False,3,9,1,1,15,10,5,10,5,5,5,0
Hendrick,77,2,211,2019-01-12T15:00:00Z,True,3,8,90,11,18,10,8,14,12,2,4,8
Hendrick,77,2,228,2019-01-19T15:00:00Z,False,3,17,90,3,21,13,8,32,16,16,-11,-8
Hendrick,77,2,234,2019-01-29T20:00:00Z,False,3,13,90,2,22,13,9,44,24,20,-22,-15
Hendrick,77,2,241,2019-02-02T15:00:00Z,True,3,15,57,1,23,13,10,23,12,11,0,2
Hendrick,77,2,250,2019-02-09T17:30:00Z,False,3,2,90,2,24,14,10,27,19,8,-3,-9
Hendrick,77,2,262,2019-02-23T12:30:00Z,True,3,16,79,2,27,14,13,60,27,33,-33,-19
Hendrick,77,2,278,2019-02-26T20:00:00Z,False,3,14,90,1,30,17,13,28,16,12,2,-3
Hendrick,77,2,282,2019-03-02T15:00:00Z,True,3,6,45,1,30,17,13,30,13,17,0,0
Hendrick,77,2,296,2019-03-10T12:00:00Z,False,3,11,78,2,30,17,13,70,38,32,-40,-25
Hendrick,77,2,302,2019-03-16T15:00:00Z,True,3,10,0,0,30,17,13,38,20,18,-8,-1
Hendrick,77,2,312,2019-03-30T15:00:00Z,True,3,19,90,3,30,17,13,44,24,20,-14,-3
Hendrick,77,2,320,2019-04-06T14:00:00Z,False,3,1,81,1,33,20,13,38,26,12,-5,-13
Hendrick,77,2,331,2019-04-13T14:00:00Z,True,3,4,90,3,36,20,16,28,20,8,8,12
Hendrick,77,2,343,2019-04-22T19:00:00Z,False,3,5,90,7,39,23,16,66,38,28,-27,-22
Hendrick,77,2,351,2019-04-28T13:05:00Z,True,3,12,75,2,40,23,17,89,51,38,-49,-15
Hendrick,77,2,364,2019-05-03T19:00:00Z,False,3,7,10,1,40,23,17,50,31,19,-10,-14
Hendrick,77,2,371,2019-05-12T14:00:00Z,True,3,0,81,2,40,23,17,67,45,22,-27,1
Brady,78,2,7,2018-08-12T12:30:00Z,False,3,15,0,0,0,0,0,0,0,0,0,0
Brady,78,2,11,2018-08-19T12:30:00Z,True,3,17,0,0,1,0,1,3,3,0,-2,0
Brady,78,2,22,2018-08-26T15:00:00Z,False,3,8,0,0,1,0,1,0,0,0,1,1
Brady,78,2,31,2018-09-02T15:00:00Z,True,3,13,0,0,1,0,1,3,3,0,-2,0
Brady,78,2,49,2018-09-16T12:30:00Z,False,3,19,0,0,1,0,1,5,2,3,-4,-1
Brady,78,2,52,2018-09-22T14:00:00Z,True,3,1,0,0,1,0,1,10,7,3,-9,-3
Brady,78,2,62,2018-09-30T15:00:00Z,False,3,4,0,0,4,3,1,2,1,1,2,0
Brady,78,2,71,2018-10-06T14:00:00Z,True,3,9,0,0,7,3,4,2,1,1,5,2
Brady,78,2,86,2018-10-20T14:00:00Z,False,3,12,0,0,8,4,4,20,12,8,-12,-8
Brady,78,2,91,2018-10-28T13:30:00Z,True,3,5,90,1,8,4,4,21,11,10,-13,-6
Brady,78,2,108,2018-11-03T15:00:00Z,False,3,18,15,3,8,4,4,8,4,4,0,0
Brady,78,2,115,2018-11-10T15:00:00Z,False,3,10,25,1,8,4,4,16,7,9,-8,-3
Brady,78,2,122,2018-11-26T20:30:00Z,True,3,14,82,2,9,4,5,9,6,3,0,1
Brady,78,2,133,2018-12-01T15:00:00Z,False,3,6,45,1,9,4,5,9,2,7,0,3
Brady,78,2,142,2018-12-05T19:45:00Z,True,3,11,70,2,9,4,5,36,19,17,-27,-13
Brady,78,2,152,2018-12-08T15:00:00Z,True,3,2,90,3,9,4,5,21,14,7,-12,-3
Brady,78,2,167,2018-12-15T15:00:00Z,False,3,16,90,1,12,7,5,36,12,24,-24,-7
Brady,78,2,170,2018-12-22T12:30:00Z,False,3,0,0,0,12,7,5,34,20,14,-22,-15
Brady,78,2,181,2018-12-26T15:00:00Z,True,3,7,0,0,12,7,5,24,18,6,-12,1
Brady,78,2,191,2018-12-30T14:15:00Z,True,3,18,0,0,12,7,5,27,13,14,-15,-7
Brady,78,2,205,2019-01-02T19:45:00Z,False,3,9,27,-2,15,10,5,10,5,5,5,0
Brady,78,2,211,2019-01-12T15:00:00Z,True,3,8,0,0,18,10,8,14,12,2,4,8
Brady,78,2,228,2019-01-19T15:00:00Z,False,3,17,0,0,21,13,8,32,16,16,-11,-8
Brady,78,2,234,2019-01-29T20:00:00Z,False,3,13,0,0,22,13,9,44,24,20,-22,-15
Brady,78,2,241,2019-02-02T15:00:00Z,True,3,15,9,1,23,13,10,23,12,11,0,2
Brady,78,2,250,2019-02-09T17:30:00Z,False,3,2,0,0,24,14,10,27,19,8,-3,-9
Brady,78,2,262,2019-02-23T12:30:00Z,True,3,16,10,1,27,14,13,60,27,33,-33,-19
Brady,78,2,278,2019-02-26T20:00:00Z,False,3,14,45,1,30,17,13,28,16,12,2,-3
Brady,78,2,282,2019-03-02T15:00:00Z,True,3,6,18,1,30,17,13,30,13,17,0,0
Brady,78,2,296,2019-03-10T12:00:00Z,False,3,11,0,0,30,17,13,70,38,32,-40,-25
Brady,78,2,302,2019-03-16T15:00:00Z,True,3,10,11,1,30,17,13,38,20,18,-8,-1
Brady,78,2,312,2019-03-30T15:00:00Z,True,3,19,0,0,30,17,13,44,24,20,-14,-3
Brady,78,2,320,2019-04-06T14:00:00Z,False,3,1,0,0,33,20,13,38,26,12,-5,-13
Brady,78,2,331,2019-04-13T14:00:00Z,True,3,4,0,0,36,20,16,28,20,8,8,12
Brady,78,2,343,2019-04-22T19:00:00Z,False,3,5,0,0,39,23,16,66,38,28,-27,-22
Brady,78,2,351,2019-04-28T13:05:00Z,True,3,12,0,0,40,23,17,89,51,38,-49,-15
Brady,78,2,364,2019-05-03T19:00:00Z,False,3,7,79,2,40,23,17,50,31,19,-10,-14
Brady,78,2,371,2019-05-12T14:00:00Z,True,3,0,8,1,40,23,17,67,45,22,-27,1
Westwood,79,2,7,2018-08-12T12:30:00Z,False,3,15,90,3,0,0,0,0,0,0,0,0
Westwood,79,2,11,2018-08-19T12:30:00Z,True,3,17,90,2,1,0,1,3,3,0,-2,0
Westwood,79,2,22,2018-08-26T15:00:00Z,False,3,8,90,2,1,0,1,0,0,0,1,1
Westwood,79,2,31,2018-09-02T15:00:00Z,True,3,13,90,2,1,0,1,3,3,0,-2,0
Westwood,79,2,49,2018-09-16T12:30:00Z,False,3,19,11,1,1,0,1,5,2,3,-4,-1
Westwood,79,2,52,2018-09-22T14:00:00Z,True,3,1,90,5,1,0,1,10,7,3,-9,-3
Westwood,79,2,62,2018-09-30T15:00:00Z,False,3,4,90,4,4,3,1,2,1,1,2,0
Westwood,79,2,71,2018-10-06T14:00:00Z,True,3,9,72,2,7,3,4,2,1,1,5,2
Westwood,79,2,86,2018-10-20T14:00:00Z,False,3,12,21,1,8,4,4,20,12,8,-12,-8
Westwood,79,2,91,2018-10-28T13:30:00Z,True,3,5,17,1,8,4,4,21,11,10,-13,-6
Westwood,79,2,108,2018-11-03T15:00:00Z,False,3,18,90,5,8,4,4,8,4,4,0,0
Westwood,79,2,115,2018-11-10T15:00:00Z,False,3,10,0,0,8,4,4,16,7,9,-8,-3
Westwood,79,2,122,2018-11-26T20:30:00Z,True,3,14,0,0,9,4,5,9,6,3,0,1
Westwood,79,2,133,2018-12-01T15:00:00Z,False,3,6,0,0,9,4,5,9,2,7,0,3
Westwood,79,2,142,2018-12-05T19:45:00Z,True,3,11,90,2,9,4,5,36,19,17,-27,-13
Westwood,79,2,152,2018-12-08T15:00:00Z,True,3,2,90,3,9,4,5,21,14,7,-12,-3
Westwood,79,2,167,2018-12-15T15:00:00Z,False,3,16,90,2,12,7,5,36,12,24,-24,-7
Westwood,79,2,170,2018-12-22T12:30:00Z,False,3,0,90,1,12,7,5,34,20,14,-22,-15
Westwood,79,2,181,2018-12-26T15:00:00Z,True,3,7,90,2,12,7,5,24,18,6,-12,1
Westwood,79,2,191,2018-12-30T14:15:00Z,True,3,18,90,8,12,7,5,27,13,14,-15,-7
Westwood,79,2,205,2019-01-02T19:45:00Z,False,3,9,90,8,15,10,5,10,5,5,5,0
Westwood,79,2,211,2019-01-12T15:00:00Z,True,3,8,90,2,18,10,8,14,12,2,4,8
Westwood,79,2,228,2019-01-19T15:00:00Z,False,3,17,90,3,21,13,8,32,16,16,-11,-8
Westwood,79,2,234,2019-01-29T20:00:00Z,False,3,13,90,5,22,13,9,44,24,20,-22,-15
Westwood,79,2,241,2019-02-02T15:00:00Z,True,3,15,90,2,23,13,10,23,12,11,0,2
Westwood,79,2,250,2019-02-09T17:30:00Z,False,3,2,90,1,24,14,10,27,19,8,-3,-9
Westwood,79,2,262,2019-02-23T12:30:00Z,True,3,16,90,2,27,14,13,60,27,33,-33,-19
Westwood,79,2,278,2019-02-26T20:00:00Z,False,3,14,0,0,30,17,13,28,16,12,2,-3
Westwood,79,2,282,2019-03-02T15:00:00Z,True,3,6,90,7,30,17,13,30,13,17,0,0
Westwood,79,2,296,2019-03-10T12:00:00Z,False,3,11,90,7,30,17,13,70,38,32,-40,-25
Westwood,79,2,302,2019-03-16T15:00:00Z,True,3,10,90,2,30,17,13,38,20,18,-8,-1
Westwood,79,2,312,2019-03-30T15:00:00Z,True,3,19,90,3,30,17,13,44,24,20,-14,-3
Westwood,79,2,320,2019-04-06T14:00:00Z,False,3,1,90,13,33,20,13,38,26,12,-5,-13
Westwood,79,2,331,2019-04-13T14:00:00Z,True,3,4,90,3,36,20,16,28,20,8,8,12
Westwood,79,2,343,2019-04-22T19:00:00Z,False,3,5,90,2,39,23,16,66,38,28,-27,-22
Westwood,79,2,351,2019-04-28T13:05:00Z,True,3,12,90,2,40,23,17,89,51,38,-49,-15
Westwood,79,2,364,2019-05-03T19:00:00Z,False,3,7,90,1,40,23,17,50,31,19,-10,-14
Westwood,79,2,371,2019-05-12T14:00:00Z,True,3,0,90,2,40,23,17,67,45,22,-27,1
Walters,80,2,7,2018-08-12T12:30:00Z,False,3,15,0,0,0,0,0,0,0,0,0,0
Walters,80,2,11,2018-08-19T12:30:00Z,True,3,17,0,0,1,0,1,3,3,0,-2,0
Walters,80,2,22,2018-08-26T15:00:00Z,False,3,8,0,0,1,0,1,0,0,0,1,1
Walters,80,2,31,2018-09-02T15:00:00Z,True,3,13,0,0,1,0,1,3,3,0,-2,0
Walters,80,2,49,2018-09-16T12:30:00Z,False,3,19,0,0,1,0,1,5,2,3,-4,-1
Walters,80,2,52,2018-09-22T14:00:00Z,True,3,1,0,0,1,0,1,10,7,3,-9,-3
Walters,80,2,62,2018-09-30T15:00:00Z,False,3,4,0,0,4,3,1,2,1,1,2,0
Walters,80,2,71,2018-10-06T14:00:00Z,True,3,9,0,0,7,3,4,2,1,1,5,2
Walters,80,2,86,2018-10-20T14:00:00Z,False,3,12,0,0,8,4,4,20,12,8,-12,-8
Walters,80,2,91,2018-10-28T13:30:00Z,True,3,5,0,0,8,4,4,21,11,10,-13,-6
Walters,80,2,108,2018-11-03T15:00:00Z,False,3,18,0,0,8,4,4,8,4,4,0,0
Walters,80,2,115,2018-11-10T15:00:00Z,False,3,10,0,0,8,4,4,16,7,9,-8,-3
Walters,80,2,122,2018-11-26T20:30:00Z,True,3,14,0,0,9,4,5,9,6,3,0,1
Walters,80,2,133,2018-12-01T15:00:00Z,False,3,6,0,0,9,4,5,9,2,7,0,3
Walters,80,2,142,2018-12-05T19:45:00Z,True,3,11,0,0,9,4,5,36,19,17,-27,-13
Walters,80,2,152,2018-12-08T15:00:00Z,True,3,2,0,0,9,4,5,21,14,7,-12,-3
Walters,80,2,167,2018-12-15T15:00:00Z,False,3,16,0,0,12,7,5,36,12,24,-24,-7
Walters,80,2,170,2018-12-22T12:30:00Z,False,3,0,0,0,12,7,5,34,20,14,-22,-15
Walters,80,2,181,2018-12-26T15:00:00Z,True,3,7,0,0,12,7,5,24,18,6,-12,1
Walters,80,2,191,2018-12-30T14:15:00Z,True,3,18,0,0,12,7,5,27,13,14,-15,-7
Walters,80,2,205,2019-01-02T19:45:00Z,False,3,9,0,0,15,10,5,10,5,5,5,0
Walters,80,2,211,2019-01-12T15:00:00Z,True,3,8,0,0,18,10,8,14,12,2,4,8
Walters,80,2,228,2019-01-19T15:00:00Z,False,3,17,0,0,21,13,8,32,16,16,-11,-8
Walters,80,2,234,2019-01-29T20:00:00Z,False,3,13,0,0,22,13,9,44,24,20,-22,-15
Walters,80,2,241,2019-02-02T15:00:00Z,True,3,15,0,0,23,13,10,23,12,11,0,2
Walters,80,2,250,2019-02-09T17:30:00Z,False,3,2,0,0,24,14,10,27,19,8,-3,-9
Walters,80,2,262,2019-02-23T12:30:00Z,True,3,16,0,0,27,14,13,60,27,33,-33,-19
Walters,80,2,278,2019-02-26T20:00:00Z,False,3,14,0,0,30,17,13,28,16,12,2,-3
Walters,80,2,282,2019-03-02T15:00:00Z,True,3,6,0,0,30,17,13,30,13,17,0,0
Walters,80,2,296,2019-03-10T12:00:00Z,False,3,11,0,0,30,17,13,70,38,32,-40,-25
Walters,80,2,302,2019-03-16T15:00:00Z,True,3,10,0,0,30,17,13,38,20,18,-8,-1
Walters,80,2,312,2019-03-30T15:00:00Z,True,3,19,0,0,30,17,13,44,24,20,-14,-3
Walters,80,2,320,2019-04-06T14:00:00Z,False,3,1,0,0,33,20,13,38,26,12,-5,-13
Walters,80,2,331,2019-04-13T14:00:00Z,True,3,4,0,0,36,20,16,28,20,8,8,12
Walters,80,2,343,2019-04-22T19:00:00Z,False,3,5,0,0,39,23,16,66,38,28,-27,-22
Walters,80,2,351,2019-04-28T13:05:00Z,True,3,12,0,0,40,23,17,89,51,38,-49,-15
Walters,80,2,364,2019-05-03T19:00:00Z,False,3,7,0,0,40,23,17,50,31,19,-10,-14
Walters,80,2,371,2019-05-12T14:00:00Z,True,3,0,0,0,40,23,17,67,45,22,-27,1
Cork,81,2,7,2018-08-12T12:30:00Z,False,3,15,90,2,0,0,0,0,0,0,0,0
Cork,81,2,11,2018-08-19T12:30:00Z,True,3,17,90,2,1,0,1,3,3,0,-2,0
Cork,81,2,22,2018-08-26T15:00:00Z,False,3,8,90,2,1,0,1,0,0,0,1,1
Cork,81,2,31,2018-09-02T15:00:00Z,True,3,13,90,2,1,0,1,3,3,0,-2,0
Cork,81,2,49,2018-09-16T12:30:00Z,False,3,19,90,1,1,0,1,5,2,3,-4,-1
Cork,81,2,52,2018-09-22T14:00:00Z,True,3,1,90,3,1,0,1,10,7,3,-9,-3
Cork,81,2,62,2018-09-30T15:00:00Z,False,3,4,90,2,4,3,1,2,1,1,2,0
Cork,81,2,71,2018-10-06T14:00:00Z,True,3,9,90,2,7,3,4,2,1,1,5,2
Cork,81,2,86,2018-10-20T14:00:00Z,False,3,12,90,1,8,4,4,20,12,8,-12,-8
Cork,81,2,91,2018-10-28T13:30:00Z,True,3,5,72,2,8,4,4,21,11,10,-13,-6
Cork,81,2,108,2018-11-03T15:00:00Z,False,3,18,0,0,8,4,4,8,4,4,0,0
Cork,81,2,115,2018-11-10T15:00:00Z,False,3,10,90,3,8,4,4,16,7,9,-8,-3
Cork,81,2,122,2018-11-26T20:30:00Z,True,3,14,90,2,9,4,5,9,6,3,0,1
Cork,81,2,133,2018-12-01T15:00:00Z,False,3,6,90,2,9,4,5,9,2,7,0,3
Cork,81,2,142,2018-12-05T19:45:00Z,True,3,11,90,7,9,4,5,36,19,17,-27,-13
Cork,81,2,152,2018-12-08T15:00:00Z,True,3,2,90,6,9,4,5,21,14,7,-12,-3
Cork,81,2,167,2018-12-15T15:00:00Z,False,3,16,90,2,12,7,5,36,12,24,-24,-7
Cork,81,2,170,2018-12-22T12:30:00Z,False,3,0,90,1,12,7,5,34,20,14,-22,-15
Cork,81,2,181,2018-12-26T15:00:00Z,True,3,7,90,2,12,7,5,24,18,6,-12,1
Cork,81,2,191,2018-12-30T14:15:00Z,True,3,18,90,3,12,7,5,27,13,14,-15,-7
Cork,81,2,205,2019-01-02T19:45:00Z,False,3,9,90,2,15,10,5,10,5,5,5,0
Cork,81,2,211,2019-01-12T15:00:00Z,True,3,8,90,2,18,10,8,14,12,2,4,8
Cork,81,2,228,2019-01-19T15:00:00Z,False,3,17,90,3,21,13,8,32,16,16,-11,-8
Cork,81,2,234,2019-01-29T20:00:00Z,False,3,13,90,4,22,13,9,44,24,20,-22,-15
Cork,81,2,241,2019-02-02T15:00:00Z,True,3,15,90,2,23,13,10,23,12,11,0,2
Cork,81,2,250,2019-02-09T17:30:00Z,False,3,2,90,2,24,14,10,27,19,8,-3,-9
Cork,81,2,262,2019-02-23T12:30:00Z,True,3,16,90,2,27,14,13,60,27,33,-33,-19
Cork,81,2,278,2019-02-26T20:00:00Z,False,3,14,90,2,30,17,13,28,16,12,2,-3
Cork,81,2,282,2019-03-02T15:00:00Z,True,3,6,90,2,30,17,13,30,13,17,0,0
Cork,81,2,296,2019-03-10T12:00:00Z,False,3,11,90,2,30,17,13,70,38,32,-40,-25
Cork,81,2,302,2019-03-16T15:00:00Z,True,3,10,90,2,30,17,13,38,20,18,-8,-1
Cork,81,2,312,2019-03-30T15:00:00Z,True,3,19,90,3,30,17,13,44,24,20,-14,-3
Cork,81,2,320,2019-04-06T14:00:00Z,False,3,1,90,2,33,20,13,38,26,12,-5,-13
Cork,81,2,331,2019-04-13T14:00:00Z,True,3,4,90,3,36,20,16,28,20,8,8,12
Cork,81,2,343,2019-04-22T19:00:00Z,False,3,5,90,2,39,23,16,66,38,28,-27,-22
Cork,81,2,351,2019-04-28T13:05:00Z,True,3,12,90,2,40,23,17,89,51,38,-49,-15
Cork,81,2,364,2019-05-03T19:00:00Z,False,3,7,90,2,40,23,17,50,31,19,-10,-14
Cork,81,2,371,2019-05-12T14:00:00Z,True,3,0,90,1,40,23,17,67,45,22,-27,1
Lennon,82,2,7,2018-08-12T12:30:00Z,False,3,15,90,3,0,0,0,0,0,0,0,0
Lennon,82,2,11,2018-08-19T12:30:00Z,True,3,17,90,2,1,0,1,3,3,0,-2,0
Lennon,82,2,22,2018-08-26T15:00:00Z,False,3,8,90,2,1,0,1,0,0,0,1,1
Lennon,82,2,31,2018-09-02T15:00:00Z,True,3,13,90,2,1,0,1,3,3,0,-2,0
Lennon,82,2,49,2018-09-16T12:30:00Z,False,3,19,90,2,1,0,1,5,2,3,-4,-1
Lennon,82,2,52,2018-09-22T14:00:00Z,True,3,1,90,13,1,0,1,10,7,3,-9,-3
Lennon,82,2,62,2018-09-30T15:00:00Z,False,3,4,90,1,4,3,1,2,1,1,2,0
Lennon,82,2,71,2018-10-06T14:00:00Z,True,3,9,90,2,7,3,4,2,1,1,5,2
Lennon,82,2,86,2018-10-20T14:00:00Z,False,3,12,68,2,8,4,4,20,12,8,-12,-8
Lennon,82,2,91,2018-10-28T13:30:00Z,True,3,5,0,0,8,4,4,21,11,10,-13,-6
Lennon,82,2,108,2018-11-03T15:00:00Z,False,3,18,74,2,8,4,4,8,4,4,0,0
Lennon,82,2,115,2018-11-10T15:00:00Z,False,3,10,90,3,8,4,4,16,7,9,-8,-3
Lennon,82,2,122,2018-11-26T20:30:00Z,True,3,14,90,2,9,4,5,9,6,3,0,1
Lennon,82,2,133,2018-12-01T15:00:00Z,False,3,6,45,1,9,4,5,9,2,7,0,3
Lennon,82,2,142,2018-12-05T19:45:00Z,True,3,11,19,1,9,4,5,36,19,17,-27,-13
Lennon,82,2,152,2018-12-08T15:00:00Z,True,3,2,18,1,9,4,5,21,14,7,-12,-3
Lennon,82,2,167,2018-12-15T15:00:00Z,False,3,16,90,2,12,7,5,36,12,24,-24,-7
Lennon,82,2,170,2018-12-22T12:30:00Z,False,3,0,0,0,12,7,5,34,20,14,-22,-15
Lennon,82,2,181,2018-12-26T15:00:00Z,True,3,7,0,0,12,7,5,24,18,6,-12,1
Lennon,82,2,191,2018-12-30T14:15:00Z,True,3,18,0,0,12,7,5,27,13,14,-15,-7
Lennon,82,2,205,2019-01-02T19:45:00Z,False,3,9,0,0,15,10,5,10,5,5,5,0
Lennon,82,2,211,2019-01-12T15:00:00Z,True,3,8,0,0,18,10,8,14,12,2,4,8
Lennon,82,2,228,2019-01-19T15:00:00Z,False,3,17,0,0,21,13,8,32,16,16,-11,-8
Lennon,82,2,234,2019-01-29T20:00:00Z,False,3,13,0,0,22,13,9,44,24,20,-22,-15
Lennon,82,2,241,2019-02-02T15:00:00Z,True,3,15,0,0,23,13,10,23,12,11,0,2
Lennon,82,2,250,2019-02-09T17:30:00Z,False,3,2,0,0,24,14,10,27,19,8,-3,-9
Lennon,82,2,262,2019-02-23T12:30:00Z,True,3,16,0,0,27,14,13,60,27,33,-33,-19
Lennon,82,2,278,2019-02-26T20:00:00Z,False,3,14,0,0,30,17,13,28,16,12,2,-3
Lennon,82,2,282,2019-03-02T15:00:00Z,True,3,6,0,0,30,17,13,30,13,17,0,0
Lennon,82,2,296,2019-03-10T12:00:00Z,False,3,11,0,0,30,17,13,70,38,32,-40,-25
Lennon,82,2,302,2019-03-16T15:00:00Z,True,3,10,0,0,30,17,13,38,20,18,-8,-1
Lennon,82,2,312,2019-03-30T15:00:00Z,True,3,19,0,0,30,17,13,44,24,20,-14,-3
Lennon,82,2,320,2019-04-06T14:00:00Z,False,3,1,0,0,33,20,13,38,26,12,-5,-13
Lennon,82,2,331,2019-04-13T14:00:00Z,True,3,4,0,0,36,20,16,28,20,8,8,12
Lennon,82,2,343,2019-04-22T19:00:00Z,False,3,5,0,0,39,23,16,66,38,28,-27,-22
Lennon,82,2,351,2019-04-28T13:05:00Z,True,3,12,0,0,40,23,17,89,51,38,-49,-15
Lennon,82,2,364,2019-05-03T19:00:00Z,False,3,7,0,0,40,23,17,50,31,19,-10,-14
Lennon,82,2,371,2019-05-12T14:00:00Z,True,3,0,0,0,40,23,17,67,45,22,-27,1
Vokes,83,3,7,2018-08-12T12:30:00Z,False,3,15,17,1,0,0,0,0,0,0,0,0
Vokes,83,3,11,2018-08-19T12:30:00Z,True,3,17,20,1,1,0,1,3,3,0,-2,0
Vokes,83,3,22,2018-08-26T15:00:00Z,False,3,8,24,1,1,0,1,0,0,0,1,1
Vokes,83,3,31,2018-09-02T15:00:00Z,True,3,13,32,1,1,0,1,3,3,0,-2,0
Vokes,83,3,49,2018-09-16T12:30:00Z,False,3,19,69,2,1,0,1,5,2,3,-4,-1
Vokes,83,3,52,2018-09-22T14:00:00Z,True,3,1,68,2,1,0,1,10,7,3,-9,-3
Vokes,83,3,62,2018-09-30T15:00:00Z,False,3,4,90,8,4,3,1,2,1,1,2,0
Vokes,83,3,71,2018-10-06T14:00:00Z,True,3,9,89,9,7,3,4,2,1,1,5,2
Vokes,83,3,86,2018-10-20T14:00:00Z,False,3,12,68,2,8,4,4,20,12,8,-12,-8
Vokes,83,3,91,2018-10-28T13:30:00Z,True,3,5,58,1,8,4,4,21,11,10,-13,-6
Vokes,83,3,108,2018-11-03T15:00:00Z,False,3,18,71,2,8,4,4,8,4,4,0,0
Vokes,83,3,115,2018-11-10T15:00:00Z,False,3,10,72,2,8,4,4,16,7,9,-8,-3
Vokes,83,3,122,2018-11-26T20:30:00Z,True,3,14,90,8,9,4,5,9,6,3,0,1
Vokes,83,3,133,2018-12-01T15:00:00Z,False,3,6,30,1,9,4,5,9,2,7,0,3
Vokes,83,3,142,2018-12-05T19:45:00Z,True,3,11,19,1,9,4,5,36,19,17,-27,-13
Vokes,83,3,152,2018-12-08T15:00:00Z,True,3,2,0,0,9,4,5,21,14,7,-12,-3
Vokes,83,3,167,2018-12-15T15:00:00Z,False,3,16,1,1,12,7,5,36,12,24,-24,-7
Vokes,83,3,170,2018-12-22T12:30:00Z,False,3,0,13,1,12,7,5,34,20,14,-22,-15
Vokes,83,3,181,2018-12-26T15:00:00Z,True,3,7,72,2,12,7,5,24,18,6,-12,1
Vokes,83,3,191,2018-12-30T14:15:00Z,True,3,18,1,1,12,7,5,27,13,14,-15,-7
Vokes,83,3,205,2019-01-02T19:45:00Z,False,3,9,0,0,15,10,5,10,5,5,5,0
Vokes,83,3,211,2019-01-12T15:00:00Z,True,3,8,3,1,18,10,8,14,12,2,4,8
Vokes,83,3,228,2019-01-19T15:00:00Z,False,3,17,0,0,21,13,8,32,16,16,-11,-8
Vokes,83,3,234,2019-01-29T20:00:00Z,False,3,13,0,0,22,13,9,44,24,20,-22,-15
Vokes,83,3,241,2019-02-02T15:00:00Z,True,3,15,0,0,23,13,10,23,12,11,0,2
Vokes,83,3,250,2019-02-09T17:30:00Z,False,3,2,0,0,24,14,10,27,19,8,-3,-9
Vokes,83,3,262,2019-02-23T12:30:00Z,True,3,16,0,0,27,14,13,60,27,33,-33,-19
Vokes,83,3,278,2019-02-26T20:00:00Z,False,3,14,0,0,30,17,13,28,16,12,2,-3
Vokes,83,3,282,2019-03-02T15:00:00Z,True,3,6,0,0,30,17,13,30,13,17,0,0
Vokes,83,3,296,2019-03-10T12:00:00Z,False,3,11,0,0,30,17,13,70,38,32,-40,-25
Vokes,83,3,302,2019-03-16T15:00:00Z,True,3,10,0,0,30,17,13,38,20,18,-8,-1
Vokes,83,3,312,2019-03-30T15:00:00Z,True,3,19,0,0,30,17,13,44,24,20,-14,-3
Vokes,83,3,320,2019-04-06T14:00:00Z,False,3,1,0,0,33,20,13,38,26,12,-5,-13
Vokes,83,3,331,2019-04-13T14:00:00Z,True,3,4,0,0,36,20,16,28,20,8,8,12
Vokes,83,3,343,2019-04-22T19:00:00Z,False,3,5,0,0,39,23,16,66,38,28,-27,-22
Vokes,83,3,351,2019-04-28T13:05:00Z,True,3,12,0,0,40,23,17,89,51,38,-49,-15
Vokes,83,3,364,2019-05-03T19:00:00Z,False,3,7,0,0,40,23,17,50,31,19,-10,-14
Vokes,83,3,371,2019-05-12T14:00:00Z,True,3,0,0,0,40,23,17,67,45,22,-27,1
Barnes,84,3,7,2018-08-12T12:30:00Z,False,3,15,14,1,0,0,0,0,0,0,0,0
Barnes,84,3,11,2018-08-19T12:30:00Z,True,3,17,25,1,1,0,1,3,3,0,-2,0
Barnes,84,3,22,2018-08-26T15:00:00Z,False,3,8,24,1,1,0,1,0,0,0,1,1
Barnes,84,3,31,2018-09-02T15:00:00Z,True,3,13,10,1,1,0,1,3,3,0,-2,0
Barnes,84,3,49,2018-09-16T12:30:00Z,False,3,19,55,1,1,0,1,5,2,3,-4,-1
Barnes,84,3,52,2018-09-22T14:00:00Z,True,3,1,21,12,1,0,1,10,7,3,-9,-3
Barnes,84,3,62,2018-09-30T15:00:00Z,False,3,4,0,0,4,3,1,2,1,1,2,0
Barnes,84,3,71,2018-10-06T14:00:00Z,True,3,9,60,2,7,3,4,2,1,1,5,2
Barnes,84,3,86,2018-10-20T14:00:00Z,False,3,12,15,1,8,4,4,20,12,8,-12,-8
Barnes,84,3,91,2018-10-28T13:30:00Z,True,3,5,25,1,8,4,4,21,11,10,-13,-6
Barnes,84,3,108,2018-11-03T15:00:00Z,False,3,18,18,0,8,4,4,8,4,4,0,0
Barnes,84,3,115,2018-11-10T15:00:00Z,False,3,10,17,1,8,4,4,16,7,9,-8,-3
Barnes,84,3,122,2018-11-26T20:30:00Z,True,3,14,7,1,9,4,5,9,6,3,0,1
Barnes,84,3,133,2018-12-01T15:00:00Z,False,3,6,10,1,9,4,5,9,2,7,0,3
Barnes,84,3,142,2018-12-05T19:45:00Z,True,3,11,82,5,9,4,5,36,19,17,-27,-13
Barnes,84,3,152,2018-12-08T15:00:00Z,True,3,2,84,2,9,4,5,21,14,7,-12,-3
Barnes,84,3,167,2018-12-15T15:00:00Z,False,3,16,79,2,12,7,5,36,12,24,-24,-7
Barnes,84,3,170,2018-12-22T12:30:00Z,False,3,0,76,7,12,7,5,34,20,14,-22,-15
Barnes,84,3,181,2018-12-26T15:00:00Z,True,3,7,90,2,12,7,5,24,18,6,-12,1
Barnes,84,3,191,2018-12-30T14:15:00Z,True,3,18,90,4,12,7,5,27,13,14,-15,-7
Barnes,84,3,205,2019-01-02T19:45:00Z,False,3,9,90,7,15,10,5,10,5,5,5,0
Barnes,84,3,211,2019-01-12T15:00:00Z,True,3,8,90,2,18,10,8,14,12,2,4,8
Barnes,84,3,228,2019-01-19T15:00:00Z,False,3,17,90,2,21,13,8,32,16,16,-11,-8
Barnes,84,3,234,2019-01-29T20:00:00Z,False,3,13,90,6,22,13,9,44,24,20,-22,-15
Barnes,84,3,241,2019-02-02T15:00:00Z,True,3,15,90,5,23,13,10,23,12,11,0,2
Barnes,84,3,250,2019-02-09T17:30:00Z,False,3,2,90,11,24,14,10,27,19,8,-3,-9
Barnes,84,3,262,2019-02-23T12:30:00Z,True,3,16,90,7,27,14,13,60,27,33,-33,-19
Barnes,84,3,278,2019-02-26T20:00:00Z,False,3,14,70,2,30,17,13,28,16,12,2,-3
Barnes,84,3,282,2019-03-02T15:00:00Z,True,3,6,90,6,30,17,13,30,13,17,0,0
Barnes,84,3,296,2019-03-10T12:00:00Z,False,3,11,85,2,30,17,13,70,38,32,-40,-25
Barnes,84,3,302,2019-03-16T15:00:00Z,True,3,10,90,2,30,17,13,38,20,18,-8,-1
Barnes,84,3,312,2019-03-30T15:00:00Z,True,3,19,90,2,30,17,13,44,24,20,-14,-3
Barnes,84,3,320,2019-04-06T14:00:00Z,False,3,1,90,3,33,20,13,38,26,12,-5,-13
Barnes,84,3,331,2019-04-13T14:00:00Z,True,3,4,90,1,36,20,16,28,20,8,8,12
Barnes,84,3,343,2019-04-22T19:00:00Z,False,3,5,90,9,39,23,16,66,38,28,-27,-22
Barnes,84,3,351,2019-04-28T13:05:00Z,True,3,12,90,2,40,23,17,89,51,38,-49,-15
Barnes,84,3,364,2019-05-03T19:00:00Z,False,3,7,71,2,40,23,17,50,31,19,-10,-14
Barnes,84,3,371,2019-05-12T14:00:00Z,True,3,0,90,5,40,23,17,67,45,22,-27,1
Wells,85,3,7,2018-08-12T12:30:00Z,False,3,15,0,0,0,0,0,0,0,0,0,0
Wells,85,3,11,2018-08-19T12:30:00Z,True,3,17,0,0,1,0,1,3,3,0,-2,0
Wells,85,3,22,2018-08-26T15:00:00Z,False,3,8,0,0,1,0,1,0,0,0,1,1
Wells,85,3,31,2018-09-02T15:00:00Z,True,3,13,0,0,1,0,1,3,3,0,-2,0
Wells,85,3,49,2018-09-16T12:30:00Z,False,3,19,0,0,1,0,1,5,2,3,-4,-1
Wells,85,3,52,2018-09-22T14:00:00Z,True,3,1,0,0,1,0,1,10,7,3,-9,-3
Wells,85,3,62,2018-09-30T15:00:00Z,False,3,4,0,0,4,3,1,2,1,1,2,0
Wells,85,3,71,2018-10-06T14:00:00Z,True,3,9,0,0,7,3,4,2,1,1,5,2
Wells,85,3,86,2018-10-20T14:00:00Z,False,3,12,0,0,8,4,4,20,12,8,-12,-8
Wells,85,3,91,2018-10-28T13:30:00Z,True,3,5,0,0,8,4,4,21,11,10,-13,-6
Wells,85,3,108,2018-11-03T15:00:00Z,False,3,18,0,0,8,4,4,8,4,4,0,0
Wells,85,3,115,2018-11-10T15:00:00Z,False,3,10,0,0,8,4,4,16,7,9,-8,-3
Wells,85,3,122,2018-11-26T20:30:00Z,True,3,14,0,0,9,4,5,9,6,3,0,1
Wells,85,3,133,2018-12-01T15:00:00Z,False,3,6,0,0,9,4,5,9,2,7,0,3
Wells,85,3,142,2018-12-05T19:45:00Z,True,3,11,0,0,9,4,5,36,19,17,-27,-13
Wells,85,3,152,2018-12-08T15:00:00Z,True,3,2,0,0,9,4,5,21,14,7,-12,-3
Wells,85,3,167,2018-12-15T15:00:00Z,False,3,16,0,0,12,7,5,36,12,24,-24,-7
Wells,85,3,170,2018-12-22T12:30:00Z,False,3,0,0,0,12,7,5,34,20,14,-22,-15
Wells,85,3,181,2018-12-26T15:00:00Z,True,3,7,0,0,12,7,5,24,18,6,-12,1
Wells,85,3,191,2018-12-30T14:15:00Z,True,3,18,0,0,12,7,5,27,13,14,-15,-7
Wells,85,3,205,2019-01-02T19:45:00Z,False,3,9,0,0,15,10,5,10,5,5,5,0
Wells,85,3,211,2019-01-12T15:00:00Z,True,3,8,0,0,18,10,8,14,12,2,4,8
Wells,85,3,228,2019-01-19T15:00:00Z,False,3,17,0,0,21,13,8,32,16,16,-11,-8
Wells,85,3,234,2019-01-29T20:00:00Z,False,3,13,0,0,22,13,9,44,24,20,-22,-15
Wells,85,3,241,2019-02-02T15:00:00Z,True,3,15,0,0,23,13,10,23,12,11,0,2
Wells,85,3,250,2019-02-09T17:30:00Z,False,3,2,0,0,24,14,10,27,19,8,-3,-9
Wells,85,3,262,2019-02-23T12:30:00Z,True,3,16,0,0,27,14,13,60,27,33,-33,-19
Wells,85,3,278,2019-02-26T20:00:00Z,False,3,14,0,0,30,17,13,28,16,12,2,-3
Wells,85,3,282,2019-03-02T15:00:00Z,True,3,6,0,0,30,17,13,30,13,17,0,0
Wells,85,3,296,2019-03-10T12:00:00Z,False,3,11,0,0,30,17,13,70,38,32,-40,-25
Wells,85,3,302,2019-03-16T15:00:00Z,True,3,10,0,0,30,17,13,38,20,18,-8,-1
Wells,85,3,312,2019-03-30T15:00:00Z,True,3,19,0,0,30,17,13,44,24,20,-14,-3
Wells,85,3,320,2019-04-06T14:00:00Z,False,3,1,0,0,33,20,13,38,26,12,-5,-13
Wells,85,3,331,2019-04-13T14:00:00Z,True,3,4,0,0,36,20,16,28,20,8,8,12
Wells,85,3,343,2019-04-22T19:00:00Z,False,3,5,0,0,39,23,16,66,38,28,-27,-22
Wells,85,3,351,2019-04-28T13:05:00Z,True,3,12,0,0,40,23,17,89,51,38,-49,-15
Wells,85,3,364,2019-05-03T19:00:00Z,False,3,7,0,0,40,23,17,50,31,19,-10,-14
Wells,85,3,371,2019-05-12T14:00:00Z,True,3,0,0,0,40,23,17,67,45,22,-27,1
Wood,86,3,7,2018-08-12T12:30:00Z,False,3,15,72,2,0,0,0,0,0,0,0,0
Wood,86,3,11,2018-08-19T12:30:00Z,True,3,17,64,2,1,0,1,3,3,0,-2,0
Wood,86,3,22,2018-08-26T15:00:00Z,False,3,8,65,2,1,0,1,0,0,0,1,1
Wood,86,3,31,2018-09-02T15:00:00Z,True,3,13,83,2,1,0,1,3,3,0,-2,0
Wood,86,3,49,2018-09-16T12:30:00Z,False,3,19,20,1,1,0,1,5,2,3,-4,-1
Wood,86,3,52,2018-09-22T14:00:00Z,True,3,1,30,1,1,0,1,10,7,3,-9,-3
Wood,86,3,62,2018-09-30T15:00:00Z,False,3,4,18,1,4,3,1,2,1,1,2,0
Wood,86,3,71,2018-10-06T14:00:00Z,True,3,9,29,1,7,3,4,2,1,1,5,2
Wood,86,3,86,2018-10-20T14:00:00Z,False,3,12,21,1,8,4,4,20,12,8,-12,-8
Wood,86,3,91,2018-10-28T13:30:00Z,True,3,5,31,1,8,4,4,21,11,10,-13,-6
Wood,86,3,108,2018-11-03T15:00:00Z,False,3,18,18,5,8,4,4,8,4,4,0,0
Wood,86,3,115,2018-11-10T15:00:00Z,False,3,10,90,2,8,4,4,16,7,9,-8,-3
Wood,86,3,122,2018-11-26T20:30:00Z,True,3,14,90,2,9,4,5,9,6,3,0,1
Wood,86,3,133,2018-12-01T15:00:00Z,False,3,6,79,2,9,4,5,9,2,7,0,3
Wood,86,3,142,2018-12-05T19:45:00Z,True,3,11,70,2,9,4,5,36,19,17,-27,-13
Wood,86,3,152,2018-12-08T15:00:00Z,True,3,2,90,2,9,4,5,21,14,7,-12,-3
Wood,86,3,167,2018-12-15T15:00:00Z,False,3,16,10,1,12,7,5,36,12,24,-24,-7
Wood,86,3,170,2018-12-22T12:30:00Z,False,3,0,76,1,12,7,5,34,20,14,-22,-15
Wood,86,3,181,2018-12-26T15:00:00Z,True,3,7,17,1,12,7,5,24,18,6,-12,1
Wood,86,3,191,2018-12-30T14:15:00Z,True,3,18,90,9,12,7,5,27,13,14,-15,-7
Wood,86,3,205,2019-01-02T19:45:00Z,False,3,9,90,5,15,10,5,10,5,5,5,0
Wood,86,3,211,2019-01-12T15:00:00Z,True,3,8,86,2,18,10,8,14,12,2,4,8
Wood,86,3,228,2019-01-19T15:00:00Z,False,3,17,90,2,21,13,8,32,16,16,-11,-8
Wood,86,3,234,2019-01-29T20:00:00Z,False,3,13,90,9,22,13,9,44,24,20,-22,-15
Wood,86,3,241,2019-02-02T15:00:00Z,True,3,15,75,2,23,13,10,23,12,11,0,2
Wood,86,3,250,2019-02-09T17:30:00Z,False,3,2,90,13,24,14,10,27,19,8,-3,-9
Wood,86,3,262,2019-02-23T12:30:00Z,True,3,16,90,9,27,14,13,60,27,33,-33,-19
Wood,86,3,278,2019-02-26T20:00:00Z,False,3,14,82,2,30,17,13,28,16,12,2,-3
Wood,86,3,282,2019-03-02T15:00:00Z,True,3,6,80,2,30,17,13,30,13,17,0,0
Wood,86,3,296,2019-03-10T12:00:00Z,False,3,11,78,2,30,17,13,70,38,32,-40,-25
Wood,86,3,302,2019-03-16T15:00:00Z,True,3,10,69,2,30,17,13,38,20,18,-8,-1
Wood,86,3,312,2019-03-30T15:00:00Z,True,3,19,90,5,30,17,13,44,24,20,-14,-3
Wood,86,3,320,2019-04-06T14:00:00Z,False,3,1,90,11,33,20,13,38,26,12,-5,-13
Wood,86,3,331,2019-04-13T14:00:00Z,True,3,4,90,13,36,20,16,28,20,8,8,12
Wood,86,3,343,2019-04-22T19:00:00Z,False,3,5,90,5,39,23,16,66,38,28,-27,-22
Wood,86,3,351,2019-04-28T13:05:00Z,True,3,12,71,2,40,23,17,89,51,38,-49,-15
Wood,86,3,364,2019-05-03T19:00:00Z,False,3,7,90,2,40,23,17,50,31,19,-10,-14
Wood,86,3,371,2019-05-12T14:00:00Z,True,3,0,76,2,40,23,17,67,45,22,-27,1
Etheridge,87,0,1,2018-08-11T14:00:00Z,False,4,1,90,6,0,0,0,0,0,0,0,0
Etheridge,87,0,12,2018-08-18T11:30:00Z,True,4,14,90,16,0,0,0,0,0,0,0,0
Etheridge,87,0,23,2018-08-25T14:00:00Z,False,4,9,90,6,1,1,0,0,0,0,1,0
Etheridge,87,0,32,2018-09-02T12:30:00Z,True,4,0,90,3,2,1,1,3,3,0,-1,1
Etheridge,87,0,41,2018-09-15T14:00:00Z,False,4,5,90,1,2,1,1,12,6,6,-10,-5
Etheridge,87,0,53,2018-09-22T14:00:00Z,True,4,12,90,1,2,1,1,13,9,4,-11,-3
Etheridge,87,0,62,2018-09-30T15:00:00Z,True,4,3,90,1,2,1,1,4,3,1,-2,0
Etheridge,87,0,78,2018-10-06T14:00:00Z,False,4,16,90,3,2,1,1,15,3,12,-13,-2
Etheridge,87,0,82,2018-10-20T14:00:00Z,True,4,8,90,1,2,1,1,5,4,1,-3,0
Etheridge,87,0,95,2018-10-27T14:00:00Z,False,4,11,90,0,5,4,1,23,10,13,-18,-9
Etheridge,87,0,102,2018-11-03T15:00:00Z,True,4,10,90,3,5,4,1,13,7,6,-8,-2
Etheridge,87,0,111,2018-11-10T12:30:00Z,True,4,2,90,2,5,4,1,14,10,4,-9,0
Etheridge,87,0,123,2018-11-24T15:00:00Z,False,4,7,90,3,8,7,1,19,13,6,-11,-12
Etheridge,87,0,131,2018-11-30T20:00:00Z,True,4,19,90,3,8,7,1,16,8,8,-8,-1
Etheridge,87,0,146,2018-12-04T19:45:00Z,False,4,18,90,3,11,10,1,15,7,8,-4,-6
Etheridge,87,0,153,2018-12-08T15:00:00Z,True,4,15,90,8,11,10,1,9,5,4,2,6
Etheridge,87,0,168,2018-12-15T15:00:00Z,False,4,17,90,2,14,13,1,21,12,9,-7,-11
Etheridge,87,0,172,2018-12-22T17:30:00Z,True,4,13,90,1,14,13,1,26,15,11,-12,2
Etheridge,87,0,182,2018-12-26T15:00:00Z,False,4,6,90,10,14,13,1,18,8,10,-4,-7
Etheridge,87,0,194,2018-12-29T15:00:00Z,False,4,10,90,15,15,13,2,28,14,14,-13,-12
Etheridge,87,0,202,2019-01-01T17:30:00Z,True,4,16,90,1,18,13,5,45,18,27,-27,-14
Etheridge,87,0,212,2019-01-12T15:00:00Z,True,4,9,90,10,18,13,5,10,5,5,8,8
Etheridge,87,0,226,2019-01-19T15:00:00Z,False,4,14,90,2,19,14,5,18,7,11,1,-2
Etheridge,87,0,230,2019-01-29T19:45:00Z,False,4,0,90,1,19,14,5,44,29,15,-25,-24
Etheridge,87,0,242,2019-02-02T17:30:00Z,True,4,1,90,6,19,14,5,33,24,9,-14,5
Etheridge,87,0,256,2019-02-09T15:00:00Z,False,4,15,90,5,22,17,5,24,12,12,-2,-7
Etheridge,87,0,263,2019-02-22T19:45:00Z,True,4,17,90,0,25,17,8,37,20,17,-12,0
Etheridge,87,0,271,2019-02-26T19:45:00Z,True,4,7,90,1,25,17,8,33,21,12,-8,5
Etheridge,87,0,289,2019-03-02T15:00:00Z,False,4,19,90,2,25,17,8,40,21,19,-15,-13
Etheridge,87,0,291,2019-03-09T15:00:00Z,True,4,18,90,7,25,17,8,39,24,15,-14,2
Etheridge,87,0,313,2019-03-31T13:05:00Z,True,4,5,90,1,28,20,8,57,32,25,-29,-5
Etheridge,87,0,324,2019-04-03T18:45:00Z,False,4,12,90,4,28,20,8,77,45,32,-49,-37
Etheridge,87,0,331,2019-04-13T14:00:00Z,False,4,3,90,3,28,20,8,36,20,16,-8,-12
Etheridge,87,0,301,2019-04-16T18:45:00Z,False,4,2,90,6,28,20,8,33,22,11,-5,-14
Etheridge,87,0,342,2019-04-21T15:00:00Z,True,4,11,90,2,31,20,11,85,47,38,-54,-18
Etheridge,87,0,353,2019-04-27T14:00:00Z,False,4,8,90,2,31,20,11,23,18,5,8,-7
Etheridge,87,0,362,2019-05-04T16:30:00Z,True,4,6,90,2,31,20,11,43,17,26,-12,-6
Etheridge,87,0,376,2019-05-12T14:00:00Z,False,4,13,90,11,31,20,11,66,36,30,-35,-25
Smithies,88,0,1,2018-08-11T14:00:00Z,False,4,1,0,0,0,0,0,0,0,0,0,0
Smithies,88,0,12,2018-08-18T11:30:00Z,True,4,14,0,0,0,0,0,0,0,0,0,0
Smithies,88,0,23,2018-08-25T14:00:00Z,False,4,9,0,0,1,1,0,0,0,0,1,0
Smithies,88,0,32,2018-09-02T12:30:00Z,True,4,0,0,0,2,1,1,3,3,0,-1,1
Smithies,88,0,41,2018-09-15T14:00:00Z,False,4,5,0,0,2,1,1,12,6,6,-10,-5
Smithies,88,0,53,2018-09-22T14:00:00Z,True,4,12,0,0,2,1,1,13,9,4,-11,-3
Smithies,88,0,62,2018-09-30T15:00:00Z,True,4,3,0,0,2,1,1,4,3,1,-2,0
Smithies,88,0,78,2018-10-06T14:00:00Z,False,4,16,0,0,2,1,1,15,3,12,-13,-2
Smithies,88,0,82,2018-10-20T14:00:00Z,True,4,8,0,0,2,1,1,5,4,1,-3,0
Smithies,88,0,95,2018-10-27T14:00:00Z,False,4,11,0,0,5,4,1,23,10,13,-18,-9
Smithies,88,0,102,2018-11-03T15:00:00Z,True,4,10,0,0,5,4,1,13,7,6,-8,-2
Smithies,88,0,111,2018-11-10T12:30:00Z,True,4,2,0,0,5,4,1,14,10,4,-9,0
Smithies,88,0,123,2018-11-24T15:00:00Z,False,4,7,0,0,8,7,1,19,13,6,-11,-12
Smithies,88,0,131,2018-11-30T20:00:00Z,True,4,19,0,0,8,7,1,16,8,8,-8,-1
Smithies,88,0,146,2018-12-04T19:45:00Z,False,4,18,0,0,11,10,1,15,7,8,-4,-6
Smithies,88,0,153,2018-12-08T15:00:00Z,True,4,15,0,0,11,10,1,9,5,4,2,6
Smithies,88,0,168,2018-12-15T15:00:00Z,False,4,17,0,0,14,13,1,21,12,9,-7,-11
Smithies,88,0,172,2018-12-22T17:30:00Z,True,4,13,0,0,14,13,1,26,15,11,-12,2
Smithies,88,0,182,2018-12-26T15:00:00Z,False,4,6,0,0,14,13,1,18,8,10,-4,-7
Smithies,88,0,194,2018-12-29T15:00:00Z,False,4,10,0,0,15,13,2,28,14,14,-13,-12
Smithies,88,0,202,2019-01-01T17:30:00Z,True,4,16,0,0,18,13,5,45,18,27,-27,-14
Smithies,88,0,212,2019-01-12T15:00:00Z,True,4,9,0,0,18,13,5,10,5,5,8,8
Smithies,88,0,226,2019-01-19T15:00:00Z,False,4,14,0,0,19,14,5,18,7,11,1,-2
Smithies,88,0,230,2019-01-29T19:45:00Z,False,4,0,0,0,19,14,5,44,29,15,-25,-24
Smithies,88,0,242,2019-02-02T17:30:00Z,True,4,1,0,0,19,14,5,33,24,9,-14,5
Smithies,88,0,256,2019-02-09T15:00:00Z,False,4,15,0,0,22,17,5,24,12,12,-2,-7
Smithies,88,0,263,2019-02-22T19:45:00Z,True,4,17,0,0,25,17,8,37,20,17,-12,0
Smithies,88,0,271,2019-02-26T19:45:00Z,True,4,7,0,0,25,17,8,33,21,12,-8,5
Smithies,88,0,289,2019-03-02T15:00:00Z,False,4,19,0,0,25,17,8,40,21,19,-15,-13
Smithies,88,0,291,2019-03-09T15:00:00Z,True,4,18,0,0,25,17,8,39,24,15,-14,2
Smithies,88,0,313,2019-03-31T13:05:00Z,True,4,5,0,0,28,20,8,57,32,25,-29,-5
Smithies,88,0,324,2019-04-03T18:45:00Z,False,4,12,0,0,28,20,8,77,45,32,-49,-37
Smithies,88,0,331,2019-04-13T14:00:00Z,False,4,3,0,0,28,20,8,36,20,16,-8,-12
Smithies,88,0,301,2019-04-16T18:45:00Z,False,4,2,0,0,28,20,8,33,22,11,-5,-14
Smithies,88,0,342,2019-04-21T15:00:00Z,True,4,11,0,0,31,20,11,85,47,38,-54,-18
Smithies,88,0,353,2019-04-27T14:00:00Z,False,4,8,0,0,31,20,11,23,18,5,8,-7
Smithies,88,0,362,2019-05-04T16:30:00Z,True,4,6,0,0,31,20,11,43,17,26,-12,-6
Smithies,88,0,376,2019-05-12T14:00:00Z,False,4,13,0,0,31,20,11,66,36,30,-35,-25
Morrison,89,1,1,2018-08-11T14:00:00Z,False,4,1,90,1,0,0,0,0,0,0,0,0
Morrison,89,1,12,2018-08-18T11:30:00Z,True,4,14,90,6,0,0,0,0,0,0,0,0
Morrison,89,1,23,2018-08-25T14:00:00Z,False,4,9,90,6,1,1,0,0,0,0,1,0
Morrison,89,1,32,2018-09-02T12:30:00Z,True,4,0,90,4,2,1,1,3,3,0,-1,1
Morrison,89,1,41,2018-09-15T14:00:00Z,False,4,5,90,3,2,1,1,12,6,6,-10,-5
Morrison,89,1,53,2018-09-22T14:00:00Z,True,4,12,90,0,2,1,1,13,9,4,-11,-3
Morrison,89,1,62,2018-09-30T15:00:00Z,True,4,3,90,1,2,1,1,4,3,1,-2,0
Morrison,89,1,78,2018-10-06T14:00:00Z,False,4,16,90,2,2,1,1,15,3,12,-13,-2
Morrison,89,1,82,2018-10-20T14:00:00Z,True,4,8,90,0,2,1,1,5,4,1,-3,0
Morrison,89,1,95,2018-10-27T14:00:00Z,False,4,11,90,0,5,4,1,23,10,13,-18,-9
Morrison,89,1,102,2018-11-03T15:00:00Z,True,4,10,90,2,5,4,1,13,7,6,-8,-2
Morrison,89,1,111,2018-11-10T12:30:00Z,True,4,2,69,2,5,4,1,14,10,4,-9,0
Morrison,89,1,123,2018-11-24T15:00:00Z,False,4,7,90,2,8,7,1,19,13,6,-11,-12
Morrison,89,1,131,2018-11-30T20:00:00Z,True,4,19,90,7,8,7,1,16,8,8,-8,-1
Morrison,89,1,146,2018-12-04T19:45:00Z,False,4,18,90,4,11,10,1,15,7,8,-4,-6
Morrison,89,1,153,2018-12-08T15:00:00Z,True,4,15,90,5,11,10,1,9,5,4,2,6
Morrison,89,1,168,2018-12-15T15:00:00Z,False,4,17,90,1,14,13,1,21,12,9,-7,-11
Morrison,89,1,172,2018-12-22T17:30:00Z,True,4,13,90,0,14,13,1,26,15,11,-12,2
Morrison,89,1,182,2018-12-26T15:00:00Z,False,4,6,90,6,14,13,1,18,8,10,-4,-7
Morrison,89,1,194,2018-12-29T15:00:00Z,False,4,10,90,5,15,13,2,28,14,14,-13,-12
Morrison,89,1,202,2019-01-01T17:30:00Z,True,4,16,90,1,18,13,5,45,18,27,-27,-14
Morrison,89,1,212,2019-01-12T15:00:00Z,True,4,9,90,6,18,13,5,10,5,5,8,8
Morrison,89,1,226,2019-01-19T15:00:00Z,False,4,14,0,0,19,14,5,18,7,11,1,-2
Morrison,89,1,230,2019-01-29T19:45:00Z,False,4,0,0,0,19,14,5,44,29,15,-25,-24
Morrison,89,1,242,2019-02-02T17:30:00Z,True,4,1,0,0,19,14,5,33,24,9,-14,5
Morrison,89,1,256,2019-02-09T15:00:00Z,False,4,15,0,0,22,17,5,24,12,12,-2,-7
Morrison,89,1,263,2019-02-22T19:45:00Z,True,4,17,90,0,25,17,8,37,20,17,-12,0
Morrison,89,1,271,2019-02-26T19:45:00Z,True,4,7,90,0,25,17,8,33,21,12,-8,5
Morrison,89,1,289,2019-03-02T15:00:00Z,False,4,19,90,1,25,17,8,40,21,19,-15,-13
Morrison,89,1,291,2019-03-09T15:00:00Z,True,4,18,90,5,25,17,8,39,24,15,-14,2
Morrison,89,1,313,2019-03-31T13:05:00Z,True,4,5,90,1,28,20,8,57,32,25,-29,-5
Morrison,89,1,324,2019-04-03T18:45:00Z,False,4,12,90,1,28,20,8,77,45,32,-49,-37
Morrison,89,1,331,2019-04-13T14:00:00Z,False,4,3,90,1,28,20,8,36,20,16,-8,-12
Morrison,89,1,301,2019-04-16T18:45:00Z,False,4,2,90,15,28,20,8,33,22,11,-5,-14
Morrison,89,1,342,2019-04-21T15:00:00Z,True,4,11,90,1,31,20,11,85,47,38,-54,-18
Morrison,89,1,353,2019-04-27T14:00:00Z,False,4,8,90,2,31,20,11,23,18,5,8,-7
Morrison,89,1,362,2019-05-04T16:30:00Z,True,4,6,90,1,31,20,11,43,17,26,-12,-6
Morrison,89,1,376,2019-05-12T14:00:00Z,False,4,13,90,5,31,20,11,66,36,30,-35,-25
Bamba,90,1,1,2018-08-11T14:00:00Z,False,4,1,90,1,0,0,0,0,0,0,0,0
Bamba,90,1,12,2018-08-18T11:30:00Z,True,4,14,90,6,0,0,0,0,0,0,0,0
Bamba,90,1,23,2018-08-25T14:00:00Z,False,4,9,90,8,1,1,0,0,0,0,1,0
Bamba,90,1,32,2018-09-02T12:30:00Z,True,4,0,90,1,2,1,1,3,3,0,-1,1
Bamba,90,1,41,2018-09-15T14:00:00Z,False,4,5,90,6,2,1,1,12,6,6,-10,-5
Bamba,90,1,53,2018-09-22T14:00:00Z,True,4,12,0,0,2,1,1,13,9,4,-11,-3
Bamba,90,1,62,2018-09-30T15:00:00Z,True,4,3,90,1,2,1,1,4,3,1,-2,0
Bamba,90,1,78,2018-10-06T14:00:00Z,False,4,16,90,2,2,1,1,15,3,12,-13,-2
Bamba,90,1,82,2018-10-20T14:00:00Z,True,4,8,90,3,2,1,1,5,4,1,-3,0
Bamba,90,1,95,2018-10-27T14:00:00Z,False,4,11,90,0,5,4,1,23,10,13,-18,-9
Bamba,90,1,102,2018-11-03T15:00:00Z,True,4,10,90,2,5,4,1,13,7,6,-8,-2
Bamba,90,1,111,2018-11-10T12:30:00Z,True,4,2,90,10,5,4,1,14,10,4,-9,0
Bamba,90,1,123,2018-11-24T15:00:00Z,False,4,7,90,2,8,7,1,19,13,6,-11,-12
Bamba,90,1,131,2018-11-30T20:00:00Z,True,4,19,90,2,8,7,1,16,8,8,-8,-1
Bamba,90,1,146,2018-12-04T19:45:00Z,False,4,18,90,0,11,10,1,15,7,8,-4,-6
Bamba,90,1,153,2018-12-08T15:00:00Z,True,4,15,90,9,11,10,1,9,5,4,2,6
Bamba,90,1,168,2018-12-15T15:00:00Z,False,4,17,90,1,14,13,1,21,12,9,-7,-11
Bamba,90,1,172,2018-12-22T17:30:00Z,True,4,13,90,0,14,13,1,26,15,11,-12,2
Bamba,90,1,182,2018-12-26T15:00:00Z,False,4,6,90,5,14,13,1,18,8,10,-4,-7
Bamba,90,1,194,2018-12-29T15:00:00Z,False,4,10,90,7,15,13,2,28,14,14,-13,-12
Bamba,90,1,202,2019-01-01T17:30:00Z,True,4,16,90,0,18,13,5,45,18,27,-27,-14
Bamba,90,1,212,2019-01-12T15:00:00Z,True,4,9,90,8,18,13,5,10,5,5,8,8
Bamba,90,1,226,2019-01-19T15:00:00Z,False,4,14,90,1,19,14,5,18,7,11,1,-2
Bamba,90,1,230,2019-01-29T19:45:00Z,False,4,0,90,1,19,14,5,44,29,15,-25,-24
Bamba,90,1,242,2019-02-02T17:30:00Z,True,4,1,90,6,19,14,5,33,24,9,-14,5
Bamba,90,1,256,2019-02-09T15:00:00Z,False,4,15,90,7,22,17,5,24,12,12,-2,-7
Bamba,90,1,263,2019-02-22T19:45:00Z,True,4,17,90,6,25,17,8,37,20,17,-12,0
Bamba,90,1,271,2019-02-26T19:45:00Z,True,4,7,90,1,25,17,8,33,21,12,-8,5
Bamba,90,1,289,2019-03-02T15:00:00Z,False,4,19,45,-1,25,17,8,40,21,19,-15,-13
Bamba,90,1,291,2019-03-09T15:00:00Z,True,4,18,0,0,25,17,8,39,24,15,-14,2
Bamba,90,1,313,2019-03-31T13:05:00Z,True,4,5,0,0,28,20,8,57,32,25,-29,-5
Bamba,90,1,324,2019-04-03T18:45:00Z,False,4,12,0,0,28,20,8,77,45,32,-49,-37
Bamba,90,1,331,2019-04-13T14:00:00Z,False,4,3,0,0,28,20,8,36,20,16,-8,-12
Bamba,90,1,301,2019-04-16T18:45:00Z,False,4,2,0,0,28,20,8,33,22,11,-5,-14
Bamba,90,1,342,2019-04-21T15:00:00Z,True,4,11,0,0,31,20,11,85,47,38,-54,-18
Bamba,90,1,353,2019-04-27T14:00:00Z,False,4,8,0,0,31,20,11,23,18,5,8,-7
Bamba,90,1,362,2019-05-04T16:30:00Z,True,4,6,0,0,31,20,11,43,17,26,-12,-6
Bamba,90,1,376,2019-05-12T14:00:00Z,False,4,13,0,0,31,20,11,66,36,30,-35,-25
Ecuele Manga,91,1,1,2018-08-11T14:00:00Z,False,4,1,90,1,0,0,0,0,0,0,0,0
Ecuele Manga,91,1,12,2018-08-18T11:30:00Z,True,4,14,90,6,0,0,0,0,0,0,0,0
Ecuele Manga,91,1,23,2018-08-25T14:00:00Z,False,4,9,90,6,1,1,0,0,0,0,1,0
Ecuele Manga,91,1,32,2018-09-02T12:30:00Z,True,4,0,90,1,2,1,1,3,3,0,-1,1
Ecuele Manga,91,1,41,2018-09-15T14:00:00Z,False,4,5,90,0,2,1,1,12,6,6,-10,-5
Ecuele Manga,91,1,53,2018-09-22T14:00:00Z,True,4,12,90,0,2,1,1,13,9,4,-11,-3
Ecuele Manga,91,1,62,2018-09-30T15:00:00Z,True,4,3,90,4,2,1,1,4,3,1,-2,0
Ecuele Manga,91,1,78,2018-10-06T14:00:00Z,False,4,16,90,2,2,1,1,15,3,12,-13,-2
Ecuele Manga,91,1,82,2018-10-20T14:00:00Z,True,4,8,90,1,2,1,1,5,4,1,-3,0
Ecuele Manga,91,1,95,2018-10-27T14:00:00Z,False,4,11,90,0,5,4,1,23,10,13,-18,-9
Ecuele Manga,91,1,102,2018-11-03T15:00:00Z,True,4,10,90,2,5,4,1,13,7,6,-8,-2
Ecuele Manga,91,1,111,2018-11-10T12:30:00Z,True,4,2,90,2,5,4,1,14,10,4,-9,0
Ecuele Manga,91,1,123,2018-11-24T15:00:00Z,False,4,7,90,2,8,7,1,19,13,6,-11,-12
Ecuele Manga,91,1,131,2018-11-30T20:00:00Z,True,4,19,90,2,8,7,1,16,8,8,-8,-1
Ecuele Manga,91,1,146,2018-12-04T19:45:00Z,False,4,18,90,1,11,10,1,15,7,8,-4,-6
Ecuele Manga,91,1,153,2018-12-08T15:00:00Z,True,4,15,90,6,11,10,1,9,5,4,2,6
Ecuele Manga,91,1,168,2018-12-15T15:00:00Z,False,4,17,90,1,14,13,1,21,12,9,-7,-11
Ecuele Manga,91,1,172,2018-12-22T17:30:00Z,True,4,13,90,0,14,13,1,26,15,11,-12,2
Ecuele Manga,91,1,182,2018-12-26T15:00:00Z,False,4,6,90,6,14,13,1,18,8,10,-4,-7
Ecuele Manga,91,1,194,2018-12-29T15:00:00Z,False,4,10,90,6,15,13,2,28,14,14,-13,-12
Ecuele Manga,91,1,202,2019-01-01T17:30:00Z,True,4,16,90,1,18,13,5,45,18,27,-27,-14
Ecuele Manga,91,1,212,2019-01-12T15:00:00Z,True,4,9,90,7,18,13,5,10,5,5,8,8
Ecuele Manga,91,1,226,2019-01-19T15:00:00Z,False,4,14,90,1,19,14,5,18,7,11,1,-2
Ecuele Manga,91,1,230,2019-01-29T19:45:00Z,False,4,0,90,1,19,14,5,44,29,15,-25,-24
Ecuele Manga,91,1,242,2019-02-02T17:30:00Z,True,4,1,90,7,19,14,5,33,24,9,-14,5
Ecuele Manga,91,1,256,2019-02-09T15:00:00Z,False,4,15,90,2,22,17,5,24,12,12,-2,-7
Ecuele Manga,91,1,263,2019-02-22T19:45:00Z,True,4,17,90,0,25,17,8,37,20,17,-12,0
Ecuele Manga,91,1,271,2019-02-26T19:45:00Z,True,4,7,90,1,25,17,8,33,21,12,-8,5
Ecuele Manga,91,1,289,2019-03-02T15:00:00Z,False,4,19,45,1,25,17,8,40,21,19,-15,-13
Ecuele Manga,91,1,291,2019-03-09T15:00:00Z,True,4,18,90,6,25,17,8,39,24,15,-14,2
Ecuele Manga,91,1,313,2019-03-31T13:05:00Z,True,4,5,90,1,28,20,8,57,32,25,-29,-5
Ecuele Manga,91,1,324,2019-04-03T18:45:00Z,False,4,12,90,1,28,20,8,77,45,32,-49,-37
Ecuele Manga,91,1,331,2019-04-13T14:00:00Z,False,4,3,90,1,28,20,8,36,20,16,-8,-12
Ecuele Manga,91,1,301,2019-04-16T18:45:00Z,False,4,2,90,7,28,20,8,33,22,11,-5,-14
Ecuele Manga,91,1,342,2019-04-21T15:00:00Z,True,4,11,90,1,31,20,11,85,47,38,-54,-18
Ecuele Manga,91,1,353,2019-04-27T14:00:00Z,False,4,8,90,2,31,20,11,23,18,5,8,-7
Ecuele Manga,91,1,362,2019-05-04T16:30:00Z,True,4,6,90,1,31,20,11,43,17,26,-12,-6
Ecuele Manga,91,1,376,2019-05-12T14:00:00Z,False,4,13,90,7,31,20,11,66,36,30,-35,-25
Connolly,92,1,1,2018-08-11T14:00:00Z,False,4,1,0,0,0,0,0,0,0,0,0,0
Connolly,92,1,12,2018-08-18T11:30:00Z,True,4,14,0,0,0,0,0,0,0,0,0,0
Connolly,92,1,23,2018-08-25T14:00:00Z,False,4,9,0,0,1,1,0,0,0,0,1,0
Connolly,92,1,32,2018-09-02T12:30:00Z,True,4,0,0,0,2,1,1,3,3,0,-1,1
Connolly,92,1,41,2018-09-15T14:00:00Z,False,4,5,0,0,2,1,1,12,6,6,-10,-5
Connolly,92,1,53,2018-09-22T14:00:00Z,True,4,12,0,0,2,1,1,13,9,4,-11,-3
Connolly,92,1,62,2018-09-30T15:00:00Z,True,4,3,0,0,2,1,1,4,3,1,-2,0
Connolly,92,1,78,2018-10-06T14:00:00Z,False,4,16,0,0,2,1,1,15,3,12,-13,-2
Connolly,92,1,82,2018-10-20T14:00:00Z,True,4,8,0,0,2,1,1,5,4,1,-3,0
Connolly,92,1,95,2018-10-27T14:00:00Z,False,4,11,0,0,5,4,1,23,10,13,-18,-9
Connolly,92,1,102,2018-11-03T15:00:00Z,True,4,10,0,0,5,4,1,13,7,6,-8,-2
Connolly,92,1,111,2018-11-10T12:30:00Z,True,4,2,0,0,5,4,1,14,10,4,-9,0
Connolly,92,1,123,2018-11-24T15:00:00Z,False,4,7,0,0,8,7,1,19,13,6,-11,-12
Connolly,92,1,131,2018-11-30T20:00:00Z,True,4,19,0,0,8,7,1,16,8,8,-8,-1
Connolly,92,1,146,2018-12-04T19:45:00Z,False,4,18,0,0,11,10,1,15,7,8,-4,-6
Connolly,92,1,153,2018-12-08T15:00:00Z,True,4,15,0,0,11,10,1,9,5,4,2,6
Connolly,92,1,168,2018-12-15T15:00:00Z,False,4,17,0,0,14,13,1,21,12,9,-7,-11
Connolly,92,1,172,2018-12-22T17:30:00Z,True,4,13,0,0,14,13,1,26,15,11,-12,2
Connolly,92,1,182,2018-12-26T15:00:00Z,False,4,6,0,0,14,13,1,18,8,10,-4,-7
Connolly,92,1,194,2018-12-29T15:00:00Z,False,4,10,0,0,15,13,2,28,14,14,-13,-12
Connolly,92,1,202,2019-01-01T17:30:00Z,True,4,16,0,0,18,13,5,45,18,27,-27,-14
Connolly,92,1,212,2019-01-12T15:00:00Z,True,4,9,0,0,18,13,5,10,5,5,8,8
Connolly,92,1,226,2019-01-19T15:00:00Z,False,4,14,0,0,19,14,5,18,7,11,1,-2
Connolly,92,1,230,2019-01-29T19:45:00Z,False,4,0,0,0,19,14,5,44,29,15,-25,-24
Connolly,92,1,242,2019-02-02T17:30:00Z,True,4,1,0,0,19,14,5,33,24,9,-14,5
Connolly,92,1,256,2019-02-09T15:00:00Z,False,4,15,0,0,22,17,5,24,12,12,-2,-7
Connolly,92,1,263,2019-02-22T19:45:00Z,True,4,17,0,0,25,17,8,37,20,17,-12,0
Connolly,92,1,271,2019-02-26T19:45:00Z,True,4,7,0,0,25,17,8,33,21,12,-8,5
Connolly,92,1,289,2019-03-02T15:00:00Z,False,4,19,0,0,25,17,8,40,21,19,-15,-13
Connolly,92,1,291,2019-03-09T15:00:00Z,True,4,18,0,0,25,17,8,39,24,15,-14,2
Connolly,92,1,313,2019-03-31T13:05:00Z,True,4,5,0,0,28,20,8,57,32,25,-29,-5
Connolly,92,1,324,2019-04-03T18:45:00Z,False,4,12,0,0,28,20,8,77,45,32,-49,-37
Connolly,92,1,331,2019-04-13T14:00:00Z,False,4,3,0,0,28,20,8,36,20,16,-8,-12
Connolly,92,1,301,2019-04-16T18:45:00Z,False,4,2,0,0,28,20,8,33,22,11,-5,-14
Connolly,92,1,342,2019-04-21T15:00:00Z,True,4,11,0,0,31,20,11,85,47,38,-54,-18
Connolly,92,1,353,2019-04-27T14:00:00Z,False,4,8,0,0,31,20,11,23,18,5,8,-7
Connolly,92,1,362,2019-05-04T16:30:00Z,True,4,6,0,0,31,20,11,43,17,26,-12,-6
Connolly,92,1,376,2019-05-12T14:00:00Z,False,4,13,0,0,31,20,11,66,36,30,-35,-25
Bennett,93,1,1,2018-08-11T14:00:00Z,False,4,1,90,1,0,0,0,0,0,0,0,0
Bennett,93,1,12,2018-08-18T11:30:00Z,True,4,14,90,8,0,0,0,0,0,0,0,0
Bennett,93,1,23,2018-08-25T14:00:00Z,False,4,9,90,6,1,1,0,0,0,0,1,0
Bennett,93,1,32,2018-09-02T12:30:00Z,True,4,0,90,4,2,1,1,3,3,0,-1,1
Bennett,93,1,41,2018-09-15T14:00:00Z,False,4,5,90,0,2,1,1,12,6,6,-10,-5
Bennett,93,1,53,2018-09-22T14:00:00Z,True,4,12,0,0,2,1,1,13,9,4,-11,-3
Bennett,93,1,62,2018-09-30T15:00:00Z,True,4,3,0,0,2,1,1,4,3,1,-2,0
Bennett,93,1,78,2018-10-06T14:00:00Z,False,4,16,90,2,2,1,1,15,3,12,-13,-2
Bennett,93,1,82,2018-10-20T14:00:00Z,True,4,8,90,1,2,1,1,5,4,1,-3,0
Bennett,93,1,95,2018-10-27T14:00:00Z,False,4,11,90,0,5,4,1,23,10,13,-18,-9
Bennett,93,1,102,2018-11-03T15:00:00Z,True,4,10,90,2,5,4,1,13,7,6,-8,-2
Bennett,93,1,111,2018-11-10T12:30:00Z,True,4,2,0,0,5,4,1,14,10,4,-9,0
Bennett,93,1,123,2018-11-24T15:00:00Z,False,4,7,0,0,8,7,1,19,13,6,-11,-12
Bennett,93,1,131,2018-11-30T20:00:00Z,True,4,19,0,0,8,7,1,16,8,8,-8,-1
Bennett,93,1,146,2018-12-04T19:45:00Z,False,4,18,90,1,11,10,1,15,7,8,-4,-6
Bennett,93,1,153,2018-12-08T15:00:00Z,True,4,15,90,5,11,10,1,9,5,4,2,6
Bennett,93,1,168,2018-12-15T15:00:00Z,False,4,17,58,0,14,13,1,21,12,9,-7,-11
Bennett,93,1,172,2018-12-22T17:30:00Z,True,4,13,0,0,14,13,1,26,15,11,-12,2
Bennett,93,1,182,2018-12-26T15:00:00Z,False,4,6,90,6,14,13,1,18,8,10,-4,-7
Bennett,93,1,194,2018-12-29T15:00:00Z,False,4,10,0,0,15,13,2,28,14,14,-13,-12
Bennett,93,1,202,2019-01-01T17:30:00Z,True,4,16,0,0,18,13,5,45,18,27,-27,-14
Bennett,93,1,212,2019-01-12T15:00:00Z,True,4,9,90,5,18,13,5,10,5,5,8,8
Bennett,93,1,226,2019-01-19T15:00:00Z,False,4,14,90,1,19,14,5,18,7,11,1,-2
Bennett,93,1,230,2019-01-29T19:45:00Z,False,4,0,90,1,19,14,5,44,29,15,-25,-24
Bennett,93,1,242,2019-02-02T17:30:00Z,True,4,1,90,8,19,14,5,33,24,9,-14,5
Bennett,93,1,256,2019-02-09T15:00:00Z,False,4,15,90,2,22,17,5,24,12,12,-2,-7
Bennett,93,1,263,2019-02-22T19:45:00Z,True,4,17,90,0,25,17,8,37,20,17,-12,0
Bennett,93,1,271,2019-02-26T19:45:00Z,True,4,7,90,1,25,17,8,33,21,12,-8,5
Bennett,93,1,289,2019-03-02T15:00:00Z,False,4,19,90,1,25,17,8,40,21,19,-15,-13
Bennett,93,1,291,2019-03-09T15:00:00Z,True,4,18,61,6,25,17,8,39,24,15,-14,2
Bennett,93,1,313,2019-03-31T13:05:00Z,True,4,5,90,1,28,20,8,57,32,25,-29,-5
Bennett,93,1,324,2019-04-03T18:45:00Z,False,4,12,90,0,28,20,8,77,45,32,-49,-37
Bennett,93,1,331,2019-04-13T14:00:00Z,False,4,3,90,0,28,20,8,36,20,16,-8,-12
Bennett,93,1,301,2019-04-16T18:45:00Z,False,4,2,90,5,28,20,8,33,22,11,-5,-14
Bennett,93,1,342,2019-04-21T15:00:00Z,True,4,11,90,1,31,20,11,85,47,38,-54,-18
Bennett,93,1,353,2019-04-27T14:00:00Z,False,4,8,90,2,31,20,11,23,18,5,8,-7
Bennett,93,1,362,2019-05-04T16:30:00Z,True,4,6,90,1,31,20,11,43,17,26,-12,-6
Bennett,93,1,376,2019-05-12T14:00:00Z,False,4,13,90,6,31,20,11,66,36,30,-35,-25
Peltier,94,1,1,2018-08-11T14:00:00Z,False,4,1,90,0,0,0,0,0,0,0,0,0
Peltier,94,1,12,2018-08-18T11:30:00Z,True,4,14,0,0,0,0,0,0,0,0,0,0
Peltier,94,1,23,2018-08-25T14:00:00Z,False,4,9,0,0,1,1,0,0,0,0,1,0
Peltier,94,1,32,2018-09-02T12:30:00Z,True,4,0,0,0,2,1,1,3,3,0,-1,1
Peltier,94,1,41,2018-09-15T14:00:00Z,False,4,5,0,0,2,1,1,12,6,6,-10,-5
Peltier,94,1,53,2018-09-22T14:00:00Z,True,4,12,50,0,2,1,1,13,9,4,-11,-3
Peltier,94,1,62,2018-09-30T15:00:00Z,True,4,3,0,0,2,1,1,4,3,1,-2,0
Peltier,94,1,78,2018-10-06T14:00:00Z,False,4,16,0,0,2,1,1,15,3,12,-13,-2
Peltier,94,1,82,2018-10-20T14:00:00Z,True,4,8,0,0,2,1,1,5,4,1,-3,0
Peltier,94,1,95,2018-10-27T14:00:00Z,False,4,11,0,0,5,4,1,23,10,13,-18,-9
Peltier,94,1,102,2018-11-03T15:00:00Z,True,4,10,0,0,5,4,1,13,7,6,-8,-2
Peltier,94,1,111,2018-11-10T12:30:00Z,True,4,2,20,1,5,4,1,14,10,4,-9,0
Peltier,94,1,123,2018-11-24T15:00:00Z,False,4,7,0,0,8,7,1,19,13,6,-11,-12
Peltier,94,1,131,2018-11-30T20:00:00Z,True,4,19,0,0,8,7,1,16,8,8,-8,-1
Peltier,94,1,146,2018-12-04T19:45:00Z,False,4,18,0,0,11,10,1,15,7,8,-4,-6
Peltier,94,1,153,2018-12-08T15:00:00Z,True,4,15,0,0,11,10,1,9,5,4,2,6
Peltier,94,1,168,2018-12-15T15:00:00Z,False,4,17,31,1,14,13,1,21,12,9,-7,-11
Peltier,94,1,172,2018-12-22T17:30:00Z,True,4,13,0,0,14,13,1,26,15,11,-12,2
Peltier,94,1,182,2018-12-26T15:00:00Z,False,4,6,90,6,14,13,1,18,8,10,-4,-7
Peltier,94,1,194,2018-12-29T15:00:00Z,False,4,10,1,1,15,13,2,28,14,14,-13,-12
Peltier,94,1,202,2019-01-01T17:30:00Z,True,4,16,0,0,18,13,5,45,18,27,-27,-14
Peltier,94,1,212,2019-01-12T15:00:00Z,True,4,9,0,0,18,13,5,10,5,5,8,8
Peltier,94,1,226,2019-01-19T15:00:00Z,False,4,14,90,1,19,14,5,18,7,11,1,-2
Peltier,94,1,230,2019-01-29T19:45:00Z,False,4,0,90,1,19,14,5,44,29,15,-25,-24
Peltier,94,1,242,2019-02-02T17:30:00Z,True,4,1,90,6,19,14,5,33,24,9,-14,5
Peltier,94,1,256,2019-02-09T15:00:00Z,False,4,15,90,2,22,17,5,24,12,12,-2,-7
Peltier,94,1,263,2019-02-22T19:45:00Z,True,4,17,0,0,25,17,8,37,20,17,-12,0
Peltier,94,1,271,2019-02-26T19:45:00Z,True,4,7,0,0,25,17,8,33,21,12,-8,5
Peltier,94,1,289,2019-03-02T15:00:00Z,False,4,19,90,0,25,17,8,40,21,19,-15,-13
Peltier,94,1,291,2019-03-09T15:00:00Z,True,4,18,90,7,25,17,8,39,24,15,-14,2
Peltier,94,1,313,2019-03-31T13:05:00Z,True,4,5,90,1,28,20,8,57,32,25,-29,-5
Peltier,94,1,324,2019-04-03T18:45:00Z,False,4,12,90,0,28,20,8,77,45,32,-49,-37
Peltier,94,1,331,2019-04-13T14:00:00Z,False,4,3,90,0,28,20,8,36,20,16,-8,-12
Peltier,94,1,301,2019-04-16T18:45:00Z,False,4,2,90,6,28,20,8,33,22,11,-5,-14
Peltier,94,1,342,2019-04-21T15:00:00Z,True,4,11,90,1,31,20,11,85,47,38,-54,-18
Peltier,94,1,353,2019-04-27T14:00:00Z,False,4,8,90,2,31,20,11,23,18,5,8,-7
Peltier,94,1,362,2019-05-04T16:30:00Z,True,4,6,90,1,31,20,11,43,17,26,-12,-6
Peltier,94,1,376,2019-05-12T14:00:00Z,False,4,13,90,6,31,20,11,66,36,30,-35,-25
Jazz Richards,95,1,1,2018-08-11T14:00:00Z,False,4,1,0,0,0,0,0,0,0,0,0,0
Jazz Richards,95,1,12,2018-08-18T11:30:00Z,True,4,14,0,0,0,0,0,0,0,0,0,0
Jazz Richards,95,1,23,2018-08-25T14:00:00Z,False,4,9,0,0,1,1,0,0,0,0,1,0
Jazz Richards,95,1,32,2018-09-02T12:30:00Z,True,4,0,0,0,2,1,1,3,3,0,-1,1
Jazz Richards,95,1,41,2018-09-15T14:00:00Z,False,4,5,45,0,2,1,1,12,6,6,-10,-5
Jazz Richards,95,1,53,2018-09-22T14:00:00Z,True,4,12,39,0,2,1,1,13,9,4,-11,-3
Jazz Richards,95,1,62,2018-09-30T15:00:00Z,True,4,3,0,0,2,1,1,4,3,1,-2,0
Jazz Richards,95,1,78,2018-10-06T14:00:00Z,False,4,16,0,0,2,1,1,15,3,12,-13,-2
Jazz Richards,95,1,82,2018-10-20T14:00:00Z,True,4,8,13,1,2,1,1,5,4,1,-3,0
Jazz Richards,95,1,95,2018-10-27T14:00:00Z,False,4,11,0,0,5,4,1,23,10,13,-18,-9
Jazz Richards,95,1,102,2018-11-03T15:00:00Z,True,4,10,0,0,5,4,1,13,7,6,-8,-2
Jazz Richards,95,1,111,2018-11-10T12:30:00Z,True,4,2,0,0,5,4,1,14,10,4,-9,0
Jazz Richards,95,1,123,2018-11-24T15:00:00Z,False,4,7,0,0,8,7,1,19,13,6,-11,-12
Jazz Richards,95,1,131,2018-11-30T20:00:00Z,True,4,19,0,0,8,7,1,16,8,8,-8,-1
Jazz Richards,95,1,146,2018-12-04T19:45:00Z,False,4,18,0,0,11,10,1,15,7,8,-4,-6
Jazz Richards,95,1,153,2018-12-08T15:00:00Z,True,4,15,0,0,11,10,1,9,5,4,2,6
Jazz Richards,95,1,168,2018-12-15T15:00:00Z,False,4,17,0,0,14,13,1,21,12,9,-7,-11
Jazz Richards,95,1,172,2018-12-22T17:30:00Z,True,4,13,0,0,14,13,1,26,15,11,-12,2
Jazz Richards,95,1,182,2018-12-26T15:00:00Z,False,4,6,0,0,14,13,1,18,8,10,-4,-7
Jazz Richards,95,1,194,2018-12-29T15:00:00Z,False,4,10,0,0,15,13,2,28,14,14,-13,-12
Jazz Richards,95,1,202,2019-01-01T17:30:00Z,True,4,16,0,0,18,13,5,45,18,27,-27,-14
Jazz Richards,95,1,212,2019-01-12T15:00:00Z,True,4,9,0,0,18,13,5,10,5,5,8,8
Jazz Richards,95,1,226,2019-01-19T15:00:00Z,False,4,14,0,0,19,14,5,18,7,11,1,-2
Jazz Richards,95,1,230,2019-01-29T19:45:00Z,False,4,0,0,0,19,14,5,44,29,15,-25,-24
Jazz Richards,95,1,242,2019-02-02T17:30:00Z,True,4,1,0,0,19,14,5,33,24,9,-14,5
Jazz Richards,95,1,256,2019-02-09T15:00:00Z,False,4,15,0,0,22,17,5,24,12,12,-2,-7
Jazz Richards,95,1,263,2019-02-22T19:45:00Z,True,4,17,0,0,25,17,8,37,20,17,-12,0
Jazz Richards,95,1,271,2019-02-26T19:45:00Z,True,4,7,0,0,25,17,8,33,21,12,-8,5
Jazz Richards,95,1,289,2019-03-02T15:00:00Z,False,4,19,0,0,25,17,8,40,21,19,-15,-13
Jazz Richards,95,1,291,2019-03-09T15:00:00Z,True,4,18,0,0,25,17,8,39,24,15,-14,2
Jazz Richards,95,1,313,2019-03-31T13:05:00Z,True,4,5,0,0,28,20,8,57,32,25,-29,-5
Jazz Richards,95,1,324,2019-04-03T18:45:00Z,False,4,12,0,0,28,20,8,77,45,32,-49,-37
Jazz Richards,95,1,331,2019-04-13T14:00:00Z,False,4,3,0,0,28,20,8,36,20,16,-8,-12
Jazz Richards,95,1,301,2019-04-16T18:45:00Z,False,4,2,0,0,28,20,8,33,22,11,-5,-14
Jazz Richards,95,1,342,2019-04-21T15:00:00Z,True,4,11,0,0,31,20,11,85,47,38,-54,-18
Jazz Richards,95,1,353,2019-04-27T14:00:00Z,False,4,8,0,0,31,20,11,23,18,5,8,-7
Jazz Richards,95,1,362,2019-05-04T16:30:00Z,True,4,6,0,0,31,20,11,43,17,26,-12,-6
Jazz Richards,95,1,376,2019-05-12T14:00:00Z,False,4,13,32,1,31,20,11,66,36,30,-35,-25
Halford,96,1,1,2018-08-11T14:00:00Z,False,4,1,0,0,0,0,0,0,0,0,0,0
Halford,96,1,12,2018-08-18T11:30:00Z,True,4,14,0,0,0,0,0,0,0,0,0,0
Halford,96,1,23,2018-08-25T14:00:00Z,False,4,9,0,0,1,1,0,0,0,0,1,0
Halford,96,1,32,2018-09-02T12:30:00Z,True,4,0,0,0,2,1,1,3,3,0,-1,1
Halford,96,1,41,2018-09-15T14:00:00Z,False,4,5,0,0,2,1,1,12,6,6,-10,-5
Halford,96,1,53,2018-09-22T14:00:00Z,True,4,12,0,0,2,1,1,13,9,4,-11,-3
Halford,96,1,62,2018-09-30T15:00:00Z,True,4,3,0,0,2,1,1,4,3,1,-2,0
Halford,96,1,78,2018-10-06T14:00:00Z,False,4,16,0,0,2,1,1,15,3,12,-13,-2
Halford,96,1,82,2018-10-20T14:00:00Z,True,4,8,0,0,2,1,1,5,4,1,-3,0
Halford,96,1,95,2018-10-27T14:00:00Z,False,4,11,0,0,5,4,1,23,10,13,-18,-9
Halford,96,1,102,2018-11-03T15:00:00Z,True,4,10,0,0,5,4,1,13,7,6,-8,-2
Halford,96,1,111,2018-11-10T12:30:00Z,True,4,2,0,0,5,4,1,14,10,4,-9,0
Halford,96,1,123,2018-11-24T15:00:00Z,False,4,7,0,0,8,7,1,19,13,6,-11,-12
Halford,96,1,131,2018-11-30T20:00:00Z,True,4,19,0,0,8,7,1,16,8,8,-8,-1
Halford,96,1,146,2018-12-04T19:45:00Z,False,4,18,0,0,11,10,1,15,7,8,-4,-6
Halford,96,1,153,2018-12-08T15:00:00Z,True,4,15,0,0,11,10,1,9,5,4,2,6
Halford,96,1,168,2018-12-15T15:00:00Z,False,4,17,0,0,14,13,1,21,12,9,-7,-11
Halford,96,1,172,2018-12-22T17:30:00Z,True,4,13,0,0,14,13,1,26,15,11,-12,2
Halford,96,1,182,2018-12-26T15:00:00Z,False,4,6,0,0,14,13,1,18,8,10,-4,-7
Halford,96,1,194,2018-12-29T15:00:00Z,False,4,10,0,0,15,13,2,28,14,14,-13,-12
Halford,96,1,202,2019-01-01T17:30:00Z,True,4,16,0,0,18,13,5,45,18,27,-27,-14
Halford,96,1,212,2019-01-12T15:00:00Z,True,4,9,0,0,18,13,5,10,5,5,8,8
Halford,96,1,226,2019-01-19T15:00:00Z,False,4,14,0,0,19,14,5,18,7,11,1,-2
Halford,96,1,230,2019-01-29T19:45:00Z,False,4,0,0,0,19,14,5,44,29,15,-25,-24
Halford,96,1,242,2019-02-02T17:30:00Z,True,4,1,0,0,19,14,5,33,24,9,-14,5
Halford,96,1,256,2019-02-09T15:00:00Z,False,4,15,0,0,22,17,5,24,12,12,-2,-7
Halford,96,1,263,2019-02-22T19:45:00Z,True,4,17,0,0,25,17,8,37,20,17,-12,0
Halford,96,1,271,2019-02-26T19:45:00Z,True,4,7,0,0,25,17,8,33,21,12,-8,5
Halford,96,1,289,2019-03-02T15:00:00Z,False,4,19,0,0,25,17,8,40,21,19,-15,-13
Halford,96,1,291,2019-03-09T15:00:00Z,True,4,18,0,0,25,17,8,39,24,15,-14,2
Halford,96,1,313,2019-03-31T13:05:00Z,True,4,5,0,0,28,20,8,57,32,25,-29,-5
Halford,96,1,324,2019-04-03T18:45:00Z,False,4,12,0,0,28,20,8,77,45,32,-49,-37
Halford,96,1,331,2019-04-13T14:00:00Z,False,4,3,0,0,28,20,8,36,20,16,-8,-12
Halford,96,1,301,2019-04-16T18:45:00Z,False,4,2,0,0,28,20,8,33,22,11,-5,-14
Halford,96,1,342,2019-04-21T15:00:00Z,True,4,11,0,0,31,20,11,85,47,38,-54,-18
Halford,96,1,353,2019-04-27T14:00:00Z,False,4,8,0,0,31,20,11,23,18,5,8,-7
Halford,96,1,362,2019-05-04T16:30:00Z,True,4,6,0,0,31,20,11,43,17,26,-12,-6
Halford,96,1,376,2019-05-12T14:00:00Z,False,4,13,0,0,31,20,11,66,36,30,-35,-25
Ralls,97,2,1,2018-08-11T14:00:00Z,False,4,1,90,2,0,0,0,0,0,0,0,0
Ralls,97,2,12,2018-08-18T11:30:00Z,True,4,14,90,3,0,0,0,0,0,0,0,0
Ralls,97,2,23,2018-08-25T14:00:00Z,False,4,9,90,3,1,1,0,0,0,0,1,0
Ralls,97,2,32,2018-09-02T12:30:00Z,True,4,0,90,2,2,1,1,3,3,0,-1,1
Ralls,97,2,41,2018-09-15T14:00:00Z,False,4,5,90,2,2,1,1,12,6,6,-10,-5
Ralls,97,2,53,2018-09-22T14:00:00Z,True,4,12,90,1,2,1,1,13,9,4,-11,-3
Ralls,97,2,62,2018-09-30T15:00:00Z,True,4,3,78,2,2,1,1,4,3,1,-2,0
Ralls,97,2,78,2018-10-06T14:00:00Z,False,4,16,57,-2,2,1,1,15,3,12,-13,-2
Ralls,97,2,82,2018-10-20T14:00:00Z,True,4,8,0,0,2,1,1,5,4,1,-3,0
Ralls,97,2,95,2018-10-27T14:00:00Z,False,4,11,0,0,5,4,1,23,10,13,-18,-9
Ralls,97,2,102,2018-11-03T15:00:00Z,True,4,10,0,0,5,4,1,13,7,6,-8,-2
Ralls,97,2,111,2018-11-10T12:30:00Z,True,4,2,75,2,5,4,1,14,10,4,-9,0
Ralls,97,2,123,2018-11-24T15:00:00Z,False,4,7,90,2,8,7,1,19,13,6,-11,-12
Ralls,97,2,131,2018-11-30T20:00:00Z,True,4,19,90,2,8,7,1,16,8,8,-8,-1
Ralls,97,2,146,2018-12-04T19:45:00Z,False,4,18,63,-1,11,10,1,15,7,8,-4,-6
Ralls,97,2,153,2018-12-08T15:00:00Z,True,4,15,1,1,11,10,1,9,5,4,2,6
Ralls,97,2,168,2018-12-15T15:00:00Z,False,4,17,0,0,14,13,1,21,12,9,-7,-11
Ralls,97,2,172,2018-12-22T17:30:00Z,True,4,13,7,1,14,13,1,26,15,11,-12,2
Ralls,97,2,182,2018-12-26T15:00:00Z,False,4,6,90,3,14,13,1,18,8,10,-4,-7
Ralls,97,2,194,2018-12-29T15:00:00Z,False,4,10,0,0,15,13,2,28,14,14,-13,-12
Ralls,97,2,202,2019-01-01T17:30:00Z,True,4,16,31,1,18,13,5,45,18,27,-27,-14
Ralls,97,2,212,2019-01-12T15:00:00Z,True,4,9,26,1,18,13,5,10,5,5,8,8
Ralls,97,2,226,2019-01-19T15:00:00Z,False,4,14,90,2,19,14,5,18,7,11,1,-2
Ralls,97,2,230,2019-01-29T19:45:00Z,False,4,0,90,1,19,14,5,44,29,15,-25,-24
Ralls,97,2,242,2019-02-02T17:30:00Z,True,4,1,90,3,19,14,5,33,24,9,-14,5
Ralls,97,2,256,2019-02-09T15:00:00Z,False,4,15,90,2,22,17,5,24,12,12,-2,-7
Ralls,97,2,263,2019-02-22T19:45:00Z,True,4,17,66,2,25,17,8,37,20,17,-12,0
Ralls,97,2,271,2019-02-26T19:45:00Z,True,4,7,0,0,25,17,8,33,21,12,-8,5
Ralls,97,2,289,2019-03-02T15:00:00Z,False,4,19,90,2,25,17,8,40,21,19,-15,-13
Ralls,97,2,291,2019-03-09T15:00:00Z,True,4,18,22,1,25,17,8,39,24,15,-14,2
Ralls,97,2,313,2019-03-31T13:05:00Z,True,4,5,10,1,28,20,8,57,32,25,-29,-5
Ralls,97,2,324,2019-04-03T18:45:00Z,False,4,12,90,1,28,20,8,77,45,32,-49,-37
Ralls,97,2,331,2019-04-13T14:00:00Z,False,4,3,0,0,28,20,8,36,20,16,-8,-12
Ralls,97,2,301,2019-04-16T18:45:00Z,False,4,2,90,3,28,20,8,33,22,11,-5,-14
Ralls,97,2,342,2019-04-21T15:00:00Z,True,4,11,78,2,31,20,11,85,47,38,-54,-18
Ralls,97,2,353,2019-04-27T14:00:00Z,False,4,8,0,0,31,20,11,23,18,5,8,-7
Ralls,97,2,362,2019-05-04T16:30:00Z,True,4,6,0,0,31,20,11,43,17,26,-12,-6
Ralls,97,2,376,2019-05-12T14:00:00Z,False,4,13,0,0,31,20,11,66,36,30,-35,-25
Hoilett,98,2,1,2018-08-11T14:00:00Z,False,4,1,90,2,0,0,0,0,0,0,0,0
Hoilett,98,2,12,2018-08-18T11:30:00Z,True,4,14,82,3,0,0,0,0,0,0,0,0
Hoilett,98,2,23,2018-08-25T14:00:00Z,False,4,9,0,0,1,1,0,0,0,0,1,0
Hoilett,98,2,32,2018-09-02T12:30:00Z,True,4,0,90,1,2,1,1,3,3,0,-1,1
Hoilett,98,2,41,2018-09-15T14:00:00Z,False,4,5,90,2,2,1,1,12,6,6,-10,-5
Hoilett,98,2,53,2018-09-22T14:00:00Z,True,4,12,74,2,2,1,1,13,9,4,-11,-3
Hoilett,98,2,62,2018-09-30T15:00:00Z,True,4,3,0,0,2,1,1,4,3,1,-2,0
Hoilett,98,2,78,2018-10-06T14:00:00Z,False,4,16,77,2,2,1,1,15,3,12,-13,-2
Hoilett,98,2,82,2018-10-20T14:00:00Z,True,4,8,0,0,2,1,1,5,4,1,-3,0
Hoilett,98,2,95,2018-10-27T14:00:00Z,False,4,11,90,5,5,4,1,23,10,13,-18,-9
Hoilett,98,2,102,2018-11-03T15:00:00Z,True,4,10,25,0,5,4,1,13,7,6,-8,-2
Hoilett,98,2,111,2018-11-10T12:30:00Z,True,4,2,18,1,5,4,1,14,10,4,-9,0
Hoilett,98,2,123,2018-11-24T15:00:00Z,False,4,7,16,1,8,7,1,19,13,6,-11,-12
Hoilett,98,2,131,2018-11-30T20:00:00Z,True,4,19,90,8,8,7,1,16,8,8,-8,-1
Hoilett,98,2,146,2018-12-04T19:45:00Z,False,4,18,63,2,11,10,1,15,7,8,-4,-6
Hoilett,98,2,153,2018-12-08T15:00:00Z,True,4,15,23,1,11,10,1,9,5,4,2,6
Hoilett,98,2,168,2018-12-15T15:00:00Z,False,4,17,90,7,14,13,1,21,12,9,-7,-11
Hoilett,98,2,172,2018-12-22T17:30:00Z,True,4,13,73,2,14,13,1,26,15,11,-12,2
Hoilett,98,2,182,2018-12-26T15:00:00Z,False,4,6,90,2,14,13,1,18,8,10,-4,-7
Hoilett,98,2,194,2018-12-29T15:00:00Z,False,4,10,82,3,15,13,2,28,14,14,-13,-12
Hoilett,98,2,202,2019-01-01T17:30:00Z,True,4,16,45,1,18,13,5,45,18,27,-27,-14
Hoilett,98,2,212,2019-01-12T15:00:00Z,True,4,9,90,2,18,13,5,10,5,5,8,8
Hoilett,98,2,226,2019-01-19T15:00:00Z,False,4,14,90,2,19,14,5,18,7,11,1,-2
Hoilett,98,2,230,2019-01-29T19:45:00Z,False,4,0,0,0,19,14,5,44,29,15,-25,-24
Hoilett,98,2,242,2019-02-02T17:30:00Z,True,4,1,21,1,19,14,5,33,24,9,-14,5
Hoilett,98,2,256,2019-02-09T15:00:00Z,False,4,15,0,0,22,17,5,24,12,12,-2,-7
Hoilett,98,2,263,2019-02-22T19:45:00Z,True,4,17,34,1,25,17,8,37,20,17,-12,0
Hoilett,98,2,271,2019-02-26T19:45:00Z,True,4,7,67,2,25,17,8,33,21,12,-8,5
Hoilett,98,2,289,2019-03-02T15:00:00Z,False,4,19,0,0,25,17,8,40,21,19,-15,-13
Hoilett,98,2,291,2019-03-09T15:00:00Z,True,4,18,90,11,25,17,8,39,24,15,-14,2
Hoilett,98,2,313,2019-03-31T13:05:00Z,True,4,5,90,2,28,20,8,57,32,25,-29,-5
Hoilett,98,2,324,2019-04-03T18:45:00Z,False,4,12,90,2,28,20,8,77,45,32,-49,-37
Hoilett,98,2,331,2019-04-13T14:00:00Z,False,4,3,72,2,28,20,8,36,20,16,-8,-12
Hoilett,98,2,301,2019-04-16T18:45:00Z,False,4,2,90,6,28,20,8,33,22,11,-5,-14
Hoilett,98,2,342,2019-04-21T15:00:00Z,True,4,11,82,2,31,20,11,85,47,38,-54,-18
Hoilett,98,2,353,2019-04-27T14:00:00Z,False,4,8,90,2,31,20,11,23,18,5,8,-7
Hoilett,98,2,362,2019-05-04T16:30:00Z,True,4,6,10,1,31,20,11,43,17,26,-12,-6
Hoilett,98,2,376,2019-05-12T14:00:00Z,False,4,13,10,1,31,20,11,66,36,30,-35,-25
Mendez-Laing,99,2,1,2018-08-11T14:00:00Z,False,4,1,62,2,0,0,0,0,0,0,0,0
Mendez-Laing,99,2,12,2018-08-18T11:30:00Z,True,4,14,12,1,0,0,0,0,0,0,0,0
Mendez-Laing,99,2,23,2018-08-25T14:00:00Z,False,4,9,9,1,1,1,0,0,0,0,1,0
Mendez-Laing,99,2,32,2018-09-02T12:30:00Z,True,4,0,0,0,2,1,1,3,3,0,-1,1
Mendez-Laing,99,2,41,2018-09-15T14:00:00Z,False,4,5,0,0,2,1,1,12,6,6,-10,-5
Mendez-Laing,99,2,53,2018-09-22T14:00:00Z,True,4,12,0,0,2,1,1,13,9,4,-11,-3
Mendez-Laing,99,2,62,2018-09-30T15:00:00Z,True,4,3,0,0,2,1,1,4,3,1,-2,0
Mendez-Laing,99,2,78,2018-10-06T14:00:00Z,False,4,16,0,0,2,1,1,15,3,12,-13,-2
Mendez-Laing,99,2,82,2018-10-20T14:00:00Z,True,4,8,0,0,2,1,1,5,4,1,-3,0
Mendez-Laing,99,2,95,2018-10-27T14:00:00Z,False,4,11,0,0,5,4,1,23,10,13,-18,-9
Mendez-Laing,99,2,102,2018-11-03T15:00:00Z,True,4,10,0,0,5,4,1,13,7,6,-8,-2
Mendez-Laing,99,2,111,2018-11-10T12:30:00Z,True,4,2,0,0,5,4,1,14,10,4,-9,0
Mendez-Laing,99,2,123,2018-11-24T15:00:00Z,False,4,7,0,0,8,7,1,19,13,6,-11,-12
Mendez-Laing,99,2,131,2018-11-30T20:00:00Z,True,4,19,0,0,8,7,1,16,8,8,-8,-1
Mendez-Laing,99,2,146,2018-12-04T19:45:00Z,False,4,18,26,1,11,10,1,15,7,8,-4,-6
Mendez-Laing,99,2,153,2018-12-08T15:00:00Z,True,4,15,66,3,11,10,1,9,5,4,2,6
Mendez-Laing,99,2,168,2018-12-15T15:00:00Z,False,4,17,45,1,14,13,1,21,12,9,-7,-11
Mendez-Laing,99,2,172,2018-12-22T17:30:00Z,True,4,13,0,0,14,13,1,26,15,11,-12,2
Mendez-Laing,99,2,182,2018-12-26T15:00:00Z,False,4,6,0,0,14,13,1,18,8,10,-4,-7
Mendez-Laing,99,2,194,2018-12-29T15:00:00Z,False,4,10,0,0,15,13,2,28,14,14,-13,-12
Mendez-Laing,99,2,202,2019-01-01T17:30:00Z,True,4,16,18,1,18,13,5,45,18,27,-27,-14
Mendez-Laing,99,2,212,2019-01-12T15:00:00Z,True,4,9,72,3,18,13,5,10,5,5,8,8
Mendez-Laing,99,2,226,2019-01-19T15:00:00Z,False,4,14,81,2,19,14,5,18,7,11,1,-2
Mendez-Laing,99,2,230,2019-01-29T19:45:00Z,False,4,0,20,7,19,14,5,44,29,15,-25,-24
Mendez-Laing,99,2,242,2019-02-02T17:30:00Z,True,4,1,0,0,19,14,5,33,24,9,-14,5
Mendez-Laing,99,2,256,2019-02-09T15:00:00Z,False,4,15,0,0,22,17,5,24,12,12,-2,-7
Mendez-Laing,99,2,263,2019-02-22T19:45:00Z,True,4,17,23,1,25,17,8,37,20,17,-12,0
Mendez-Laing,99,2,271,2019-02-26T19:45:00Z,True,4,7,68,2,25,17,8,33,21,12,-8,5
Mendez-Laing,99,2,289,2019-03-02T15:00:00Z,False,4,19,0,0,25,17,8,40,21,19,-15,-13
Mendez-Laing,99,2,291,2019-03-09T15:00:00Z,True,4,18,0,0,25,17,8,39,24,15,-14,2
Mendez-Laing,99,2,313,2019-03-31T13:05:00Z,True,4,5,1,1,28,20,8,57,32,25,-29,-5
Mendez-Laing,99,2,324,2019-04-03T18:45:00Z,False,4,12,30,1,28,20,8,77,45,32,-49,-37
Mendez-Laing,99,2,331,2019-04-13T14:00:00Z,False,4,3,17,1,28,20,8,36,20,16,-8,-12
Mendez-Laing,99,2,301,2019-04-16T18:45:00Z,False,4,2,79,10,28,20,8,33,22,11,-5,-14
Mendez-Laing,99,2,342,2019-04-21T15:00:00Z,True,4,11,90,2,31,20,11,85,47,38,-54,-18
Mendez-Laing,99,2,353,2019-04-27T14:00:00Z,False,4,8,90,2,31,20,11,23,18,5,8,-7
Mendez-Laing,99,2,362,2019-05-04T16:30:00Z,True,4,6,90,5,31,20,11,43,17,26,-12,-6
Mendez-Laing,99,2,376,2019-05-12T14:00:00Z,False,4,13,79,16,31,20,11,66,36,30,-35,-25
Paterson,100,2,1,2018-08-11T14:00:00Z,False,4,1,62,2,0,0,0,0,0,0,0,0
Paterson,100,2,12,2018-08-18T11:30:00Z,True,4,14,7,1,0,0,0,0,0,0,0,0
Paterson,100,2,23,2018-08-25T14:00:00Z,False,4,9,80,3,1,1,0,0,0,0,1,0
Paterson,100,2,32,2018-09-02T12:30:00Z,True,4,0,0,0,2,1,1,3,3,0,-1,1
Paterson,100,2,41,2018-09-15T14:00:00Z,False,4,5,19,1,2,1,1,12,6,6,-10,-5
Paterson,100,2,53,2018-09-22T14:00:00Z,True,4,12,0,0,2,1,1,13,9,4,-11,-3
Paterson,100,2,62,2018-09-30T15:00:00Z,True,4,3,90,2,2,1,1,4,3,1,-2,0
Paterson,100,2,78,2018-10-06T14:00:00Z,False,4,16,77,2,2,1,1,15,3,12,-13,-2
Paterson,100,2,82,2018-10-20T14:00:00Z,True,4,8,90,7,2,1,1,5,4,1,-3,0
Paterson,100,2,95,2018-10-27T14:00:00Z,False,4,11,90,7,5,4,1,23,10,13,-18,-9
Paterson,100,2,102,2018-11-03T15:00:00Z,True,4,10,90,2,5,4,1,13,7,6,-8,-2
Paterson,100,2,111,2018-11-10T12:30:00Z,True,4,2,90,12,5,4,1,14,10,4,-9,0
Paterson,100,2,123,2018-11-24T15:00:00Z,False,4,7,90,2,8,7,1,19,13,6,-11,-12
Paterson,100,2,131,2018-11-30T20:00:00Z,True,4,19,90,1,8,7,1,16,8,8,-8,-1
Paterson,100,2,146,2018-12-04T19:45:00Z,False,4,18,72,2,11,10,1,15,7,8,-4,-6
Paterson,100,2,153,2018-12-08T15:00:00Z,True,4,15,90,9,11,10,1,9,5,4,2,6
Paterson,100,2,168,2018-12-15T15:00:00Z,False,4,17,90,2,14,13,1,21,12,9,-7,-11
Paterson,100,2,172,2018-12-22T17:30:00Z,True,4,13,90,2,14,13,1,26,15,11,-12,2
Paterson,100,2,182,2018-12-26T15:00:00Z,False,4,6,0,0,14,13,1,18,8,10,-4,-7
Paterson,100,2,194,2018-12-29T15:00:00Z,False,4,10,90,3,15,13,2,28,14,14,-13,-12
Paterson,100,2,202,2019-01-01T17:30:00Z,True,4,16,90,2,18,13,5,45,18,27,-27,-14
Paterson,100,2,212,2019-01-12T15:00:00Z,True,4,9,90,3,18,13,5,10,5,5,8,8
Paterson,100,2,226,2019-01-19T15:00:00Z,False,4,14,88,2,19,14,5,18,7,11,1,-2
Paterson,100,2,230,2019-01-29T19:45:00Z,False,4,0,90,1,19,14,5,44,29,15,-25,-24
Paterson,100,2,242,2019-02-02T17:30:00Z,True,4,1,90,3,19,14,5,33,24,9,-14,5
Paterson,100,2,256,2019-02-09T15:00:00Z,False,4,15,90,5,22,17,5,24,12,12,-2,-7
Paterson,100,2,263,2019-02-22T19:45:00Z,True,4,17,90,1,25,17,8,37,20,17,-12,0
Paterson,100,2,271,2019-02-26T19:45:00Z,True,4,7,21,1,25,17,8,33,21,12,-8,5
Paterson,100,2,289,2019-03-02T15:00:00Z,False,4,19,31,1,25,17,8,40,21,19,-15,-13
Paterson,100,2,291,2019-03-09T15:00:00Z,True,4,18,6,1,25,17,8,39,24,15,-14,2
Paterson,100,2,313,2019-03-31T13:05:00Z,True,4,5,0,0,28,20,8,57,32,25,-29,-5
Paterson,100,2,324,2019-04-03T18:45:00Z,False,4,12,0,0,28,20,8,77,45,32,-49,-37
Paterson,100,2,331,2019-04-13T14:00:00Z,False,4,3,0,0,28,20,8,36,20,16,-8,-12
Paterson,100,2,301,2019-04-16T18:45:00Z,False,4,2,0,0,28,20,8,33,22,11,-5,-14
Paterson,100,2,342,2019-04-21T15:00:00Z,True,4,11,0,0,31,20,11,85,47,38,-54,-18
Paterson,100,2,353,2019-04-27T14:00:00Z,False,4,8,0,0,31,20,11,23,18,5,8,-7
Paterson,100,2,362,2019-05-04T16:30:00Z,True,4,6,0,0,31,20,11,43,17,26,-12,-6
Paterson,100,2,376,2019-05-12T14:00:00Z,False,4,13,0,0,31,20,11,66,36,30,-35,-25
Gunnarsson,101,2,1,2018-08-11T14:00:00Z,False,4,1,0,0,0,0,0,0,0,0,0,0
Gunnarsson,101,2,12,2018-08-18T11:30:00Z,True,4,14,0,0,0,0,0,0,0,0,0,0
Gunnarsson,101,2,23,2018-08-25T14:00:00Z,False,4,9,0,0,1,1,0,0,0,0,1,0
Gunnarsson,101,2,32,2018-09-02T12:30:00Z,True,4,0,0,0,2,1,1,3,3,0,-1,1
Gunnarsson,101,2,41,2018-09-15T14:00:00Z,False,4,5,0,0,2,1,1,12,6,6,-10,-5
Gunnarsson,101,2,53,2018-09-22T14:00:00Z,True,4,12,0,0,2,1,1,13,9,4,-11,-3
Gunnarsson,101,2,62,2018-09-30T15:00:00Z,True,4,3,0,0,2,1,1,4,3,1,-2,0
Gunnarsson,101,2,78,2018-10-06T14:00:00Z,False,4,16,0,0,2,1,1,15,3,12,-13,-2
Gunnarsson,101,2,82,2018-10-20T14:00:00Z,True,4,8,76,1,2,1,1,5,4,1,-3,0
Gunnarsson,101,2,95,2018-10-27T14:00:00Z,False,4,11,72,2,5,4,1,23,10,13,-18,-9
Gunnarsson,101,2,102,2018-11-03T15:00:00Z,True,4,10,90,2,5,4,1,13,7,6,-8,-2
Gunnarsson,101,2,111,2018-11-10T12:30:00Z,True,4,2,90,2,5,4,1,14,10,4,-9,0
Gunnarsson,101,2,123,2018-11-24T15:00:00Z,False,4,7,90,2,8,7,1,19,13,6,-11,-12
Gunnarsson,101,2,131,2018-11-30T20:00:00Z,True,4,19,90,10,8,7,1,16,8,8,-8,-1
Gunnarsson,101,2,146,2018-12-04T19:45:00Z,False,4,18,90,2,11,10,1,15,7,8,-4,-6
Gunnarsson,101,2,153,2018-12-08T15:00:00Z,True,4,15,90,3,11,10,1,9,5,4,2,6
Gunnarsson,101,2,168,2018-12-15T15:00:00Z,False,4,17,77,2,14,13,1,21,12,9,-7,-11
Gunnarsson,101,2,172,2018-12-22T17:30:00Z,True,4,13,82,1,14,13,1,26,15,11,-12,2
Gunnarsson,101,2,182,2018-12-26T15:00:00Z,False,4,6,1,1,14,13,1,18,8,10,-4,-7
Gunnarsson,101,2,194,2018-12-29T15:00:00Z,False,4,10,90,3,15,13,2,28,14,14,-13,-12
Gunnarsson,101,2,202,2019-01-01T17:30:00Z,True,4,16,90,2,18,13,5,45,18,27,-27,-14
Gunnarsson,101,2,212,2019-01-12T15:00:00Z,True,4,9,90,3,18,13,5,10,5,5,8,8
Gunnarsson,101,2,226,2019-01-19T15:00:00Z,False,4,14,0,0,19,14,5,18,7,11,1,-2
Gunnarsson,101,2,230,2019-01-29T19:45:00Z,False,4,0,90,2,19,14,5,44,29,15,-25,-24
Gunnarsson,101,2,242,2019-02-02T17:30:00Z,True,4,1,90,6,19,14,5,33,24,9,-14,5
Gunnarsson,101,2,256,2019-02-09T15:00:00Z,False,4,15,61,2,22,17,5,24,12,12,-2,-7
Gunnarsson,101,2,263,2019-02-22T19:45:00Z,True,4,17,0,0,25,17,8,37,20,17,-12,0
Gunnarsson,101,2,271,2019-02-26T19:45:00Z,True,4,7,90,2,25,17,8,33,21,12,-8,5
Gunnarsson,101,2,289,2019-03-02T15:00:00Z,False,4,19,90,2,25,17,8,40,21,19,-15,-13
Gunnarsson,101,2,291,2019-03-09T15:00:00Z,True,4,18,90,3,25,17,8,39,24,15,-14,2
Gunnarsson,101,2,313,2019-03-31T13:05:00Z,True,4,5,90,1,28,20,8,57,32,25,-29,-5
Gunnarsson,101,2,324,2019-04-03T18:45:00Z,False,4,12,80,2,28,20,8,77,45,32,-49,-37
Gunnarsson,101,2,331,2019-04-13T14:00:00Z,False,4,3,90,2,28,20,8,36,20,16,-8,-12
Gunnarsson,101,2,301,2019-04-16T18:45:00Z,False,4,2,54,1,28,20,8,33,22,11,-5,-14
Gunnarsson,101,2,342,2019-04-21T15:00:00Z,True,4,11,90,1,31,20,11,85,47,38,-54,-18
Gunnarsson,101,2,353,2019-04-27T14:00:00Z,False,4,8,86,2,31,20,11,23,18,5,8,-7
Gunnarsson,101,2,362,2019-05-04T16:30:00Z,True,4,6,90,2,31,20,11,43,17,26,-12,-6
Gunnarsson,101,2,376,2019-05-12T14:00:00Z,False,4,13,57,1,31,20,11,66,36,30,-35,-25
Pilkington,102,2,1,2018-08-11T14:00:00Z,False,4,1,0,0,0,0,0,0,0,0,0,0
Pilkington,102,2,12,2018-08-18T11:30:00Z,True,4,14,0,0,0,0,0,0,0,0,0,0
Pilkington,102,2,23,2018-08-25T14:00:00Z,False,4,9,0,0,1,1,0,0,0,0,1,0
Pilkington,102,2,32,2018-09-02T12:30:00Z,True,4,0,0,0,2,1,1,3,3,0,-1,1
Pilkington,102,2,41,2018-09-15T14:00:00Z,False,4,5,0,0,2,1,1,12,6,6,-10,-5
Pilkington,102,2,53,2018-09-22T14:00:00Z,True,4,12,0,0,2,1,1,13,9,4,-11,-3
Pilkington,102,2,62,2018-09-30T15:00:00Z,True,4,3,0,0,2,1,1,4,3,1,-2,0
Pilkington,102,2,78,2018-10-06T14:00:00Z,False,4,16,0,0,2,1,1,15,3,12,-13,-2
Pilkington,102,2,82,2018-10-20T14:00:00Z,True,4,8,0,0,2,1,1,5,4,1,-3,0
Pilkington,102,2,95,2018-10-27T14:00:00Z,False,4,11,0,0,5,4,1,23,10,13,-18,-9
Pilkington,102,2,102,2018-11-03T15:00:00Z,True,4,10,0,0,5,4,1,13,7,6,-8,-2
Pilkington,102,2,111,2018-11-10T12:30:00Z,True,4,2,0,0,5,4,1,14,10,4,-9,0
Pilkington,102,2,123,2018-11-24T15:00:00Z,False,4,7,0,0,8,7,1,19,13,6,-11,-12
Pilkington,102,2,131,2018-11-30T20:00:00Z,True,4,19,0,0,8,7,1,16,8,8,-8,-1
Pilkington,102,2,146,2018-12-04T19:45:00Z,False,4,18,0,0,11,10,1,15,7,8,-4,-6
Pilkington,102,2,153,2018-12-08T15:00:00Z,True,4,15,0,0,11,10,1,9,5,4,2,6
Pilkington,102,2,168,2018-12-15T15:00:00Z,False,4,17,0,0,14,13,1,21,12,9,-7,-11
Pilkington,102,2,172,2018-12-22T17:30:00Z,True,4,13,0,0,14,13,1,26,15,11,-12,2
Pilkington,102,2,182,2018-12-26T15:00:00Z,False,4,6,0,0,14,13,1,18,8,10,-4,-7
Pilkington,102,2,194,2018-12-29T15:00:00Z,False,4,10,0,0,15,13,2,28,14,14,-13,-12
Pilkington,102,2,202,2019-01-01T17:30:00Z,True,4,16,0,0,18,13,5,45,18,27,-27,-14
Pilkington,102,2,212,2019-01-12T15:00:00Z,True,4,9,0,0,18,13,5,10,5,5,8,8
Pilkington,102,2,226,2019-01-19T15:00:00Z,False,4,14,0,0,19,14,5,18,7,11,1,-2
Pilkington,102,2,230,2019-01-29T19:45:00Z,False,4,0,0,0,19,14,5,44,29,15,-25,-24
Pilkington,102,2,242,2019-02-02T17:30:00Z,True,4,1,0,0,19,14,5,33,24,9,-14,5
Pilkington,102,2,256,2019-02-09T15:00:00Z,False,4,15,0,0,22,17,5,24,12,12,-2,-7
Pilkington,102,2,263,2019-02-22T19:45:00Z,True,4,17,0,0,25,17,8,37,20,17,-12,0
Pilkington,102,2,271,2019-02-26T19:45:00Z,True,4,7,0,0,25,17,8,33,21,12,-8,5
Pilkington,102,2,289,2019-03-02T15:00:00Z,False,4,19,0,0,25,17,8,40,21,19,-15,-13
Pilkington,102,2,291,2019-03-09T15:00:00Z,True,4,18,0,0,25,17,8,39,24,15,-14,2
Pilkington,102,2,313,2019-03-31T13:05:00Z,True,4,5,0,0,28,20,8,57,32,25,-29,-5
Pilkington,102,2,324,2019-04-03T18:45:00Z,False,4,12,0,0,28,20,8,77,45,32,-49,-37
Pilkington,102,2,331,2019-04-13T14:00:00Z,False,4,3,0,0,28,20,8,36,20,16,-8,-12
Pilkington,102,2,301,2019-04-16T18:45:00Z,False,4,2,0,0,28,20,8,33,22,11,-5,-14
Pilkington,102,2,342,2019-04-21T15:00:00Z,True,4,11,0,0,31,20,11,85,47,38,-54,-18
Pilkington,102,2,353,2019-04-27T14:00:00Z,False,4,8,0,0,31,20,11,23,18,5,8,-7
Pilkington,102,2,362,2019-05-04T16:30:00Z,True,4,6,0,0,31,20,11,43,17,26,-12,-6
Pilkington,102,2,376,2019-05-12T14:00:00Z,False,4,13,0,0,31,20,11,66,36,30,-35,-25
Damour,103,2,1,2018-08-11T14:00:00Z,False,4,1,0,0,0,0,0,0,0,0,0,0
Damour,103,2,12,2018-08-18T11:30:00Z,True,4,14,0,0,0,0,0,0,0,0,0,0
Damour,103,2,23,2018-08-25T14:00:00Z,False,4,9,0,0,1,1,0,0,0,0,1,0
Damour,103,2,32,2018-09-02T12:30:00Z,True,4,0,0,0,2,1,1,3,3,0,-1,1
Damour,103,2,41,2018-09-15T14:00:00Z,False,4,5,0,0,2,1,1,12,6,6,-10,-5
Damour,103,2,53,2018-09-22T14:00:00Z,True,4,12,0,0,2,1,1,13,9,4,-11,-3
Damour,103,2,62,2018-09-30T15:00:00Z,True,4,3,0,0,2,1,1,4,3,1,-2,0
Damour,103,2,78,2018-10-06T14:00:00Z,False,4,16,0,0,2,1,1,15,3,12,-13,-2
Damour,103,2,82,2018-10-20T14:00:00Z,True,4,8,4,1,2,1,1,5,4,1,-3,0
Damour,103,2,95,2018-10-27T14:00:00Z,False,4,11,17,1,5,4,1,23,10,13,-18,-9
Damour,103,2,102,2018-11-03T15:00:00Z,True,4,10,0,0,5,4,1,13,7,6,-8,-2
Damour,103,2,111,2018-11-10T12:30:00Z,True,4,2,0,0,5,4,1,14,10,4,-9,0
Damour,103,2,123,2018-11-24T15:00:00Z,False,4,7,0,0,8,7,1,19,13,6,-11,-12
Damour,103,2,131,2018-11-30T20:00:00Z,True,4,19,0,0,8,7,1,16,8,8,-8,-1
Damour,103,2,146,2018-12-04T19:45:00Z,False,4,18,0,0,11,10,1,15,7,8,-4,-6
Damour,103,2,153,2018-12-08T15:00:00Z,True,4,15,0,0,11,10,1,9,5,4,2,6
Damour,103,2,168,2018-12-15T15:00:00Z,False,4,17,0,0,14,13,1,21,12,9,-7,-11
Damour,103,2,172,2018-12-22T17:30:00Z,True,4,13,0,0,14,13,1,26,15,11,-12,2
Damour,103,2,182,2018-12-26T15:00:00Z,False,4,6,0,0,14,13,1,18,8,10,-4,-7
Damour,103,2,194,2018-12-29T15:00:00Z,False,4,10,0,0,15,13,2,28,14,14,-13,-12
Damour,103,2,202,2019-01-01T17:30:00Z,True,4,16,0,0,18,13,5,45,18,27,-27,-14
Damour,103,2,212,2019-01-12T15:00:00Z,True,4,9,0,0,18,13,5,10,5,5,8,8
Damour,103,2,226,2019-01-19T15:00:00Z,False,4,14,0,0,19,14,5,18,7,11,1,-2
Damour,103,2,230,2019-01-29T19:45:00Z,False,4,0,0,0,19,14,5,44,29,15,-25,-24
Damour,103,2,242,2019-02-02T17:30:00Z,True,4,1,0,0,19,14,5,33,24,9,-14,5
Damour,103,2,256,2019-02-09T15:00:00Z,False,4,15,0,0,22,17,5,24,12,12,-2,-7
Damour,103,2,263,2019-02-22T19:45:00Z,True,4,17,0,0,25,17,8,37,20,17,-12,0
Damour,103,2,271,2019-02-26T19:45:00Z,True,4,7,0,0,25,17,8,33,21,12,-8,5
Damour,103,2,289,2019-03-02T15:00:00Z,False,4,19,0,0,25,17,8,40,21,19,-15,-13
Damour,103,2,291,2019-03-09T15:00:00Z,True,4,18,0,0,25,17,8,39,24,15,-14,2
Damour,103,2,313,2019-03-31T13:05:00Z,True,4,5,0,0,28,20,8,57,32,25,-29,-5
Damour,103,2,324,2019-04-03T18:45:00Z,False,4,12,0,0,28,20,8,77,45,32,-49,-37
Damour,103,2,331,2019-04-13T14:00:00Z,False,4,3,0,0,28,20,8,36,20,16,-8,-12
Damour,103,2,301,2019-04-16T18:45:00Z,False,4,2,0,0,28,20,8,33,22,11,-5,-14
Damour,103,2,342,2019-04-21T15:00:00Z,True,4,11,0,0,31,20,11,85,47,38,-54,-18
Damour,103,2,353,2019-04-27T14:00:00Z,False,4,8,0,0,31,20,11,23,18,5,8,-7
Damour,103,2,362,2019-05-04T16:30:00Z,True,4,6,0,0,31,20,11,43,17,26,-12,-6
Damour,103,2,376,2019-05-12T14:00:00Z,False,4,13,0,0,31,20,11,66,36,30,-35,-25
Ward,104,2,1,2018-08-11T14:00:00Z,False,4,1,28,1,0,0,0,0,0,0,0,0
Ward,104,2,12,2018-08-18T11:30:00Z,True,4,14,0,0,0,0,0,0,0,0,0,0
Ward,104,2,23,2018-08-25T14:00:00Z,False,4,9,31,1,1,1,0,0,0,0,1,0
Ward,104,2,32,2018-09-02T12:30:00Z,True,4,0,83,7,2,1,1,3,3,0,-1,1
Ward,104,2,41,2018-09-15T14:00:00Z,False,4,5,76,2,2,1,1,12,6,6,-10,-5
Ward,104,2,53,2018-09-22T14:00:00Z,True,4,12,62,2,2,1,1,13,9,4,-11,-3
Ward,104,2,62,2018-09-30T15:00:00Z,True,4,3,19,1,2,1,1,4,3,1,-2,0
Ward,104,2,78,2018-10-06T14:00:00Z,False,4,16,6,1,2,1,1,15,3,12,-13,-2
Ward,104,2,82,2018-10-20T14:00:00Z,True,4,8,0,0,2,1,1,5,4,1,-3,0
Ward,104,2,95,2018-10-27T14:00:00Z,False,4,11,0,0,5,4,1,23,10,13,-18,-9
Ward,104,2,102,2018-11-03T15:00:00Z,True,4,10,11,1,5,4,1,13,7,6,-8,-2
Ward,104,2,111,2018-11-10T12:30:00Z,True,4,2,0,0,5,4,1,14,10,4,-9,0
Ward,104,2,123,2018-11-24T15:00:00Z,False,4,7,5,1,8,7,1,19,13,6,-11,-12
Ward,104,2,131,2018-11-30T20:00:00Z,True,4,19,0,0,8,7,1,16,8,8,-8,-1
Ward,104,2,146,2018-12-04T19:45:00Z,False,4,18,0,0,11,10,1,15,7,8,-4,-6
Ward,104,2,153,2018-12-08T15:00:00Z,True,4,15,0,0,11,10,1,9,5,4,2,6
Ward,104,2,168,2018-12-15T15:00:00Z,False,4,17,0,0,14,13,1,21,12,9,-7,-11
Ward,104,2,172,2018-12-22T17:30:00Z,True,4,13,0,0,14,13,1,26,15,11,-12,2
Ward,104,2,182,2018-12-26T15:00:00Z,False,4,6,0,0,14,13,1,18,8,10,-4,-7
Ward,104,2,194,2018-12-29T15:00:00Z,False,4,10,0,0,15,13,2,28,14,14,-13,-12
Ward,104,2,202,2019-01-01T17:30:00Z,True,4,16,0,0,18,13,5,45,18,27,-27,-14
Ward,104,2,212,2019-01-12T15:00:00Z,True,4,9,0,0,18,13,5,10,5,5,8,8
Ward,104,2,226,2019-01-19T15:00:00Z,False,4,14,1,1,19,14,5,18,7,11,1,-2
Ward,104,2,230,2019-01-29T19:45:00Z,False,4,0,0,0,19,14,5,44,29,15,-25,-24
Ward,104,2,242,2019-02-02T17:30:00Z,True,4,1,0,0,19,14,5,33,24,9,-14,5
Ward,104,2,256,2019-02-09T15:00:00Z,False,4,15,0,0,22,17,5,24,12,12,-2,-7
Ward,104,2,263,2019-02-22T19:45:00Z,True,4,17,0,0,25,17,8,37,20,17,-12,0
Ward,104,2,271,2019-02-26T19:45:00Z,True,4,7,9,1,25,17,8,33,21,12,-8,5
Ward,104,2,289,2019-03-02T15:00:00Z,False,4,19,0,0,25,17,8,40,21,19,-15,-13
Ward,104,2,291,2019-03-09T15:00:00Z,True,4,18,0,0,25,17,8,39,24,15,-14,2
Ward,104,2,313,2019-03-31T13:05:00Z,True,4,5,0,0,28,20,8,57,32,25,-29,-5
Ward,104,2,324,2019-04-03T18:45:00Z,False,4,12,0,0,28,20,8,77,45,32,-49,-37
Ward,104,2,331,2019-04-13T14:00:00Z,False,4,3,0,0,28,20,8,36,20,16,-8,-12
Ward,104,2,301,2019-04-16T18:45:00Z,False,4,2,0,0,28,20,8,33,22,11,-5,-14
Ward,104,2,342,2019-04-21T15:00:00Z,True,4,11,0,0,31,20,11,85,47,38,-54,-18
Ward,104,2,353,2019-04-27T14:00:00Z,False,4,8,29,1,31,20,11,23,18,5,8,-7
Ward,104,2,362,2019-05-04T16:30:00Z,True,4,6,59,1,31,20,11,43,17,26,-12,-6
Ward,104,2,376,2019-05-12T14:00:00Z,False,4,13,16,1,31,20,11,66,36,30,-35,-25
Murphy,105,2,1,2018-08-11T14:00:00Z,False,4,1,27,1,0,0,0,0,0,0,0,0
Murphy,105,2,12,2018-08-18T11:30:00Z,True,4,14,77,3,0,0,0,0,0,0,0,0
Murphy,105,2,23,2018-08-25T14:00:00Z,False,4,9,90,3,1,1,0,0,0,0,1,0
Murphy,105,2,32,2018-09-02T12:30:00Z,True,4,0,0,0,2,1,1,3,3,0,-1,1
Murphy,105,2,41,2018-09-15T14:00:00Z,False,4,5,0,0,2,1,1,12,6,6,-10,-5
Murphy,105,2,53,2018-09-22T14:00:00Z,True,4,12,15,1,2,1,1,13,9,4,-11,-3
Murphy,105,2,62,2018-09-30T15:00:00Z,True,4,3,90,8,2,1,1,4,3,1,-2,0
Murphy,105,2,78,2018-10-06T14:00:00Z,False,4,16,90,2,2,1,1,15,3,12,-13,-2
Murphy,105,2,82,2018-10-20T14:00:00Z,True,4,8,81,7,2,1,1,5,4,1,-3,0
Murphy,105,2,95,2018-10-27T14:00:00Z,False,4,11,73,2,5,4,1,23,10,13,-18,-9
Murphy,105,2,102,2018-11-03T15:00:00Z,True,4,10,84,2,5,4,1,13,7,6,-8,-2
Murphy,105,2,111,2018-11-10T12:30:00Z,True,4,2,71,2,5,4,1,14,10,4,-9,0
Murphy,105,2,123,2018-11-24T15:00:00Z,False,4,7,23,1,8,7,1,19,13,6,-11,-12
Murphy,105,2,131,2018-11-30T20:00:00Z,True,4,19,65,2,8,7,1,16,8,8,-8,-1
Murphy,105,2,146,2018-12-04T19:45:00Z,False,4,18,26,6,11,10,1,15,7,8,-4,-6
Murphy,105,2,153,2018-12-08T15:00:00Z,True,4,15,84,3,11,10,1,9,5,4,2,6
Murphy,105,2,168,2018-12-15T15:00:00Z,False,4,17,45,1,14,13,1,21,12,9,-7,-11
Murphy,105,2,172,2018-12-22T17:30:00Z,True,4,13,90,2,14,13,1,26,15,11,-12,2
Murphy,105,2,182,2018-12-26T15:00:00Z,False,4,6,0,0,14,13,1,18,8,10,-4,-7
Murphy,105,2,194,2018-12-29T15:00:00Z,False,4,10,77,3,15,13,2,28,14,14,-13,-12
Murphy,105,2,202,2019-01-01T17:30:00Z,True,4,16,45,1,18,13,5,45,18,27,-27,-14
Murphy,105,2,212,2019-01-12T15:00:00Z,True,4,9,0,0,18,13,5,10,5,5,8,8
Murphy,105,2,226,2019-01-19T15:00:00Z,False,4,14,8,1,19,14,5,18,7,11,1,-2
Murphy,105,2,230,2019-01-29T19:45:00Z,False,4,0,0,0,19,14,5,44,29,15,-25,-24
Murphy,105,2,242,2019-02-02T17:30:00Z,True,4,1,68,3,19,14,5,33,24,9,-14,5
Murphy,105,2,256,2019-02-09T15:00:00Z,False,4,15,0,0,22,17,5,24,12,12,-2,-7
Murphy,105,2,263,2019-02-22T19:45:00Z,True,4,17,55,1,25,17,8,37,20,17,-12,0
Murphy,105,2,271,2019-02-26T19:45:00Z,True,4,7,22,0,25,17,8,33,21,12,-8,5
Murphy,105,2,289,2019-03-02T15:00:00Z,False,4,19,0,0,25,17,8,40,21,19,-15,-13
Murphy,105,2,291,2019-03-09T15:00:00Z,True,4,18,90,8,25,17,8,39,24,15,-14,2
Murphy,105,2,313,2019-03-31T13:05:00Z,True,4,5,89,2,28,20,8,57,32,25,-29,-5
Murphy,105,2,324,2019-04-03T18:45:00Z,False,4,12,59,1,28,20,8,77,45,32,-49,-37
Murphy,105,2,331,2019-04-13T14:00:00Z,False,4,3,90,2,28,20,8,36,20,16,-8,-12
Murphy,105,2,301,2019-04-16T18:45:00Z,False,4,2,0,0,28,20,8,33,22,11,-5,-14
Murphy,105,2,342,2019-04-21T15:00:00Z,True,4,11,7,1,31,20,11,85,47,38,-54,-18
Murphy,105,2,353,2019-04-27T14:00:00Z,False,4,8,0,0,31,20,11,23,18,5,8,-7
Murphy,105,2,362,2019-05-04T16:30:00Z,True,4,6,79,2,31,20,11,43,17,26,-12,-6
Murphy,105,2,376,2019-05-12T14:00:00Z,False,4,13,90,5,31,20,11,66,36,30,-35,-25
Zohore,106,3,1,2018-08-11T14:00:00Z,False,4,1,0,0,0,0,0,0,0,0,0,0
Zohore,106,3,12,2018-08-18T11:30:00Z,True,4,14,90,2,0,0,0,0,0,0,0,0
Zohore,106,3,23,2018-08-25T14:00:00Z,False,4,9,58,1,1,1,0,0,0,0,1,0
Zohore,106,3,32,2018-09-02T12:30:00Z,True,4,0,6,1,2,1,1,3,3,0,-1,1
Zohore,106,3,41,2018-09-15T14:00:00Z,False,4,5,0,0,2,1,1,12,6,6,-10,-5
Zohore,106,3,53,2018-09-22T14:00:00Z,True,4,12,27,1,2,1,1,13,9,4,-11,-3
Zohore,106,3,62,2018-09-30T15:00:00Z,True,4,3,70,2,2,1,1,4,3,1,-2,0
Zohore,106,3,78,2018-10-06T14:00:00Z,False,4,16,0,0,2,1,1,15,3,12,-13,-2
Zohore,106,3,82,2018-10-20T14:00:00Z,True,4,8,0,0,2,1,1,5,4,1,-3,0
Zohore,106,3,95,2018-10-27T14:00:00Z,False,4,11,7,1,5,4,1,23,10,13,-18,-9
Zohore,106,3,102,2018-11-03T15:00:00Z,True,4,10,0,0,5,4,1,13,7,6,-8,-2
Zohore,106,3,111,2018-11-10T12:30:00Z,True,4,2,0,0,5,4,1,14,10,4,-9,0
Zohore,106,3,123,2018-11-24T15:00:00Z,False,4,7,0,0,8,7,1,19,13,6,-11,-12
Zohore,106,3,131,2018-11-30T20:00:00Z,True,4,19,0,0,8,7,1,16,8,8,-8,-1
Zohore,106,3,146,2018-12-04T19:45:00Z,False,4,18,0,0,11,10,1,15,7,8,-4,-6
Zohore,106,3,153,2018-12-08T15:00:00Z,True,4,15,0,0,11,10,1,9,5,4,2,6
Zohore,106,3,168,2018-12-15T15:00:00Z,False,4,17,0,0,14,13,1,21,12,9,-7,-11
Zohore,106,3,172,2018-12-22T17:30:00Z,True,4,13,29,1,14,13,1,26,15,11,-12,2
Zohore,106,3,182,2018-12-26T15:00:00Z,False,4,6,0,0,14,13,1,18,8,10,-4,-7
Zohore,106,3,194,2018-12-29T15:00:00Z,False,4,10,0,0,15,13,2,28,14,14,-13,-12
Zohore,106,3,202,2019-01-01T17:30:00Z,True,4,16,0,0,18,13,5,45,18,27,-27,-14
Zohore,106,3,212,2019-01-12T15:00:00Z,True,4,9,0,0,18,13,5,10,5,5,8,8
Zohore,106,3,226,2019-01-19T15:00:00Z,False,4,14,0,0,19,14,5,18,7,11,1,-2
Zohore,106,3,230,2019-01-29T19:45:00Z,False,4,0,17,4,19,14,5,44,29,15,-25,-24
Zohore,106,3,242,2019-02-02T17:30:00Z,True,4,1,7,1,19,14,5,33,24,9,-14,5
Zohore,106,3,256,2019-02-09T15:00:00Z,False,4,15,28,6,22,17,5,24,12,12,-2,-7
Zohore,106,3,263,2019-02-22T19:45:00Z,True,4,17,19,1,25,17,8,37,20,17,-12,0
Zohore,106,3,271,2019-02-26T19:45:00Z,True,4,7,80,2,25,17,8,33,21,12,-8,5
Zohore,106,3,289,2019-03-02T15:00:00Z,False,4,19,90,2,25,17,8,40,21,19,-15,-13
Zohore,106,3,291,2019-03-09T15:00:00Z,True,4,18,0,0,25,17,8,39,24,15,-14,2
Zohore,106,3,313,2019-03-31T13:05:00Z,True,4,5,5,1,28,20,8,57,32,25,-29,-5
Zohore,106,3,324,2019-04-03T18:45:00Z,False,4,12,0,0,28,20,8,77,45,32,-49,-37
Zohore,106,3,331,2019-04-13T14:00:00Z,False,4,3,77,2,28,20,8,36,20,16,-8,-12
Zohore,106,3,301,2019-04-16T18:45:00Z,False,4,2,5,1,28,20,8,33,22,11,-5,-14
Zohore,106,3,342,2019-04-21T15:00:00Z,True,4,11,23,1,31,20,11,85,47,38,-54,-18
Zohore,106,3,353,2019-04-27T14:00:00Z,False,4,8,0,0,31,20,11,23,18,5,8,-7
Zohore,106,3,362,2019-05-04T16:30:00Z,True,4,6,30,1,31,20,11,43,17,26,-12,-6
Zohore,106,3,376,2019-05-12T14:00:00Z,False,4,13,73,2,31,20,11,66,36,30,-35,-25
Bogle,107,3,1,2018-08-11T14:00:00Z,False,4,1,0,0,0,0,0,0,0,0,0,0
Bogle,107,3,12,2018-08-18T11:30:00Z,True,4,14,0,0,0,0,0,0,0,0,0,0
Bogle,107,3,23,2018-08-25T14:00:00Z,False,4,9,0,0,1,1,0,0,0,0,1,0
Bogle,107,3,32,2018-09-02T12:30:00Z,True,4,0,0,0,2,1,1,3,3,0,-1,1
Bogle,107,3,41,2018-09-15T14:00:00Z,False,4,5,0,0,2,1,1,12,6,6,-10,-5
Bogle,107,3,53,2018-09-22T14:00:00Z,True,4,12,0,0,2,1,1,13,9,4,-11,-3
Bogle,107,3,62,2018-09-30T15:00:00Z,True,4,3,0,0,2,1,1,4,3,1,-2,0
Bogle,107,3,78,2018-10-06T14:00:00Z,False,4,16,0,0,2,1,1,15,3,12,-13,-2
Bogle,107,3,82,2018-10-20T14:00:00Z,True,4,8,0,0,2,1,1,5,4,1,-3,0
Bogle,107,3,95,2018-10-27T14:00:00Z,False,4,11,0,0,5,4,1,23,10,13,-18,-9
Bogle,107,3,102,2018-11-03T15:00:00Z,True,4,10,0,0,5,4,1,13,7,6,-8,-2
Bogle,107,3,111,2018-11-10T12:30:00Z,True,4,2,0,0,5,4,1,14,10,4,-9,0
Bogle,107,3,123,2018-11-24T15:00:00Z,False,4,7,0,0,8,7,1,19,13,6,-11,-12
Bogle,107,3,131,2018-11-30T20:00:00Z,True,4,19,0,0,8,7,1,16,8,8,-8,-1
Bogle,107,3,146,2018-12-04T19:45:00Z,False,4,18,0,0,11,10,1,15,7,8,-4,-6
Bogle,107,3,153,2018-12-08T15:00:00Z,True,4,15,0,0,11,10,1,9,5,4,2,6
Bogle,107,3,168,2018-12-15T15:00:00Z,False,4,17,0,0,14,13,1,21,12,9,-7,-11
Bogle,107,3,172,2018-12-22T17:30:00Z,True,4,13,0,0,14,13,1,26,15,11,-12,2
Bogle,107,3,182,2018-12-26T15:00:00Z,False,4,6,0,0,14,13,1,18,8,10,-4,-7
Bogle,107,3,194,2018-12-29T15:00:00Z,False,4,10,0,0,15,13,2,28,14,14,-13,-12
Bogle,107,3,202,2019-01-01T17:30:00Z,True,4,16,0,0,18,13,5,45,18,27,-27,-14
Bogle,107,3,212,2019-01-12T15:00:00Z,True,4,9,0,0,18,13,5,10,5,5,8,8
Bogle,107,3,226,2019-01-19T15:00:00Z,False,4,14,0,0,19,14,5,18,7,11,1,-2
Bogle,107,3,230,2019-01-29T19:45:00Z,False,4,0,0,0,19,14,5,44,29,15,-25,-24
Bogle,107,3,242,2019-02-02T17:30:00Z,True,4,1,0,0,19,14,5,33,24,9,-14,5
Bogle,107,3,256,2019-02-09T15:00:00Z,False,4,15,0,0,22,17,5,24,12,12,-2,-7
Bogle,107,3,263,2019-02-22T19:45:00Z,True,4,17,0,0,25,17,8,37,20,17,-12,0
Bogle,107,3,271,2019-02-26T19:45:00Z,True,4,7,0,0,25,17,8,33,21,12,-8,5
Bogle,107,3,289,2019-03-02T15:00:00Z,False,4,19,0,0,25,17,8,40,21,19,-15,-13
Bogle,107,3,291,2019-03-09T15:00:00Z,True,4,18,0,0,25,17,8,39,24,15,-14,2
Bogle,107,3,313,2019-03-31T13:05:00Z,True,4,5,0,0,28,20,8,57,32,25,-29,-5
Bogle,107,3,324,2019-04-03T18:45:00Z,False,4,12,0,0,28,20,8,77,45,32,-49,-37
Bogle,107,3,331,2019-04-13T14:00:00Z,False,4,3,0,0,28,20,8,36,20,16,-8,-12
Bogle,107,3,301,2019-04-16T18:45:00Z,False,4,2,0,0,28,20,8,33,22,11,-5,-14
Bogle,107,3,342,2019-04-21T15:00:00Z,True,4,11,0,0,31,20,11,85,47,38,-54,-18
Bogle,107,3,353,2019-04-27T14:00:00Z,False,4,8,0,0,31,20,11,23,18,5,8,-7
Bogle,107,3,362,2019-05-04T16:30:00Z,True,4,6,0,0,31,20,11,43,17,26,-12,-6
Bogle,107,3,376,2019-05-12T14:00:00Z,False,4,13,0,0,31,20,11,66,36,30,-35,-25
Madine,108,3,1,2018-08-11T14:00:00Z,False,4,1,2,1,0,0,0,0,0,0,0,0
Madine,108,3,12,2018-08-18T11:30:00Z,True,4,14,0,0,0,0,0,0,0,0,0,0
Madine,108,3,23,2018-08-25T14:00:00Z,False,4,9,0,0,1,1,0,0,0,0,1,0
Madine,108,3,32,2018-09-02T12:30:00Z,True,4,0,1,1,2,1,1,3,3,0,-1,1
Madine,108,3,41,2018-09-15T14:00:00Z,False,4,5,13,1,2,1,1,12,6,6,-10,-5
Madine,108,3,53,2018-09-22T14:00:00Z,True,4,12,0,0,2,1,1,13,9,4,-11,-3
Madine,108,3,62,2018-09-30T15:00:00Z,True,4,3,11,1,2,1,1,4,3,1,-2,0
Madine,108,3,78,2018-10-06T14:00:00Z,False,4,16,0,0,2,1,1,15,3,12,-13,-2
Madine,108,3,82,2018-10-20T14:00:00Z,True,4,8,0,0,2,1,1,5,4,1,-3,0
Madine,108,3,95,2018-10-27T14:00:00Z,False,4,11,0,0,5,4,1,23,10,13,-18,-9
Madine,108,3,102,2018-11-03T15:00:00Z,True,4,10,5,1,5,4,1,13,7,6,-8,-2
Madine,108,3,111,2018-11-10T12:30:00Z,True,4,2,0,0,5,4,1,14,10,4,-9,0
Madine,108,3,123,2018-11-24T15:00:00Z,False,4,7,0,0,8,7,1,19,13,6,-11,-12
Madine,108,3,131,2018-11-30T20:00:00Z,True,4,19,0,0,8,7,1,16,8,8,-8,-1
Madine,108,3,146,2018-12-04T19:45:00Z,False,4,18,0,0,11,10,1,15,7,8,-4,-6
Madine,108,3,153,2018-12-08T15:00:00Z,True,4,15,0,0,11,10,1,9,5,4,2,6
Madine,108,3,168,2018-12-15T15:00:00Z,False,4,17,0,0,14,13,1,21,12,9,-7,-11
Madine,108,3,172,2018-12-22T17:30:00Z,True,4,13,0,0,14,13,1,26,15,11,-12,2
Madine,108,3,182,2018-12-26T15:00:00Z,False,4,6,0,0,14,13,1,18,8,10,-4,-7
Madine,108,3,194,2018-12-29T15:00:00Z,False,4,10,0,0,15,13,2,28,14,14,-13,-12
Madine,108,3,202,2019-01-01T17:30:00Z,True,4,16,0,0,18,13,5,45,18,27,-27,-14
Madine,108,3,212,2019-01-12T15:00:00Z,True,4,9,0,0,18,13,5,10,5,5,8,8
Madine,108,3,226,2019-01-19T15:00:00Z,False,4,14,0,0,19,14,5,18,7,11,1,-2
Madine,108,3,230,2019-01-29T19:45:00Z,False,4,0,0,0,19,14,5,44,29,15,-25,-24
Madine,108,3,242,2019-02-02T17:30:00Z,True,4,1,0,0,19,14,5,33,24,9,-14,5
Madine,108,3,256,2019-02-09T15:00:00Z,False,4,15,0,0,22,17,5,24,12,12,-2,-7
Madine,108,3,263,2019-02-22T19:45:00Z,True,4,17,0,0,25,17,8,37,20,17,-12,0
Madine,108,3,271,2019-02-26T19:45:00Z,True,4,7,0,0,25,17,8,33,21,12,-8,5
Madine,108,3,289,2019-03-02T15:00:00Z,False,4,19,0,0,25,17,8,40,21,19,-15,-13
Madine,108,3,291,2019-03-09T15:00:00Z,True,4,18,0,0,25,17,8,39,24,15,-14,2
Madine,108,3,313,2019-03-31T13:05:00Z,True,4,5,0,0,28,20,8,57,32,25,-29,-5
Madine,108,3,324,2019-04-03T18:45:00Z,False,4,12,0,0,28,20,8,77,45,32,-49,-37
Madine,108,3,331,2019-04-13T14:00:00Z,False,4,3,0,0,28,20,8,36,20,16,-8,-12
Madine,108,3,301,2019-04-16T18:45:00Z,False,4,2,0,0,28,20,8,33,22,11,-5,-14
Madine,108,3,342,2019-04-21T15:00:00Z,True,4,11,0,0,31,20,11,85,47,38,-54,-18
Madine,108,3,353,2019-04-27T14:00:00Z,False,4,8,0,0,31,20,11,23,18,5,8,-7
Madine,108,3,362,2019-05-04T16:30:00Z,True,4,6,0,0,31,20,11,43,17,26,-12,-6
Madine,108,3,376,2019-05-12T14:00:00Z,False,4,13,0,0,31,20,11,66,36,30,-35,-25
Reid,109,3,1,2018-08-11T14:00:00Z,False,4,1,87,2,0,0,0,0,0,0,0,0
Reid,109,3,12,2018-08-18T11:30:00Z,True,4,14,14,1,0,0,0,0,0,0,0,0
Reid,109,3,23,2018-08-25T14:00:00Z,False,4,9,15,1,1,1,0,0,0,0,1,0
Reid,109,3,32,2018-09-02T12:30:00Z,True,4,0,90,2,2,1,1,3,3,0,-1,1
Reid,109,3,41,2018-09-15T14:00:00Z,False,4,5,70,2,2,1,1,12,6,6,-10,-5
Reid,109,3,53,2018-09-22T14:00:00Z,True,4,12,90,2,2,1,1,13,9,4,-11,-3
Reid,109,3,62,2018-09-30T15:00:00Z,True,4,3,0,0,2,1,1,4,3,1,-2,0
Reid,109,3,78,2018-10-06T14:00:00Z,False,4,16,5,1,2,1,1,15,3,12,-13,-2
Reid,109,3,82,2018-10-20T14:00:00Z,True,4,8,90,12,2,1,1,5,4,1,-3,0
Reid,109,3,95,2018-10-27T14:00:00Z,False,4,11,82,2,5,4,1,23,10,13,-18,-9
Reid,109,3,102,2018-11-03T15:00:00Z,True,4,10,64,2,5,4,1,13,7,6,-8,-2
Reid,109,3,111,2018-11-10T12:30:00Z,True,4,2,14,1,5,4,1,14,10,4,-9,0
Reid,109,3,123,2018-11-24T15:00:00Z,False,4,7,0,0,8,7,1,19,13,6,-11,-12
Reid,109,3,131,2018-11-30T20:00:00Z,True,4,19,24,4,8,7,1,16,8,8,-8,-1
Reid,109,3,146,2018-12-04T19:45:00Z,False,4,18,0,0,11,10,1,15,7,8,-4,-6
Reid,109,3,153,2018-12-08T15:00:00Z,True,4,15,0,0,11,10,1,9,5,4,2,6
Reid,109,3,168,2018-12-15T15:00:00Z,False,4,17,12,6,14,13,1,21,12,9,-7,-11
Reid,109,3,172,2018-12-22T17:30:00Z,True,4,13,0,0,14,13,1,26,15,11,-12,2
Reid,109,3,182,2018-12-26T15:00:00Z,False,4,6,90,2,14,13,1,18,8,10,-4,-7
Reid,109,3,194,2018-12-29T15:00:00Z,False,4,10,7,4,15,13,2,28,14,14,-13,-12
Reid,109,3,202,2019-01-01T17:30:00Z,True,4,16,71,2,18,13,5,45,18,27,-27,-14
Reid,109,3,212,2019-01-12T15:00:00Z,True,4,9,0,0,18,13,5,10,5,5,8,8
Reid,109,3,226,2019-01-19T15:00:00Z,False,4,14,26,1,19,14,5,18,7,11,1,-2
Reid,109,3,230,2019-01-29T19:45:00Z,False,4,0,69,2,19,14,5,44,29,15,-25,-24
Reid,109,3,242,2019-02-02T17:30:00Z,True,4,1,85,13,19,14,5,33,24,9,-14,5
Reid,109,3,256,2019-02-09T15:00:00Z,False,4,15,61,2,22,17,5,24,12,12,-2,-7
Reid,109,3,263,2019-02-22T19:45:00Z,True,4,17,0,0,25,17,8,37,20,17,-12,0
Reid,109,3,271,2019-02-26T19:45:00Z,True,4,7,90,2,25,17,8,33,21,12,-8,5
Reid,109,3,289,2019-03-02T15:00:00Z,False,4,19,58,1,25,17,8,40,21,19,-15,-13
Reid,109,3,291,2019-03-09T15:00:00Z,True,4,18,0,0,25,17,8,39,24,15,-14,2
Reid,109,3,313,2019-03-31T13:05:00Z,True,4,5,0,0,28,20,8,57,32,25,-29,-5
Reid,109,3,324,2019-04-03T18:45:00Z,False,4,12,7,1,28,20,8,77,45,32,-49,-37
Reid,109,3,331,2019-04-13T14:00:00Z,False,4,3,9,1,28,20,8,36,20,16,-8,-12
Reid,109,3,301,2019-04-16T18:45:00Z,False,4,2,0,0,28,20,8,33,22,11,-5,-14
Reid,109,3,342,2019-04-21T15:00:00Z,True,4,11,0,0,31,20,11,85,47,38,-54,-18
Reid,109,3,353,2019-04-27T14:00:00Z,False,4,8,3,1,31,20,11,23,18,5,8,-7
Reid,109,3,362,2019-05-04T16:30:00Z,True,4,6,90,8,31,20,11,43,17,26,-12,-6
Reid,109,3,376,2019-05-12T14:00:00Z,False,4,13,90,2,31,20,11,66,36,30,-35,-25
Courtois,110,0,3,2018-08-11T14:00:00Z,False,5,9,0,0,0,0,0,0,0,0,0,0
Courtois,110,0,13,2018-08-18T16:30:00Z,True,5,0,0,0,3,0,3,0,0,0,3,0
Courtois,110,0,26,2018-08-26T15:00:00Z,False,5,14,0,0,6,3,3,1,0,1,5,3
Courtois,110,0,33,2018-09-01T14:00:00Z,True,5,1,0,0,9,3,6,7,4,3,2,0
Courtois,110,0,41,2018-09-15T14:00:00Z,True,5,4,0,0,12,6,6,2,1,1,10,5
Courtois,110,0,59,2018-09-23T12:30:00Z,False,5,18,0,0,15,9,6,3,0,3,12,6
Courtois,110,0,63,2018-09-29T16:30:00Z,True,5,11,0,0,16,9,7,18,9,9,-2,0
Courtois,110,0,77,2018-10-07T13:15:00Z,False,5,15,0,0,17,10,7,5,2,3,12,5
Courtois,110,0,83,2018-10-20T11:30:00Z,True,5,13,0,0,20,10,10,13,7,6,7,4
Courtois,110,0,91,2018-10-28T13:30:00Z,False,5,3,0,0,21,11,10,8,4,4,13,6
Courtois,110,0,103,2018-11-04T16:00:00Z,True,5,6,0,0,24,11,13,8,2,6,16,5
Courtois,110,0,112,2018-11-11T14:15:00Z,True,5,7,0,0,27,14,13,18,13,5,9,9
Courtois,110,0,126,2018-11-24T17:30:00Z,False,5,16,0,0,28,15,13,27,6,21,1,7
Courtois,110,0,132,2018-12-02T12:00:00Z,True,5,8,0,0,28,15,13,8,7,1,20,14
Courtois,110,0,147,2018-12-05T19:45:00Z,False,5,19,0,0,31,18,13,16,8,8,15,5
Courtois,110,0,154,2018-12-08T17:30:00Z,True,5,12,0,0,31,18,13,41,24,17,-10,1
Courtois,110,0,160,2018-12-16T13:30:00Z,False,5,2,0,0,34,21,13,21,14,7,13,-1
Courtois,110,0,173,2018-12-22T15:00:00Z,True,5,10,0,0,37,21,16,22,11,11,15,10
Courtois,110,0,189,2018-12-26T19:30:00Z,False,5,17,0,0,37,21,16,27,15,12,10,1
Courtois,110,0,192,2018-12-30T12:00:00Z,False,5,6,0,0,40,21,19,19,9,10,21,10
Courtois,110,0,203,2019-01-02T19:45:00Z,True,5,15,0,0,43,21,22,15,8,7,28,14
Courtois,110,0,213,2019-01-12T17:30:00Z,True,5,14,0,0,44,22,22,18,7,11,26,11
Courtois,110,0,220,2019-01-19T17:30:00Z,False,5,0,0,0,47,25,22,41,26,15,6,-4
Courtois,110,0,231,2019-01-30T19:45:00Z,False,5,1,0,0,47,25,22,30,21,9,17,1
Courtois,110,0,243,2019-02-02T15:00:00Z,True,5,9,0,0,47,25,22,11,5,6,36,19
Courtois,110,0,255,2019-02-10T16:00:00Z,False,5,12,0,0,50,28,22,62,36,26,-12,-14
Courtois,110,0,275,2019-02-27T20:00:00Z,True,5,16,0,0,50,28,22,60,27,33,-10,-5
Courtois,110,0,284,2019-03-03T14:05:00Z,False,5,8,0,0,53,31,22,17,15,2,36,7
Courtois,110,0,292,2019-03-10T14:05:00Z,True,5,19,0,0,56,31,25,43,24,19,13,12
Courtois,110,0,303,2019-03-17T16:30:00Z,False,5,7,0,0,57,32,25,37,22,15,20,3
Courtois,110,0,313,2019-03-31T13:05:00Z,False,5,4,0,0,57,32,25,28,20,8,29,5
Courtois,110,0,264,2019-04-03T18:45:00Z,True,5,2,0,0,60,32,28,33,22,11,27,21
Courtois,110,0,321,2019-04-08T19:00:00Z,True,5,18,0,0,63,35,28,42,27,15,21,20
Courtois,110,0,335,2019-04-14T15:30:00Z,False,5,11,0,0,66,38,28,82,44,38,-16,-16
Courtois,110,0,343,2019-04-22T19:00:00Z,True,5,3,0,0,66,38,28,39,23,16,27,22
Courtois,110,0,356,2019-04-28T15:30:00Z,False,5,13,0,0,67,39,28,64,35,29,3,-7
Courtois,110,0,363,2019-05-05T13:00:00Z,True,5,17,0,0,68,39,29,50,27,23,18,16
Courtois,110,0,374,2019-05-12T14:00:00Z,False,5,10,0,0,71,42,29,51,26,25,20,3
Caballero,111,0,3,2018-08-11T14:00:00Z,False,5,9,0,0,0,0,0,0,0,0,0,0
Caballero,111,0,13,2018-08-18T16:30:00Z,True,5,0,0,0,3,0,3,0,0,0,3,0
Caballero,111,0,26,2018-08-26T15:00:00Z,False,5,14,0,0,6,3,3,1,0,1,5,3
Caballero,111,0,33,2018-09-01T14:00:00Z,True,5,1,0,0,9,3,6,7,4,3,2,0
Caballero,111,0,41,2018-09-15T14:00:00Z,True,5,4,0,0,12,6,6,2,1,1,10,5
Caballero,111,0,59,2018-09-23T12:30:00Z,False,5,18,0,0,15,9,6,3,0,3,12,6
Caballero,111,0,63,2018-09-29T16:30:00Z,True,5,11,0,0,16,9,7,18,9,9,-2,0
Caballero,111,0,77,2018-10-07T13:15:00Z,False,5,15,0,0,17,10,7,5,2,3,12,5
Caballero,111,0,83,2018-10-20T11:30:00Z,True,5,13,0,0,20,10,10,13,7,6,7,4
Caballero,111,0,91,2018-10-28T13:30:00Z,False,5,3,0,0,21,11,10,8,4,4,13,6
Caballero,111,0,103,2018-11-04T16:00:00Z,True,5,6,0,0,24,11,13,8,2,6,16,5
Caballero,111,0,112,2018-11-11T14:15:00Z,True,5,7,0,0,27,14,13,18,13,5,9,9
Caballero,111,0,126,2018-11-24T17:30:00Z,False,5,16,0,0,28,15,13,27,6,21,1,7
Caballero,111,0,132,2018-12-02T12:00:00Z,True,5,8,0,0,28,15,13,8,7,1,20,14
Caballero,111,0,147,2018-12-05T19:45:00Z,False,5,19,0,0,31,18,13,16,8,8,15,5
Caballero,111,0,154,2018-12-08T17:30:00Z,True,5,12,0,0,31,18,13,41,24,17,-10,1
Caballero,111,0,160,2018-12-16T13:30:00Z,False,5,2,0,0,34,21,13,21,14,7,13,-1
Caballero,111,0,173,2018-12-22T15:00:00Z,True,5,10,0,0,37,21,16,22,11,11,15,10
Caballero,111,0,189,2018-12-26T19:30:00Z,False,5,17,0,0,37,21,16,27,15,12,10,1
Caballero,111,0,192,2018-12-30T12:00:00Z,False,5,6,0,0,40,21,19,19,9,10,21,10
Caballero,111,0,203,2019-01-02T19:45:00Z,True,5,15,0,0,43,21,22,15,8,7,28,14
Caballero,111,0,213,2019-01-12T17:30:00Z,True,5,14,0,0,44,22,22,18,7,11,26,11
Caballero,111,0,220,2019-01-19T17:30:00Z,False,5,0,0,0,47,25,22,41,26,15,6,-4
Caballero,111,0,231,2019-01-30T19:45:00Z,False,5,1,0,0,47,25,22,30,21,9,17,1
Caballero,111,0,243,2019-02-02T15:00:00Z,True,5,9,0,0,47,25,22,11,5,6,36,19
Caballero,111,0,255,2019-02-10T16:00:00Z,False,5,12,0,0,50,28,22,62,36,26,-12,-14
Caballero,111,0,275,2019-02-27T20:00:00Z,True,5,16,90,6,50,28,22,60,27,33,-10,-5
Caballero,111,0,284,2019-03-03T14:05:00Z,False,5,8,0,0,53,31,22,17,15,2,36,7
Caballero,111,0,292,2019-03-10T14:05:00Z,True,5,19,0,0,56,31,25,43,24,19,13,12
Caballero,111,0,303,2019-03-17T16:30:00Z,False,5,7,0,0,57,32,25,37,22,15,20,3
Caballero,111,0,313,2019-03-31T13:05:00Z,False,5,4,0,0,57,32,25,28,20,8,29,5
Caballero,111,0,264,2019-04-03T18:45:00Z,True,5,2,0,0,60,32,28,33,22,11,27,21
Caballero,111,0,321,2019-04-08T19:00:00Z,True,5,18,0,0,63,35,28,42,27,15,21,20
Caballero,111,0,335,2019-04-14T15:30:00Z,False,5,11,0,0,66,38,28,82,44,38,-16,-16
Caballero,111,0,343,2019-04-22T19:00:00Z,True,5,3,0,0,66,38,28,39,23,16,27,22
Caballero,111,0,356,2019-04-28T15:30:00Z,False,5,13,0,0,67,39,28,64,35,29,3,-7
Caballero,111,0,363,2019-05-05T13:00:00Z,True,5,17,0,0,68,39,29,50,27,23,18,16
Caballero,111,0,374,2019-05-12T14:00:00Z,False,5,10,90,7,71,42,29,51,26,25,20,3
Azpilicueta,112,1,3,2018-08-11T14:00:00Z,False,5,9,90,6,0,0,0,0,0,0,0,0
Azpilicueta,112,1,13,2018-08-18T16:30:00Z,True,5,0,90,4,3,0,3,0,0,0,3,0
Azpilicueta,112,1,26,2018-08-26T15:00:00Z,False,5,14,90,2,6,3,3,1,0,1,5,3
Azpilicueta,112,1,33,2018-09-01T14:00:00Z,True,5,1,90,6,9,3,6,7,4,3,2,0
Azpilicueta,112,1,41,2018-09-15T14:00:00Z,True,5,4,90,2,12,6,6,2,1,1,10,5
Azpilicueta,112,1,59,2018-09-23T12:30:00Z,False,5,18,90,6,15,9,6,3,0,3,12,6
Azpilicueta,112,1,63,2018-09-29T16:30:00Z,True,5,11,90,2,16,9,7,18,9,9,-2,0
Azpilicueta,112,1,77,2018-10-07T13:15:00Z,False,5,15,90,6,17,10,7,5,2,3,12,5
Azpilicueta,112,1,83,2018-10-20T11:30:00Z,True,5,13,90,1,20,10,10,13,7,6,7,4
Azpilicueta,112,1,91,2018-10-28T13:30:00Z,False,5,3,90,7,21,11,10,8,4,4,13,6
Azpilicueta,112,1,103,2018-11-04T16:00:00Z,True,5,6,90,2,24,11,13,8,2,6,16,5
Azpilicueta,112,1,112,2018-11-11T14:15:00Z,True,5,7,90,6,27,14,13,18,13,5,9,9
Azpilicueta,112,1,126,2018-11-24T17:30:00Z,False,5,16,90,5,28,15,13,27,6,21,1,7
Azpilicueta,112,1,132,2018-12-02T12:00:00Z,True,5,8,90,5,28,15,13,8,7,1,20,14
Azpilicueta,112,1,147,2018-12-05T19:45:00Z,False,5,19,90,1,31,18,13,16,8,8,15,5
Azpilicueta,112,1,154,2018-12-08T17:30:00Z,True,5,12,90,8,31,18,13,41,24,17,-10,1
Azpilicueta,112,1,160,2018-12-16T13:30:00Z,False,5,2,90,2,34,21,13,21,14,7,13,-1
Azpilicueta,112,1,173,2018-12-22T15:00:00Z,True,5,10,90,2,37,21,16,22,11,11,15,10
Azpilicueta,112,1,189,2018-12-26T19:30:00Z,False,5,17,90,2,37,21,16,27,15,12,10,1
Azpilicueta,112,1,192,2018-12-30T12:00:00Z,False,5,6,90,6,40,21,19,19,9,10,21,10
Azpilicueta,112,1,203,2019-01-02T19:45:00Z,True,5,15,90,6,43,21,22,15,8,7,28,14
Azpilicueta,112,1,213,2019-01-12T17:30:00Z,True,5,14,90,2,44,22,22,18,7,11,26,11
Azpilicueta,112,1,220,2019-01-19T17:30:00Z,False,5,0,90,1,47,25,22,41,26,15,6,-4
Azpilicueta,112,1,231,2019-01-30T19:45:00Z,False,5,1,90,0,47,25,22,30,21,9,17,1
Azpilicueta,112,1,243,2019-02-02T15:00:00Z,True,5,9,90,9,47,25,22,11,5,6,36,19
Azpilicueta,112,1,255,2019-02-10T16:00:00Z,False,5,12,90,-1,50,28,22,62,36,26,-12,-14
Azpilicueta,112,1,275,2019-02-27T20:00:00Z,True,5,16,90,12,50,28,22,60,27,33,-10,-5
Azpilicueta,112,1,284,2019-03-03T14:05:00Z,False,5,8,90,6,53,31,22,17,15,2,36,7
Azpilicueta,112,1,292,2019-03-10T14:05:00Z,True,5,19,90,2,56,31,25,43,24,19,13,12
Azpilicueta,112,1,303,2019-03-17T16:30:00Z,False,5,7,90,1,57,32,25,37,22,15,20,3
Azpilicueta,112,1,313,2019-03-31T13:05:00Z,False,5,4,90,10,57,32,25,28,20,8,29,5
Azpilicueta,112,1,264,2019-04-03T18:45:00Z,True,5,2,72,6,60,32,28,33,22,11,27,21
Azpilicueta,112,1,321,2019-04-08T19:00:00Z,True,5,18,90,5,63,35,28,42,27,15,21,20
Azpilicueta,112,1,335,2019-04-14T15:30:00Z,False,5,11,90,0,66,38,28,82,44,38,-16,-16
Azpilicueta,112,1,343,2019-04-22T19:00:00Z,True,5,3,90,4,66,38,28,39,23,16,27,22
Azpilicueta,112,1,356,2019-04-28T15:30:00Z,False,5,13,90,2,67,39,28,64,35,29,3,-7
Azpilicueta,112,1,363,2019-05-05T13:00:00Z,True,5,17,90,6,68,39,29,50,27,23,18,16
Azpilicueta,112,1,374,2019-05-12T14:00:00Z,False,5,10,90,6,71,42,29,51,26,25,20,3
Cahill,113,1,3,2018-08-11T14:00:00Z,False,5,9,0,0,0,0,0,0,0,0,0,0
Cahill,113,1,13,2018-08-18T16:30:00Z,True,5,0,0,0,3,0,3,0,0,0,3,0
Cahill,113,1,26,2018-08-26T15:00:00Z,False,5,14,0,0,6,3,3,1,0,1,5,3
Cahill,113,1,33,2018-09-01T14:00:00Z,True,5,1,0,0,9,3,6,7,4,3,2,0
Cahill,113,1,41,2018-09-15T14:00:00Z,True,5,4,0,0,12,6,6,2,1,1,10,5
Cahill,113,1,59,2018-09-23T12:30:00Z,False,5,18,21,1,15,9,6,3,0,3,12,6
Cahill,113,1,63,2018-09-29T16:30:00Z,True,5,11,0,0,16,9,7,18,9,9,-2,0
Cahill,113,1,77,2018-10-07T13:15:00Z,False,5,15,0,0,17,10,7,5,2,3,12,5
Cahill,113,1,83,2018-10-20T11:30:00Z,True,5,13,0,0,20,10,10,13,7,6,7,4
Cahill,113,1,91,2018-10-28T13:30:00Z,False,5,3,0,0,21,11,10,8,4,4,13,6
Cahill,113,1,103,2018-11-04T16:00:00Z,True,5,6,0,0,24,11,13,8,2,6,16,5
Cahill,113,1,112,2018-11-11T14:15:00Z,True,5,7,0,0,27,14,13,18,13,5,9,9
Cahill,113,1,126,2018-11-24T17:30:00Z,False,5,16,0,0,28,15,13,27,6,21,1,7
Cahill,113,1,132,2018-12-02T12:00:00Z,True,5,8,0,0,28,15,13,8,7,1,20,14
Cahill,113,1,147,2018-12-05T19:45:00Z,False,5,19,0,0,31,18,13,16,8,8,15,5
Cahill,113,1,154,2018-12-08T17:30:00Z,True,5,12,0,0,31,18,13,41,24,17,-10,1
Cahill,113,1,160,2018-12-16T13:30:00Z,False,5,2,0,0,34,21,13,21,14,7,13,-1
Cahill,113,1,173,2018-12-22T15:00:00Z,True,5,10,0,0,37,21,16,22,11,11,15,10
Cahill,113,1,189,2018-12-26T19:30:00Z,False,5,17,0,0,37,21,16,27,15,12,10,1
Cahill,113,1,192,2018-12-30T12:00:00Z,False,5,6,0,0,40,21,19,19,9,10,21,10
Cahill,113,1,203,2019-01-02T19:45:00Z,True,5,15,0,0,43,21,22,15,8,7,28,14
Cahill,113,1,213,2019-01-12T17:30:00Z,True,5,14,0,0,44,22,22,18,7,11,26,11
Cahill,113,1,220,2019-01-19T17:30:00Z,False,5,0,0,0,47,25,22,41,26,15,6,-4
Cahill,113,1,231,2019-01-30T19:45:00Z,False,5,1,0,0,47,25,22,30,21,9,17,1
Cahill,113,1,243,2019-02-02T15:00:00Z,True,5,9,0,0,47,25,22,11,5,6,36,19
Cahill,113,1,255,2019-02-10T16:00:00Z,False,5,12,0,0,50,28,22,62,36,26,-12,-14
Cahill,113,1,275,2019-02-27T20:00:00Z,True,5,16,0,0,50,28,22,60,27,33,-10,-5
Cahill,113,1,284,2019-03-03T14:05:00Z,False,5,8,0,0,53,31,22,17,15,2,36,7
Cahill,113,1,292,2019-03-10T14:05:00Z,True,5,19,0,0,56,31,25,43,24,19,13,12
Cahill,113,1,303,2019-03-17T16:30:00Z,False,5,7,0,0,57,32,25,37,22,15,20,3
Cahill,113,1,313,2019-03-31T13:05:00Z,False,5,4,0,0,57,32,25,28,20,8,29,5
Cahill,113,1,264,2019-04-03T18:45:00Z,True,5,2,0,0,60,32,28,33,22,11,27,21
Cahill,113,1,321,2019-04-08T19:00:00Z,True,5,18,0,0,63,35,28,42,27,15,21,20
Cahill,113,1,335,2019-04-14T15:30:00Z,False,5,11,0,0,66,38,28,82,44,38,-16,-16
Cahill,113,1,343,2019-04-22T19:00:00Z,True,5,3,0,0,66,38,28,39,23,16,27,22
Cahill,113,1,356,2019-04-28T15:30:00Z,False,5,13,0,0,67,39,28,64,35,29,3,-7
Cahill,113,1,363,2019-05-05T13:00:00Z,True,5,17,1,1,68,39,29,50,27,23,18,16
Cahill,113,1,374,2019-05-12T14:00:00Z,False,5,10,0,0,71,42,29,51,26,25,20,3
Alonso,114,1,3,2018-08-11T14:00:00Z,False,5,9,90,11,0,0,0,0,0,0,0,0
Alonso,114,1,13,2018-08-18T16:30:00Z,True,5,0,90,13,3,0,3,0,0,0,3,0
Alonso,114,1,26,2018-08-26T15:00:00Z,False,5,14,90,11,6,3,3,1,0,1,5,3
Alonso,114,1,33,2018-09-01T14:00:00Z,True,5,1,90,9,9,3,6,7,4,3,2,0
Alonso,114,1,41,2018-09-15T14:00:00Z,True,5,4,90,2,12,6,6,2,1,1,10,5
Alonso,114,1,59,2018-09-23T12:30:00Z,False,5,18,90,6,15,9,6,3,0,3,12,6
Alonso,114,1,63,2018-09-29T16:30:00Z,True,5,11,90,2,16,9,7,18,9,9,-2,0
Alonso,114,1,77,2018-10-07T13:15:00Z,False,5,15,90,6,17,10,7,5,2,3,12,5
Alonso,114,1,83,2018-10-20T11:30:00Z,True,5,13,90,1,20,10,10,13,7,6,7,4
Alonso,114,1,91,2018-10-28T13:30:00Z,False,5,3,90,11,21,11,10,8,4,4,13,6
Alonso,114,1,103,2018-11-04T16:00:00Z,True,5,6,90,6,24,11,13,8,2,6,16,5
Alonso,114,1,112,2018-11-11T14:15:00Z,True,5,7,90,8,27,14,13,18,13,5,9,9
Alonso,114,1,126,2018-11-24T17:30:00Z,False,5,16,90,1,28,15,13,27,6,21,1,7
Alonso,114,1,132,2018-12-02T12:00:00Z,True,5,8,77,6,28,15,13,8,7,1,20,14
Alonso,114,1,147,2018-12-05T19:45:00Z,False,5,19,90,0,31,18,13,16,8,8,15,5
Alonso,114,1,154,2018-12-08T17:30:00Z,True,5,12,90,6,31,18,13,41,24,17,-10,1
Alonso,114,1,160,2018-12-16T13:30:00Z,False,5,2,90,1,34,21,13,21,14,7,13,-1
Alonso,114,1,173,2018-12-22T15:00:00Z,True,5,10,90,2,37,21,16,22,11,11,15,10
Alonso,114,1,189,2018-12-26T19:30:00Z,False,5,17,90,2,37,21,16,27,15,12,10,1
Alonso,114,1,192,2018-12-30T12:00:00Z,False,5,6,90,5,40,21,19,19,9,10,21,10
Alonso,114,1,203,2019-01-02T19:45:00Z,True,5,15,90,8,43,21,22,15,8,7,28,14
Alonso,114,1,213,2019-01-12T17:30:00Z,True,5,14,90,2,44,22,22,18,7,11,26,11
Alonso,114,1,220,2019-01-19T17:30:00Z,False,5,0,90,1,47,25,22,41,26,15,6,-4
Alonso,114,1,231,2019-01-30T19:45:00Z,False,5,1,0,0,47,25,22,30,21,9,17,1
Alonso,114,1,243,2019-02-02T15:00:00Z,True,5,9,90,6,47,25,22,11,5,6,36,19
Alonso,114,1,255,2019-02-10T16:00:00Z,False,5,12,72,-1,50,28,22,62,36,26,-12,-14
Alonso,114,1,275,2019-02-27T20:00:00Z,True,5,16,90,9,50,28,22,60,27,33,-10,-5
Alonso,114,1,284,2019-03-03T14:05:00Z,False,5,8,0,0,53,31,22,17,15,2,36,7
Alonso,114,1,292,2019-03-10T14:05:00Z,True,5,19,0,0,56,31,25,43,24,19,13,12
Alonso,114,1,303,2019-03-17T16:30:00Z,False,5,7,90,0,57,32,25,37,22,15,20,3
Alonso,114,1,313,2019-03-31T13:05:00Z,False,5,4,90,5,57,32,25,28,20,8,29,5
Alonso,114,1,264,2019-04-03T18:45:00Z,True,5,2,0,0,60,32,28,33,22,11,27,21
Alonso,114,1,321,2019-04-08T19:00:00Z,True,5,18,0,0,63,35,28,42,27,15,21,20
Alonso,114,1,335,2019-04-14T15:30:00Z,False,5,11,0,0,66,38,28,82,44,38,-16,-16
Alonso,114,1,343,2019-04-22T19:00:00Z,True,5,3,0,0,66,38,28,39,23,16,27,22
Alonso,114,1,356,2019-04-28T15:30:00Z,False,5,13,90,10,67,39,28,64,35,29,3,-7
Alonso,114,1,363,2019-05-05T13:00:00Z,True,5,17,90,6,68,39,29,50,27,23,18,16
Alonso,114,1,374,2019-05-12T14:00:00Z,False,5,10,90,6,71,42,29,51,26,25,20,3
David Luiz,115,1,3,2018-08-11T14:00:00Z,False,5,9,90,5,0,0,0,0,0,0,0,0
David Luiz,115,1,13,2018-08-18T16:30:00Z,True,5,0,90,1,3,0,3,0,0,0,3,0
David Luiz,115,1,26,2018-08-26T15:00:00Z,False,5,14,90,2,6,3,3,1,0,1,5,3
David Luiz,115,1,33,2018-09-01T14:00:00Z,True,5,1,90,8,9,3,6,7,4,3,2,0
David Luiz,115,1,41,2018-09-15T14:00:00Z,True,5,4,90,2,12,6,6,2,1,1,10,5
David Luiz,115,1,59,2018-09-23T12:30:00Z,False,5,18,90,6,15,9,6,3,0,3,12,6
David Luiz,115,1,63,2018-09-29T16:30:00Z,True,5,11,90,3,16,9,7,18,9,9,-2,0
David Luiz,115,1,77,2018-10-07T13:15:00Z,False,5,15,90,6,17,10,7,5,2,3,12,5
David Luiz,115,1,83,2018-10-20T11:30:00Z,True,5,13,90,1,20,10,10,13,7,6,7,4
David Luiz,115,1,91,2018-10-28T13:30:00Z,False,5,3,90,6,21,11,10,8,4,4,13,6
David Luiz,115,1,103,2018-11-04T16:00:00Z,True,5,6,90,2,24,11,13,8,2,6,16,5
David Luiz,115,1,112,2018-11-11T14:15:00Z,True,5,7,90,9,27,14,13,18,13,5,9,9
David Luiz,115,1,126,2018-11-24T17:30:00Z,False,5,16,90,1,28,15,13,27,6,21,1,7
David Luiz,115,1,132,2018-12-02T12:00:00Z,True,5,8,90,6,28,15,13,8,7,1,20,14
David Luiz,115,1,147,2018-12-05T19:45:00Z,False,5,19,0,0,31,18,13,16,8,8,15,5
David Luiz,115,1,154,2018-12-08T17:30:00Z,True,5,12,90,15,31,18,13,41,24,17,-10,1
David Luiz,115,1,160,2018-12-16T13:30:00Z,False,5,2,90,2,34,21,13,21,14,7,13,-1
David Luiz,115,1,173,2018-12-22T15:00:00Z,True,5,10,90,2,37,21,16,22,11,11,15,10
David Luiz,115,1,189,2018-12-26T19:30:00Z,False,5,17,90,2,37,21,16,27,15,12,10,1
David Luiz,115,1,192,2018-12-30T12:00:00Z,False,5,6,90,12,40,21,19,19,9,10,21,10
David Luiz,115,1,203,2019-01-02T19:45:00Z,True,5,15,90,6,43,21,22,15,8,7,28,14
David Luiz,115,1,213,2019-01-12T17:30:00Z,True,5,14,90,8,44,22,22,18,7,11,26,11
David Luiz,115,1,220,2019-01-19T17:30:00Z,False,5,0,90,0,47,25,22,41,26,15,6,-4
David Luiz,115,1,231,2019-01-30T19:45:00Z,False,5,1,90,0,47,25,22,30,21,9,17,1
David Luiz,115,1,243,2019-02-02T15:00:00Z,True,5,9,90,13,47,25,22,11,5,6,36,19
David Luiz,115,1,255,2019-02-10T16:00:00Z,False,5,12,90,-1,50,28,22,62,36,26,-12,-14
David Luiz,115,1,275,2019-02-27T20:00:00Z,True,5,16,90,5,50,28,22,60,27,33,-10,-5
David Luiz,115,1,284,2019-03-03T14:05:00Z,False,5,8,0,0,53,31,22,17,15,2,36,7
David Luiz,115,1,292,2019-03-10T14:05:00Z,True,5,19,90,2,56,31,25,43,24,19,13,12
David Luiz,115,1,303,2019-03-17T16:30:00Z,False,5,7,90,1,57,32,25,37,22,15,20,3
David Luiz,115,1,313,2019-03-31T13:05:00Z,False,5,4,90,2,57,32,25,28,20,8,29,5
David Luiz,115,1,264,2019-04-03T18:45:00Z,True,5,2,90,6,60,32,28,33,22,11,27,21
David Luiz,115,1,321,2019-04-08T19:00:00Z,True,5,18,90,6,63,35,28,42,27,15,21,20
David Luiz,115,1,335,2019-04-14T15:30:00Z,False,5,11,90,1,66,38,28,82,44,38,-16,-16
David Luiz,115,1,343,2019-04-22T19:00:00Z,True,5,3,90,1,66,38,28,39,23,16,27,22
David Luiz,115,1,356,2019-04-28T15:30:00Z,False,5,13,90,2,67,39,28,64,35,29,3,-7
David Luiz,115,1,363,2019-05-05T13:00:00Z,True,5,17,88,15,68,39,29,50,27,23,18,16
David Luiz,115,1,374,2019-05-12T14:00:00Z,False,5,10,90,6,71,42,29,51,26,25,20,3
Moses,116,1,3,2018-08-11T14:00:00Z,False,5,9,9,1,0,0,0,0,0,0,0,0
Moses,116,1,13,2018-08-18T16:30:00Z,True,5,0,0,0,3,0,3,0,0,0,3,0
Moses,116,1,26,2018-08-26T15:00:00Z,False,5,14,0,0,6,3,3,1,0,1,5,3
Moses,116,1,33,2018-09-01T14:00:00Z,True,5,1,0,0,9,3,6,7,4,3,2,0
Moses,116,1,41,2018-09-15T14:00:00Z,True,5,4,0,0,12,6,6,2,1,1,10,5
Moses,116,1,59,2018-09-23T12:30:00Z,False,5,18,0,0,15,9,6,3,0,3,12,6
Moses,116,1,63,2018-09-29T16:30:00Z,True,5,11,17,1,16,9,7,18,9,9,-2,0
Moses,116,1,77,2018-10-07T13:15:00Z,False,5,15,0,0,17,10,7,5,2,3,12,5
Moses,116,1,83,2018-10-20T11:30:00Z,True,5,13,0,0,20,10,10,13,7,6,7,4
Moses,116,1,91,2018-10-28T13:30:00Z,False,5,3,0,0,21,11,10,8,4,4,13,6
Moses,116,1,103,2018-11-04T16:00:00Z,True,5,6,0,0,24,11,13,8,2,6,16,5
Moses,116,1,112,2018-11-11T14:15:00Z,True,5,7,0,0,27,14,13,18,13,5,9,9
Moses,116,1,126,2018-11-24T17:30:00Z,False,5,16,0,0,28,15,13,27,6,21,1,7
Moses,116,1,132,2018-12-02T12:00:00Z,True,5,8,0,0,28,15,13,8,7,1,20,14
Moses,116,1,147,2018-12-05T19:45:00Z,False,5,19,0,0,31,18,13,16,8,8,15,5
Moses,116,1,154,2018-12-08T17:30:00Z,True,5,12,0,0,31,18,13,41,24,17,-10,1
Moses,116,1,160,2018-12-16T13:30:00Z,False,5,2,0,0,34,21,13,21,14,7,13,-1
Moses,116,1,173,2018-12-22T15:00:00Z,True,5,10,0,0,37,21,16,22,11,11,15,10
Moses,116,1,189,2018-12-26T19:30:00Z,False,5,17,0,0,37,21,16,27,15,12,10,1
Moses,116,1,192,2018-12-30T12:00:00Z,False,5,6,0,0,40,21,19,19,9,10,21,10
Moses,116,1,203,2019-01-02T19:45:00Z,True,5,15,0,0,43,21,22,15,8,7,28,14
Moses,116,1,213,2019-01-12T17:30:00Z,True,5,14,0,0,44,22,22,18,7,11,26,11
Moses,116,1,220,2019-01-19T17:30:00Z,False,5,0,0,0,47,25,22,41,26,15,6,-4
Moses,116,1,231,2019-01-30T19:45:00Z,False,5,1,0,0,47,25,22,30,21,9,17,1
Moses,116,1,243,2019-02-02T15:00:00Z,True,5,9,0,0,47,25,22,11,5,6,36,19
Moses,116,1,255,2019-02-10T16:00:00Z,False,5,12,0,0,50,28,22,62,36,26,-12,-14
Moses,116,1,275,2019-02-27T20:00:00Z,True,5,16,0,0,50,28,22,60,27,33,-10,-5
Moses,116,1,284,2019-03-03T14:05:00Z,False,5,8,0,0,53,31,22,17,15,2,36,7
Moses,116,1,292,2019-03-10T14:05:00Z,True,5,19,0,0,56,31,25,43,24,19,13,12
Moses,116,1,303,2019-03-17T16:30:00Z,False,5,7,0,0,57,32,25,37,22,15,20,3
Moses,116,1,313,2019-03-31T13:05:00Z,False,5,4,0,0,57,32,25,28,20,8,29,5
Moses,116,1,264,2019-04-03T18:45:00Z,True,5,2,0,0,60,32,28,33,22,11,27,21
Moses,116,1,321,2019-04-08T19:00:00Z,True,5,18,0,0,63,35,28,42,27,15,21,20
Moses,116,1,335,2019-04-14T15:30:00Z,False,5,11,0,0,66,38,28,82,44,38,-16,-16
Moses,116,1,343,2019-04-22T19:00:00Z,True,5,3,0,0,66,38,28,39,23,16,27,22
Moses,116,1,356,2019-04-28T15:30:00Z,False,5,13,0,0,67,39,28,64,35,29,3,-7
Moses,116,1,363,2019-05-05T13:00:00Z,True,5,17,0,0,68,39,29,50,27,23,18,16
Moses,116,1,374,2019-05-12T14:00:00Z,False,5,10,0,0,71,42,29,51,26,25,20,3
Rudiger,117,1,3,2018-08-11T14:00:00Z,False,5,9,90,9,0,0,0,0,0,0,0,0
Rudiger,117,1,13,2018-08-18T16:30:00Z,True,5,0,90,1,3,0,3,0,0,0,3,0
Rudiger,117,1,26,2018-08-26T15:00:00Z,False,5,14,90,2,6,3,3,1,0,1,5,3
Rudiger,117,1,33,2018-09-01T14:00:00Z,True,5,1,90,6,9,3,6,7,4,3,2,0
Rudiger,117,1,41,2018-09-15T14:00:00Z,True,5,4,90,2,12,6,6,2,1,1,10,5
Rudiger,117,1,59,2018-09-23T12:30:00Z,False,5,18,68,6,15,9,6,3,0,3,12,6
Rudiger,117,1,63,2018-09-29T16:30:00Z,True,5,11,90,2,16,9,7,18,9,9,-2,0
Rudiger,117,1,77,2018-10-07T13:15:00Z,False,5,15,90,6,17,10,7,5,2,3,12,5
Rudiger,117,1,83,2018-10-20T11:30:00Z,True,5,13,90,11,20,10,10,13,7,6,7,4
Rudiger,117,1,91,2018-10-28T13:30:00Z,False,5,3,90,6,21,11,10,8,4,4,13,6
Rudiger,117,1,103,2018-11-04T16:00:00Z,True,5,6,90,2,24,11,13,8,2,6,16,5
Rudiger,117,1,112,2018-11-11T14:15:00Z,True,5,7,90,5,27,14,13,18,13,5,9,9
Rudiger,117,1,126,2018-11-24T17:30:00Z,False,5,16,90,0,28,15,13,27,6,21,1,7
Rudiger,117,1,132,2018-12-02T12:00:00Z,True,5,8,90,7,28,15,13,8,7,1,20,14
Rudiger,117,1,147,2018-12-05T19:45:00Z,False,5,19,90,1,31,18,13,16,8,8,15,5
Rudiger,117,1,154,2018-12-08T17:30:00Z,True,5,12,90,6,31,18,13,41,24,17,-10,1
Rudiger,117,1,160,2018-12-16T13:30:00Z,False,5,2,90,2,34,21,13,21,14,7,13,-1
Rudiger,117,1,173,2018-12-22T15:00:00Z,True,5,10,90,2,37,21,16,22,11,11,15,10
Rudiger,117,1,189,2018-12-26T19:30:00Z,False,5,17,90,2,37,21,16,27,15,12,10,1
Rudiger,117,1,192,2018-12-30T12:00:00Z,False,5,6,90,7,40,21,19,19,9,10,21,10
Rudiger,117,1,203,2019-01-02T19:45:00Z,True,5,15,90,5,43,21,22,15,8,7,28,14
Rudiger,117,1,213,2019-01-12T17:30:00Z,True,5,14,90,2,44,22,22,18,7,11,26,11
Rudiger,117,1,220,2019-01-19T17:30:00Z,False,5,0,90,1,47,25,22,41,26,15,6,-4
Rudiger,117,1,231,2019-01-30T19:45:00Z,False,5,1,90,0,47,25,22,30,21,9,17,1
Rudiger,117,1,243,2019-02-02T15:00:00Z,True,5,9,0,0,47,25,22,11,5,6,36,19
Rudiger,117,1,255,2019-02-10T16:00:00Z,False,5,12,90,-1,50,28,22,62,36,26,-12,-14
Rudiger,117,1,275,2019-02-27T20:00:00Z,True,5,16,90,6,50,28,22,60,27,33,-10,-5
Rudiger,117,1,284,2019-03-03T14:05:00Z,False,5,8,90,2,53,31,22,17,15,2,36,7
Rudiger,117,1,292,2019-03-10T14:05:00Z,True,5,19,90,1,56,31,25,43,24,19,13,12
Rudiger,117,1,303,2019-03-17T16:30:00Z,False,5,7,90,0,57,32,25,37,22,15,20,3
Rudiger,117,1,313,2019-03-31T13:05:00Z,False,5,4,90,1,57,32,25,28,20,8,29,5
Rudiger,117,1,264,2019-04-03T18:45:00Z,True,5,2,0,0,60,32,28,33,22,11,27,21
Rudiger,117,1,321,2019-04-08T19:00:00Z,True,5,18,90,8,63,35,28,42,27,15,21,20
Rudiger,117,1,335,2019-04-14T15:30:00Z,False,5,11,39,1,66,38,28,82,44,38,-16,-16
Rudiger,117,1,343,2019-04-22T19:00:00Z,True,5,3,0,0,66,38,28,39,23,16,27,22
Rudiger,117,1,356,2019-04-28T15:30:00Z,False,5,13,64,5,67,39,28,64,35,29,3,-7
Rudiger,117,1,363,2019-05-05T13:00:00Z,True,5,17,0,0,68,39,29,50,27,23,18,16
Rudiger,117,1,374,2019-05-12T14:00:00Z,False,5,10,0,0,71,42,29,51,26,25,20,3
Christensen,118,1,3,2018-08-11T14:00:00Z,False,5,9,0,0,0,0,0,0,0,0,0,0
Christensen,118,1,13,2018-08-18T16:30:00Z,True,5,0,0,0,3,0,3,0,0,0,3,0
Christensen,118,1,26,2018-08-26T15:00:00Z,False,5,14,0,0,6,3,3,1,0,1,5,3
Christensen,118,1,33,2018-09-01T14:00:00Z,True,5,1,0,0,9,3,6,7,4,3,2,0
Christensen,118,1,41,2018-09-15T14:00:00Z,True,5,4,0,0,12,6,6,2,1,1,10,5
Christensen,118,1,59,2018-09-23T12:30:00Z,False,5,18,0,0,15,9,6,3,0,3,12,6
Christensen,118,1,63,2018-09-29T16:30:00Z,True,5,11,0,0,16,9,7,18,9,9,-2,0
Christensen,118,1,77,2018-10-07T13:15:00Z,False,5,15,0,0,17,10,7,5,2,3,12,5
Christensen,118,1,83,2018-10-20T11:30:00Z,True,5,13,0,0,20,10,10,13,7,6,7,4
Christensen,118,1,91,2018-10-28T13:30:00Z,False,5,3,0,0,21,11,10,8,4,4,13,6
Christensen,118,1,103,2018-11-04T16:00:00Z,True,5,6,0,0,24,11,13,8,2,6,16,5
Christensen,118,1,112,2018-11-11T14:15:00Z,True,5,7,0,0,27,14,13,18,13,5,9,9
Christensen,118,1,126,2018-11-24T17:30:00Z,False,5,16,0,0,28,15,13,27,6,21,1,7
Christensen,118,1,132,2018-12-02T12:00:00Z,True,5,8,0,0,28,15,13,8,7,1,20,14
Christensen,118,1,147,2018-12-05T19:45:00Z,False,5,19,90,0,31,18,13,16,8,8,15,5
Christensen,118,1,154,2018-12-08T17:30:00Z,True,5,12,0,0,31,18,13,41,24,17,-10,1
Christensen,118,1,160,2018-12-16T13:30:00Z,False,5,2,0,0,34,21,13,21,14,7,13,-1
Christensen,118,1,173,2018-12-22T15:00:00Z,True,5,10,0,0,37,21,16,22,11,11,15,10
Christensen,118,1,189,2018-12-26T19:30:00Z,False,5,17,0,0,37,21,16,27,15,12,10,1
Christensen,118,1,192,2018-12-30T12:00:00Z,False,5,6,0,0,40,21,19,19,9,10,21,10
Christensen,118,1,203,2019-01-02T19:45:00Z,True,5,15,0,0,43,21,22,15,8,7,28,14
Christensen,118,1,213,2019-01-12T17:30:00Z,True,5,14,0,0,44,22,22,18,7,11,26,11
Christensen,118,1,220,2019-01-19T17:30:00Z,False,5,0,0,0,47,25,22,41,26,15,6,-4
Christensen,118,1,231,2019-01-30T19:45:00Z,False,5,1,0,0,47,25,22,30,21,9,17,1
Christensen,118,1,243,2019-02-02T15:00:00Z,True,5,9,90,6,47,25,22,11,5,6,36,19
Christensen,118,1,255,2019-02-10T16:00:00Z,False,5,12,0,0,50,28,22,62,36,26,-12,-14
Christensen,118,1,275,2019-02-27T20:00:00Z,True,5,16,0,0,50,28,22,60,27,33,-10,-5
Christensen,118,1,284,2019-03-03T14:05:00Z,False,5,8,90,2,53,31,22,17,15,2,36,7
Christensen,118,1,292,2019-03-10T14:05:00Z,True,5,19,0,0,56,31,25,43,24,19,13,12
Christensen,118,1,303,2019-03-17T16:30:00Z,False,5,7,0,0,57,32,25,37,22,15,20,3
Christensen,118,1,313,2019-03-31T13:05:00Z,False,5,4,0,0,57,32,25,28,20,8,29,5
Christensen,118,1,264,2019-04-03T18:45:00Z,True,5,2,90,6,60,32,28,33,22,11,27,21
Christensen,118,1,321,2019-04-08T19:00:00Z,True,5,18,0,0,63,35,28,42,27,15,21,20
Christensen,118,1,335,2019-04-14T15:30:00Z,False,5,11,50,0,66,38,28,82,44,38,-16,-16
Christensen,118,1,343,2019-04-22T19:00:00Z,True,5,3,90,1,66,38,28,39,23,16,27,22
Christensen,118,1,356,2019-04-28T15:30:00Z,False,5,13,25,1,67,39,28,64,35,29,3,-7
Christensen,118,1,363,2019-05-05T13:00:00Z,True,5,17,90,6,68,39,29,50,27,23,18,16
Christensen,118,1,374,2019-05-12T14:00:00Z,False,5,10,0,0,71,42,29,51,26,25,20,3
Zappacosta,119,1,3,2018-08-11T14:00:00Z,False,5,9,0,0,0,0,0,0,0,0,0,0
Zappacosta,119,1,13,2018-08-18T16:30:00Z,True,5,0,0,0,3,0,3,0,0,0,3,0
Zappacosta,119,1,26,2018-08-26T15:00:00Z,False,5,14,0,0,6,3,3,1,0,1,5,3
Zappacosta,119,1,33,2018-09-01T14:00:00Z,True,5,1,0,0,9,3,6,7,4,3,2,0
Zappacosta,119,1,41,2018-09-15T14:00:00Z,True,5,4,6,1,12,6,6,2,1,1,10,5
Zappacosta,119,1,59,2018-09-23T12:30:00Z,False,5,18,0,0,15,9,6,3,0,3,12,6
Zappacosta,119,1,63,2018-09-29T16:30:00Z,True,5,11,0,0,16,9,7,18,9,9,-2,0
Zappacosta,119,1,77,2018-10-07T13:15:00Z,False,5,15,0,0,17,10,7,5,2,3,12,5
Zappacosta,119,1,83,2018-10-20T11:30:00Z,True,5,13,0,0,20,10,10,13,7,6,7,4
Zappacosta,119,1,91,2018-10-28T13:30:00Z,False,5,3,0,0,21,11,10,8,4,4,13,6
Zappacosta,119,1,103,2018-11-04T16:00:00Z,True,5,6,0,0,24,11,13,8,2,6,16,5
Zappacosta,119,1,112,2018-11-11T14:15:00Z,True,5,7,0,0,27,14,13,18,13,5,9,9
Zappacosta,119,1,126,2018-11-24T17:30:00Z,False,5,16,0,0,28,15,13,27,6,21,1,7
Zappacosta,119,1,132,2018-12-02T12:00:00Z,True,5,8,12,1,28,15,13,8,7,1,20,14
Zappacosta,119,1,147,2018-12-05T19:45:00Z,False,5,19,0,0,31,18,13,16,8,8,15,5
Zappacosta,119,1,154,2018-12-08T17:30:00Z,True,5,12,0,0,31,18,13,41,24,17,-10,1
Zappacosta,119,1,160,2018-12-16T13:30:00Z,False,5,2,0,0,34,21,13,21,14,7,13,-1
Zappacosta,119,1,173,2018-12-22T15:00:00Z,True,5,10,0,0,37,21,16,22,11,11,15,10
Zappacosta,119,1,189,2018-12-26T19:30:00Z,False,5,17,0,0,37,21,16,27,15,12,10,1
Zappacosta,119,1,192,2018-12-30T12:00:00Z,False,5,6,0,0,40,21,19,19,9,10,21,10
Zappacosta,119,1,203,2019-01-02T19:45:00Z,True,5,15,0,0,43,21,22,15,8,7,28,14
Zappacosta,119,1,213,2019-01-12T17:30:00Z,True,5,14,0,0,44,22,22,18,7,11,26,11
Zappacosta,119,1,220,2019-01-19T17:30:00Z,False,5,0,0,0,47,25,22,41,26,15,6,-4
Zappacosta,119,1,231,2019-01-30T19:45:00Z,False,5,1,0,0,47,25,22,30,21,9,17,1
Zappacosta,119,1,243,2019-02-02T15:00:00Z,True,5,9,0,0,47,25,22,11,5,6,36,19
Zappacosta,119,1,255,2019-02-10T16:00:00Z,False,5,12,0,0,50,28,22,62,36,26,-12,-14
Zappacosta,119,1,275,2019-02-27T20:00:00Z,True,5,16,0,0,50,28,22,60,27,33,-10,-5
Zappacosta,119,1,284,2019-03-03T14:05:00Z,False,5,8,0,0,53,31,22,17,15,2,36,7
Zappacosta,119,1,292,2019-03-10T14:05:00Z,True,5,19,0,0,56,31,25,43,24,19,13,12
Zappacosta,119,1,303,2019-03-17T16:30:00Z,False,5,7,0,0,57,32,25,37,22,15,20,3
Zappacosta,119,1,313,2019-03-31T13:05:00Z,False,5,4,0,0,57,32,25,28,20,8,29,5
Zappacosta,119,1,264,2019-04-03T18:45:00Z,True,5,2,17,1,60,32,28,33,22,11,27,21
Zappacosta,119,1,321,2019-04-08T19:00:00Z,True,5,18,0,0,63,35,28,42,27,15,21,20
Zappacosta,119,1,335,2019-04-14T15:30:00Z,False,5,11,0,0,66,38,28,82,44,38,-16,-16
Zappacosta,119,1,343,2019-04-22T19:00:00Z,True,5,3,0,0,66,38,28,39,23,16,27,22
Zappacosta,119,1,356,2019-04-28T15:30:00Z,False,5,13,0,0,67,39,28,64,35,29,3,-7
Zappacosta,119,1,363,2019-05-05T13:00:00Z,True,5,17,0,0,68,39,29,50,27,23,18,16
Zappacosta,119,1,374,2019-05-12T14:00:00Z,False,5,10,90,6,71,42,29,51,26,25,20,3
Emerson,120,1,3,2018-08-11T14:00:00Z,False,5,9,0,0,0,0,0,0,0,0,0,0
Emerson,120,1,13,2018-08-18T16:30:00Z,True,5,0,0,0,3,0,3,0,0,0,3,0
Emerson,120,1,26,2018-08-26T15:00:00Z,False,5,14,0,0,6,3,3,1,0,1,5,3
Emerson,120,1,33,2018-09-01T14:00:00Z,True,5,1,0,0,9,3,6,7,4,3,2,0
Emerson,120,1,41,2018-09-15T14:00:00Z,True,5,4,0,0,12,6,6,2,1,1,10,5
Emerson,120,1,59,2018-09-23T12:30:00Z,False,5,18,0,0,15,9,6,3,0,3,12,6
Emerson,120,1,63,2018-09-29T16:30:00Z,True,5,11,0,0,16,9,7,18,9,9,-2,0
Emerson,120,1,77,2018-10-07T13:15:00Z,False,5,15,0,0,17,10,7,5,2,3,12,5
Emerson,120,1,83,2018-10-20T11:30:00Z,True,5,13,0,0,20,10,10,13,7,6,7,4
Emerson,120,1,91,2018-10-28T13:30:00Z,False,5,3,0,0,21,11,10,8,4,4,13,6
Emerson,120,1,103,2018-11-04T16:00:00Z,True,5,6,0,0,24,11,13,8,2,6,16,5
Emerson,120,1,112,2018-11-11T14:15:00Z,True,5,7,0,0,27,14,13,18,13,5,9,9
Emerson,120,1,126,2018-11-24T17:30:00Z,False,5,16,0,0,28,15,13,27,6,21,1,7
Emerson,120,1,132,2018-12-02T12:00:00Z,True,5,8,0,0,28,15,13,8,7,1,20,14
Emerson,120,1,147,2018-12-05T19:45:00Z,False,5,19,0,0,31,18,13,16,8,8,15,5
Emerson,120,1,154,2018-12-08T17:30:00Z,True,5,12,0,0,31,18,13,41,24,17,-10,1
Emerson,120,1,160,2018-12-16T13:30:00Z,False,5,2,0,0,34,21,13,21,14,7,13,-1
Emerson,120,1,173,2018-12-22T15:00:00Z,True,5,10,0,0,37,21,16,22,11,11,15,10
Emerson,120,1,189,2018-12-26T19:30:00Z,False,5,17,5,1,37,21,16,27,15,12,10,1
Emerson,120,1,192,2018-12-30T12:00:00Z,False,5,6,8,1,40,21,19,19,9,10,21,10
Emerson,120,1,203,2019-01-02T19:45:00Z,True,5,15,0,0,43,21,22,15,8,7,28,14
Emerson,120,1,213,2019-01-12T17:30:00Z,True,5,14,0,0,44,22,22,18,7,11,26,11
Emerson,120,1,220,2019-01-19T17:30:00Z,False,5,0,0,0,47,25,22,41,26,15,6,-4
Emerson,120,1,231,2019-01-30T19:45:00Z,False,5,1,90,0,47,25,22,30,21,9,17,1
Emerson,120,1,243,2019-02-02T15:00:00Z,True,5,9,0,0,47,25,22,11,5,6,36,19
Emerson,120,1,255,2019-02-10T16:00:00Z,False,5,12,17,1,50,28,22,62,36,26,-12,-14
Emerson,120,1,275,2019-02-27T20:00:00Z,True,5,16,0,0,50,28,22,60,27,33,-10,-5
Emerson,120,1,284,2019-03-03T14:05:00Z,False,5,8,90,2,53,31,22,17,15,2,36,7
Emerson,120,1,292,2019-03-10T14:05:00Z,True,5,19,90,2,56,31,25,43,24,19,13,12
Emerson,120,1,303,2019-03-17T16:30:00Z,False,5,7,0,0,57,32,25,37,22,15,20,3
Emerson,120,1,313,2019-03-31T13:05:00Z,False,5,4,0,0,57,32,25,28,20,8,29,5
Emerson,120,1,264,2019-04-03T18:45:00Z,True,5,2,90,6,60,32,28,33,22,11,27,21
Emerson,120,1,321,2019-04-08T19:00:00Z,True,5,18,90,7,63,35,28,42,27,15,21,20
Emerson,120,1,335,2019-04-14T15:30:00Z,False,5,11,90,1,66,38,28,82,44,38,-16,-16
Emerson,120,1,343,2019-04-22T19:00:00Z,True,5,3,90,1,66,38,28,39,23,16,27,22
Emerson,120,1,356,2019-04-28T15:30:00Z,False,5,13,0,0,67,39,28,64,35,29,3,-7
Emerson,120,1,363,2019-05-05T13:00:00Z,True,5,17,0,0,68,39,29,50,27,23,18,16
Emerson,120,1,374,2019-05-12T14:00:00Z,False,5,10,0,0,71,42,29,51,26,25,20,3
Hazard,121,2,3,2018-08-11T14:00:00Z,False,5,9,14,4,0,0,0,0,0,0,0,0
Hazard,121,2,13,2018-08-18T16:30:00Z,True,5,0,29,4,3,0,3,0,0,0,3,0
Hazard,121,2,26,2018-08-26T15:00:00Z,False,5,14,90,8,6,3,3,1,0,1,5,3
Hazard,121,2,33,2018-09-01T14:00:00Z,True,5,1,90,11,9,3,6,7,4,3,2,0
Hazard,121,2,41,2018-09-15T14:00:00Z,True,5,4,83,20,12,6,6,2,1,1,10,5
Hazard,121,2,59,2018-09-23T12:30:00Z,False,5,18,90,3,15,9,6,3,0,3,12,6
Hazard,121,2,63,2018-09-29T16:30:00Z,True,5,11,90,10,16,9,7,18,9,9,-2,0
Hazard,121,2,77,2018-10-07T13:15:00Z,False,5,15,90,14,17,10,7,5,2,3,12,5
Hazard,121,2,83,2018-10-20T11:30:00Z,True,5,13,90,1,20,10,10,13,7,6,7,4
Hazard,121,2,91,2018-10-28T13:30:00Z,False,5,3,0,0,21,11,10,8,4,4,13,6
Hazard,121,2,103,2018-11-04T16:00:00Z,True,5,6,26,4,24,11,13,8,2,6,16,5
Hazard,121,2,112,2018-11-11T14:15:00Z,True,5,7,90,3,27,14,13,18,13,5,9,9
Hazard,121,2,126,2018-11-24T17:30:00Z,False,5,16,90,1,28,15,13,27,6,21,1,7
Hazard,121,2,132,2018-12-02T12:00:00Z,True,5,8,90,6,28,15,13,8,7,1,20,14
Hazard,121,2,147,2018-12-05T19:45:00Z,False,5,19,90,5,31,18,13,16,8,8,15,5
Hazard,121,2,154,2018-12-08T17:30:00Z,True,5,12,89,9,31,18,13,41,24,17,-10,1
Hazard,121,2,160,2018-12-16T13:30:00Z,False,5,2,82,13,34,21,13,21,14,7,13,-1
Hazard,121,2,173,2018-12-22T15:00:00Z,True,5,10,90,2,37,21,16,22,11,11,15,10
Hazard,121,2,189,2018-12-26T19:30:00Z,False,5,17,90,15,37,21,16,27,15,12,10,1
Hazard,121,2,192,2018-12-30T12:00:00Z,False,5,6,90,3,40,21,19,19,9,10,21,10
Hazard,121,2,203,2019-01-02T19:45:00Z,True,5,15,90,3,43,21,22,15,8,7,28,14
Hazard,121,2,213,2019-01-12T17:30:00Z,True,5,14,86,5,44,22,22,18,7,11,26,11
Hazard,121,2,220,2019-01-19T17:30:00Z,False,5,0,90,2,47,25,22,41,26,15,6,-4
Hazard,121,2,231,2019-01-30T19:45:00Z,False,5,1,90,2,47,25,22,30,21,9,17,1
Hazard,121,2,243,2019-02-02T15:00:00Z,True,5,9,76,15,47,25,22,11,5,6,36,19
Hazard,121,2,255,2019-02-10T16:00:00Z,False,5,12,90,2,50,28,22,62,36,26,-12,-14
Hazard,121,2,275,2019-02-27T20:00:00Z,True,5,16,59,1,50,28,22,60,27,33,-10,-5
Hazard,121,2,284,2019-03-03T14:05:00Z,False,5,8,73,6,53,31,22,17,15,2,36,7
Hazard,121,2,292,2019-03-10T14:05:00Z,True,5,19,90,10,56,31,25,43,24,19,13,12
Hazard,121,2,303,2019-03-17T16:30:00Z,False,5,7,90,2,57,32,25,37,22,15,20,3
Hazard,121,2,313,2019-03-31T13:05:00Z,False,5,4,37,1,57,32,25,28,20,8,29,5
Hazard,121,2,264,2019-04-03T18:45:00Z,True,5,2,83,14,60,32,28,33,22,11,27,21
Hazard,121,2,321,2019-04-08T19:00:00Z,True,5,18,90,16,63,35,28,42,27,15,21,20
Hazard,121,2,335,2019-04-14T15:30:00Z,False,5,11,90,2,66,38,28,82,44,38,-16,-16
Hazard,121,2,343,2019-04-22T19:00:00Z,True,5,3,90,7,66,38,28,39,23,16,27,22
Hazard,121,2,356,2019-04-28T15:30:00Z,False,5,13,90,2,67,39,28,64,35,29,3,-7
Hazard,121,2,363,2019-05-05T13:00:00Z,True,5,17,90,11,68,39,29,50,27,23,18,16
Hazard,121,2,374,2019-05-12T14:00:00Z,False,5,10,21,1,71,42,29,51,26,25,20,3
Fabregas,122,2,3,2018-08-11T14:00:00Z,False,5,9,0,0,0,0,0,0,0,0,0,0
Fabregas,122,2,13,2018-08-18T16:30:00Z,True,5,0,0,0,3,0,3,0,0,0,3,0
Fabregas,122,2,26,2018-08-26T15:00:00Z,False,5,14,0,0,6,3,3,1,0,1,5,3
Fabregas,122,2,33,2018-09-01T14:00:00Z,True,5,1,0,0,9,3,6,7,4,3,2,0
Fabregas,122,2,41,2018-09-15T14:00:00Z,True,5,4,0,0,12,6,6,2,1,1,10,5
Fabregas,122,2,59,2018-09-23T12:30:00Z,False,5,18,0,0,15,9,6,3,0,3,12,6
Fabregas,122,2,63,2018-09-29T16:30:00Z,True,5,11,0,0,16,9,7,18,9,9,-2,0
Fabregas,122,2,77,2018-10-07T13:15:00Z,False,5,15,0,0,17,10,7,5,2,3,12,5
Fabregas,122,2,83,2018-10-20T11:30:00Z,True,5,13,0,0,20,10,10,13,7,6,7,4
Fabregas,122,2,91,2018-10-28T13:30:00Z,False,5,3,12,1,21,11,10,8,4,4,13,6
Fabregas,122,2,103,2018-11-04T16:00:00Z,True,5,6,10,1,24,11,13,8,2,6,16,5
Fabregas,122,2,112,2018-11-11T14:15:00Z,True,5,7,26,1,27,14,13,18,13,5,9,9
Fabregas,122,2,126,2018-11-24T17:30:00Z,False,5,16,0,0,28,15,13,27,6,21,1,7
Fabregas,122,2,132,2018-12-02T12:00:00Z,True,5,8,0,0,28,15,13,8,7,1,20,14
Fabregas,122,2,147,2018-12-05T19:45:00Z,False,5,19,90,1,31,18,13,16,8,8,15,5
Fabregas,122,2,154,2018-12-08T17:30:00Z,True,5,12,0,0,31,18,13,41,24,17,-10,1
Fabregas,122,2,160,2018-12-16T13:30:00Z,False,5,2,0,0,34,21,13,21,14,7,13,-1
Fabregas,122,2,173,2018-12-22T15:00:00Z,True,5,10,15,1,37,21,16,22,11,11,15,10
Fabregas,122,2,189,2018-12-26T19:30:00Z,False,5,17,0,0,37,21,16,27,15,12,10,1
Fabregas,122,2,192,2018-12-30T12:00:00Z,False,5,6,0,0,40,21,19,19,9,10,21,10
Fabregas,122,2,203,2019-01-02T19:45:00Z,True,5,15,22,1,43,21,22,15,8,7,28,14
Fabregas,122,2,213,2019-01-12T17:30:00Z,True,5,14,0,0,44,22,22,18,7,11,26,11
Fabregas,122,2,220,2019-01-19T17:30:00Z,False,5,0,0,0,47,25,22,41,26,15,6,-4
Fabregas,122,2,231,2019-01-30T19:45:00Z,False,5,1,0,0,47,25,22,30,21,9,17,1
Fabregas,122,2,243,2019-02-02T15:00:00Z,True,5,9,0,0,47,25,22,11,5,6,36,19
Fabregas,122,2,255,2019-02-10T16:00:00Z,False,5,12,0,0,50,28,22,62,36,26,-12,-14
Fabregas,122,2,275,2019-02-27T20:00:00Z,True,5,16,0,0,50,28,22,60,27,33,-10,-5
Fabregas,122,2,284,2019-03-03T14:05:00Z,False,5,8,0,0,53,31,22,17,15,2,36,7
Fabregas,122,2,292,2019-03-10T14:05:00Z,True,5,19,0,0,56,31,25,43,24,19,13,12
Fabregas,122,2,303,2019-03-17T16:30:00Z,False,5,7,0,0,57,32,25,37,22,15,20,3
Fabregas,122,2,313,2019-03-31T13:05:00Z,False,5,4,0,0,57,32,25,28,20,8,29,5
Fabregas,122,2,264,2019-04-03T18:45:00Z,True,5,2,0,0,60,32,28,33,22,11,27,21
Fabregas,122,2,321,2019-04-08T19:00:00Z,True,5,18,0,0,63,35,28,42,27,15,21,20
Fabregas,122,2,335,2019-04-14T15:30:00Z,False,5,11,0,0,66,38,28,82,44,38,-16,-16
Fabregas,122,2,343,2019-04-22T19:00:00Z,True,5,3,0,0,66,38,28,39,23,16,27,22
Fabregas,122,2,356,2019-04-28T15:30:00Z,False,5,13,0,0,67,39,28,64,35,29,3,-7
Fabregas,122,2,363,2019-05-05T13:00:00Z,True,5,17,0,0,68,39,29,50,27,23,18,16
Fabregas,122,2,374,2019-05-12T14:00:00Z,False,5,10,0,0,71,42,29,51,26,25,20,3
Willian,123,2,3,2018-08-11T14:00:00Z,False,5,9,75,6,0,0,0,0,0,0,0,0
Willian,123,2,13,2018-08-18T16:30:00Z,True,5,0,60,2,3,0,3,0,0,0,3,0
Willian,123,2,26,2018-08-26T15:00:00Z,False,5,14,21,1,6,3,3,1,0,1,5,3
Willian,123,2,33,2018-09-01T14:00:00Z,True,5,1,64,3,9,3,6,7,4,3,2,0
Willian,123,2,41,2018-09-15T14:00:00Z,True,5,4,22,10,12,6,6,2,1,1,10,5
Willian,123,2,59,2018-09-23T12:30:00Z,False,5,18,90,3,15,9,6,3,0,3,12,6
Willian,123,2,63,2018-09-29T16:30:00Z,True,5,11,72,3,16,9,7,18,9,9,-2,0
Willian,123,2,77,2018-10-07T13:15:00Z,False,5,15,74,3,17,10,7,5,2,3,12,5
Willian,123,2,83,2018-10-20T11:30:00Z,True,5,13,72,6,20,10,10,13,7,6,7,4
Willian,123,2,91,2018-10-28T13:30:00Z,False,5,3,90,7,21,11,10,8,4,4,13,6
Willian,123,2,103,2018-11-04T16:00:00Z,True,5,6,63,2,24,11,13,8,2,6,16,5
Willian,123,2,112,2018-11-11T14:15:00Z,True,5,7,67,3,27,14,13,18,13,5,9,9
Willian,123,2,126,2018-11-24T17:30:00Z,False,5,16,75,2,28,15,13,27,6,21,1,7
Willian,123,2,132,2018-12-02T12:00:00Z,True,5,8,0,0,28,15,13,8,7,1,20,14
Willian,123,2,147,2018-12-05T19:45:00Z,False,5,19,64,2,31,18,13,16,8,8,15,5
Willian,123,2,154,2018-12-08T17:30:00Z,True,5,12,74,3,31,18,13,41,24,17,-10,1
Willian,123,2,160,2018-12-16T13:30:00Z,False,5,2,90,5,34,21,13,21,14,7,13,-1
Willian,123,2,173,2018-12-22T15:00:00Z,True,5,10,60,2,37,21,16,22,11,11,15,10
Willian,123,2,189,2018-12-26T19:30:00Z,False,5,17,90,2,37,21,16,27,15,12,10,1
Willian,123,2,192,2018-12-30T12:00:00Z,False,5,6,81,3,40,21,19,19,9,10,21,10
Willian,123,2,203,2019-01-02T19:45:00Z,True,5,15,36,1,43,21,22,15,8,7,28,14
Willian,123,2,213,2019-01-12T17:30:00Z,True,5,14,90,8,44,22,22,18,7,11,26,11
Willian,123,2,220,2019-01-19T17:30:00Z,False,5,0,67,2,47,25,22,41,26,15,6,-4
Willian,123,2,231,2019-01-30T19:45:00Z,False,5,1,29,1,47,25,22,30,21,9,17,1
Willian,123,2,243,2019-02-02T15:00:00Z,True,5,9,90,6,47,25,22,11,5,6,36,19
Willian,123,2,255,2019-02-10T16:00:00Z,False,5,12,0,0,50,28,22,62,36,26,-12,-14
Willian,123,2,275,2019-02-27T20:00:00Z,True,5,16,30,1,50,28,22,60,27,33,-10,-5
Willian,123,2,284,2019-03-03T14:05:00Z,False,5,8,90,2,53,31,22,17,15,2,36,7
Willian,123,2,292,2019-03-10T14:05:00Z,True,5,19,18,4,56,31,25,43,24,19,13,12
Willian,123,2,303,2019-03-17T16:30:00Z,False,5,7,0,0,57,32,25,37,22,15,20,3
Willian,123,2,313,2019-03-31T13:05:00Z,False,5,4,90,8,57,32,25,28,20,8,29,5
Willian,123,2,264,2019-04-03T18:45:00Z,True,5,2,6,1,60,32,28,33,22,11,27,21
Willian,123,2,321,2019-04-08T19:00:00Z,True,5,18,0,0,63,35,28,42,27,15,21,20
Willian,123,2,335,2019-04-14T15:30:00Z,False,5,11,90,2,66,38,28,82,44,38,-16,-16
Willian,123,2,343,2019-04-22T19:00:00Z,True,5,3,0,0,66,38,28,39,23,16,27,22
Willian,123,2,356,2019-04-28T15:30:00Z,False,5,13,83,1,67,39,28,64,35,29,3,-7
Willian,123,2,363,2019-05-05T13:00:00Z,True,5,17,0,0,68,39,29,50,27,23,18,16
Willian,123,2,374,2019-05-12T14:00:00Z,False,5,10,68,3,71,42,29,51,26,25,20,3
Pedro,124,2,3,2018-08-11T14:00:00Z,False,5,9,80,9,0,0,0,0,0,0,0,0
Pedro,124,2,13,2018-08-18T16:30:00Z,True,5,0,90,8,3,0,3,0,0,0,3,0
Pedro,124,2,26,2018-08-26T15:00:00Z,False,5,14,68,3,6,3,3,1,0,1,5,3
Pedro,124,2,33,2018-09-01T14:00:00Z,True,5,1,25,6,9,3,6,7,4,3,2,0
Pedro,124,2,41,2018-09-15T14:00:00Z,True,5,4,67,2,12,6,6,2,1,1,10,5
Pedro,124,2,59,2018-09-23T12:30:00Z,False,5,18,0,0,15,9,6,3,0,3,12,6
Pedro,124,2,63,2018-09-29T16:30:00Z,True,5,11,0,0,16,9,7,18,9,9,-2,0
Pedro,124,2,77,2018-10-07T13:15:00Z,False,5,15,15,1,17,10,7,5,2,3,12,5
Pedro,124,2,83,2018-10-20T11:30:00Z,True,5,13,17,1,20,10,10,13,7,6,7,4
Pedro,124,2,91,2018-10-28T13:30:00Z,False,5,3,29,1,21,11,10,8,4,4,13,6
Pedro,124,2,103,2018-11-04T16:00:00Z,True,5,6,90,12,24,11,13,8,2,6,16,5
Pedro,124,2,112,2018-11-11T14:15:00Z,True,5,7,22,1,27,14,13,18,13,5,9,9
Pedro,124,2,126,2018-11-24T17:30:00Z,False,5,16,32,1,28,15,13,27,6,21,1,7
Pedro,124,2,132,2018-12-02T12:00:00Z,True,5,8,90,11,28,15,13,8,7,1,20,14
Pedro,124,2,147,2018-12-05T19:45:00Z,False,5,19,25,1,31,18,13,16,8,8,15,5
Pedro,124,2,154,2018-12-08T17:30:00Z,True,5,12,90,2,31,18,13,41,24,17,-10,1
Pedro,124,2,160,2018-12-16T13:30:00Z,False,5,2,65,9,34,21,13,21,14,7,13,-1
Pedro,124,2,173,2018-12-22T15:00:00Z,True,5,10,90,2,37,21,16,22,11,11,15,10
Pedro,124,2,189,2018-12-26T19:30:00Z,False,5,17,42,1,37,21,16,27,15,12,10,1
Pedro,124,2,192,2018-12-30T12:00:00Z,False,5,6,0,0,40,21,19,19,9,10,21,10
Pedro,124,2,203,2019-01-02T19:45:00Z,True,5,15,0,0,43,21,22,15,8,7,28,14
Pedro,124,2,213,2019-01-12T17:30:00Z,True,5,14,80,9,44,22,22,18,7,11,26,11
Pedro,124,2,220,2019-01-19T17:30:00Z,False,5,0,79,2,47,25,22,41,26,15,6,-4
Pedro,124,2,231,2019-01-30T19:45:00Z,False,5,1,60,2,47,25,22,30,21,9,17,1
Pedro,124,2,243,2019-02-02T15:00:00Z,True,5,9,0,0,47,25,22,11,5,6,36,19
Pedro,124,2,255,2019-02-10T16:00:00Z,False,5,12,64,2,50,28,22,62,36,26,-12,-14
Pedro,124,2,275,2019-02-27T20:00:00Z,True,5,16,90,9,50,28,22,60,27,33,-10,-5
Pedro,124,2,284,2019-03-03T14:05:00Z,False,5,8,16,1,53,31,22,17,15,2,36,7
Pedro,124,2,292,2019-03-10T14:05:00Z,True,5,19,60,2,56,31,25,43,24,19,13,12
Pedro,124,2,303,2019-03-17T16:30:00Z,False,5,7,90,2,57,32,25,37,22,15,20,3
Pedro,124,2,313,2019-03-31T13:05:00Z,False,5,4,52,1,57,32,25,28,20,8,29,5
Pedro,124,2,264,2019-04-03T18:45:00Z,True,5,2,0,0,60,32,28,33,22,11,27,21
Pedro,124,2,321,2019-04-08T19:00:00Z,True,5,18,5,1,63,35,28,42,27,15,21,20
Pedro,124,2,335,2019-04-14T15:30:00Z,False,5,11,0,0,66,38,28,82,44,38,-16,-16
Pedro,124,2,343,2019-04-22T19:00:00Z,True,5,3,49,0,66,38,28,39,23,16,27,22
Pedro,124,2,356,2019-04-28T15:30:00Z,False,5,13,6,1,67,39,28,64,35,29,3,-7
Pedro,124,2,363,2019-05-05T13:00:00Z,True,5,17,90,6,68,39,29,50,27,23,18,16
Pedro,124,2,374,2019-05-12T14:00:00Z,False,5,10,90,3,71,42,29,51,26,25,20,3
Kante,125,2,3,2018-08-11T14:00:00Z,False,5,9,90,8,0,0,0,0,0,0,0,0
Kante,125,2,13,2018-08-18T16:30:00Z,True,5,0,90,2,3,0,3,0,0,0,3,0
Kante,125,2,26,2018-08-26T15:00:00Z,False,5,14,90,2,6,3,3,1,0,1,5,3
Kante,125,2,33,2018-09-01T14:00:00Z,True,5,1,90,2,9,3,6,7,4,3,2,0
Kante,125,2,41,2018-09-15T14:00:00Z,True,5,4,90,2,12,6,6,2,1,1,10,5
Kante,125,2,59,2018-09-23T12:30:00Z,False,5,18,90,2,15,9,6,3,0,3,12,6
Kante,125,2,63,2018-09-29T16:30:00Z,True,5,11,90,2,16,9,7,18,9,9,-2,0
Kante,125,2,77,2018-10-07T13:15:00Z,False,5,15,90,3,17,10,7,5,2,3,12,5
Kante,125,2,83,2018-10-20T11:30:00Z,True,5,13,90,2,20,10,10,13,7,6,7,4
Kante,125,2,91,2018-10-28T13:30:00Z,False,5,3,90,6,21,11,10,8,4,4,13,6
Kante,125,2,103,2018-11-04T16:00:00Z,True,5,6,90,2,24,11,13,8,2,6,16,5
Kante,125,2,112,2018-11-11T14:15:00Z,True,5,7,90,2,27,14,13,18,13,5,9,9
Kante,125,2,126,2018-11-24T17:30:00Z,False,5,16,90,2,28,15,13,27,6,21,1,7
Kante,125,2,132,2018-12-02T12:00:00Z,True,5,8,90,6,28,15,13,8,7,1,20,14
Kante,125,2,147,2018-12-05T19:45:00Z,False,5,19,76,2,31,18,13,16,8,8,15,5
Kante,125,2,154,2018-12-08T17:30:00Z,True,5,12,90,9,31,18,13,41,24,17,-10,1
Kante,125,2,160,2018-12-16T13:30:00Z,False,5,2,90,2,34,21,13,21,14,7,13,-1
Kante,125,2,173,2018-12-22T15:00:00Z,True,5,10,90,2,37,21,16,22,11,11,15,10
Kante,125,2,189,2018-12-26T19:30:00Z,False,5,17,90,2,37,21,16,27,15,12,10,1
Kante,125,2,192,2018-12-30T12:00:00Z,False,5,6,90,10,40,21,19,19,9,10,21,10
Kante,125,2,203,2019-01-02T19:45:00Z,True,5,15,90,3,43,21,22,15,8,7,28,14
Kante,125,2,213,2019-01-12T17:30:00Z,True,5,14,90,2,44,22,22,18,7,11,26,11
Kante,125,2,220,2019-01-19T17:30:00Z,False,5,0,90,2,47,25,22,41,26,15,6,-4
Kante,125,2,231,2019-01-30T19:45:00Z,False,5,1,90,2,47,25,22,30,21,9,17,1
Kante,125,2,243,2019-02-02T15:00:00Z,True,5,9,82,9,47,25,22,11,5,6,36,19
Kante,125,2,255,2019-02-10T16:00:00Z,False,5,12,90,2,50,28,22,62,36,26,-12,-14
Kante,125,2,275,2019-02-27T20:00:00Z,True,5,16,90,3,50,28,22,60,27,33,-10,-5
Kante,125,2,284,2019-03-03T14:05:00Z,False,5,8,90,2,53,31,22,17,15,2,36,7
Kante,125,2,292,2019-03-10T14:05:00Z,True,5,19,90,2,56,31,25,43,24,19,13,12
Kante,125,2,303,2019-03-17T16:30:00Z,False,5,7,90,2,57,32,25,37,22,15,20,3
Kante,125,2,313,2019-03-31T13:05:00Z,False,5,4,0,0,57,32,25,28,20,8,29,5
Kante,125,2,264,2019-04-03T18:45:00Z,True,5,2,90,3,60,32,28,33,22,11,27,21
Kante,125,2,321,2019-04-08T19:00:00Z,True,5,18,90,3,63,35,28,42,27,15,21,20
Kante,125,2,335,2019-04-14T15:30:00Z,False,5,11,90,2,66,38,28,82,44,38,-16,-16
Kante,125,2,343,2019-04-22T19:00:00Z,True,5,3,45,6,66,38,28,39,23,16,27,22
Kante,125,2,356,2019-04-28T15:30:00Z,False,5,13,90,2,67,39,28,64,35,29,3,-7
Kante,125,2,363,2019-05-05T13:00:00Z,True,5,17,9,1,68,39,29,50,27,23,18,16
Kante,125,2,374,2019-05-12T14:00:00Z,False,5,10,0,0,71,42,29,51,26,25,20,3
Barkley,126,2,3,2018-08-11T14:00:00Z,False,5,9,67,3,0,0,0,0,0,0,0,0
Barkley,126,2,13,2018-08-18T16:30:00Z,True,5,0,59,1,3,0,3,0,0,0,3,0
Barkley,126,2,26,2018-08-26T15:00:00Z,False,5,14,11,1,6,3,3,1,0,1,5,3
Barkley,126,2,33,2018-09-01T14:00:00Z,True,5,1,0,0,9,3,6,7,4,3,2,0
Barkley,126,2,41,2018-09-15T14:00:00Z,True,5,4,40,1,12,6,6,2,1,1,10,5
Barkley,126,2,59,2018-09-23T12:30:00Z,False,5,18,11,1,15,9,6,3,0,3,12,6
Barkley,126,2,63,2018-09-29T16:30:00Z,True,5,11,9,1,16,9,7,18,9,9,-2,0
Barkley,126,2,77,2018-10-07T13:15:00Z,False,5,15,80,13,17,10,7,5,2,3,12,5
Barkley,126,2,83,2018-10-20T11:30:00Z,True,5,13,21,6,20,10,10,13,7,6,7,4
Barkley,126,2,91,2018-10-28T13:30:00Z,False,5,3,90,17,21,11,10,8,4,4,13,6
Barkley,126,2,103,2018-11-04T16:00:00Z,True,5,6,63,2,24,11,13,8,2,6,16,5
Barkley,126,2,112,2018-11-11T14:15:00Z,True,5,7,8,1,27,14,13,18,13,5,9,9
Barkley,126,2,126,2018-11-24T17:30:00Z,False,5,16,32,1,28,15,13,27,6,21,1,7
Barkley,126,2,132,2018-12-02T12:00:00Z,True,5,8,0,0,28,15,13,8,7,1,20,14
Barkley,126,2,147,2018-12-05T19:45:00Z,False,5,19,0,0,31,18,13,16,8,8,15,5
Barkley,126,2,154,2018-12-08T17:30:00Z,True,5,12,25,1,31,18,13,41,24,17,-10,1
Barkley,126,2,160,2018-12-16T13:30:00Z,False,5,2,15,1,34,21,13,21,14,7,13,-1
Barkley,126,2,173,2018-12-22T15:00:00Z,True,5,10,0,0,37,21,16,22,11,11,15,10
Barkley,126,2,189,2018-12-26T19:30:00Z,False,5,17,10,1,37,21,16,27,15,12,10,1
Barkley,126,2,192,2018-12-30T12:00:00Z,False,5,6,87,3,40,21,19,19,9,10,21,10
Barkley,126,2,203,2019-01-02T19:45:00Z,True,5,15,67,3,43,21,22,15,8,7,28,14
Barkley,126,2,213,2019-01-12T17:30:00Z,True,5,14,27,1,44,22,22,18,7,11,26,11
Barkley,126,2,220,2019-01-19T17:30:00Z,False,5,0,27,0,47,25,22,41,26,15,6,-4
Barkley,126,2,231,2019-01-30T19:45:00Z,False,5,1,0,0,47,25,22,30,21,9,17,1
Barkley,126,2,243,2019-02-02T15:00:00Z,True,5,9,90,6,47,25,22,11,5,6,36,19
Barkley,126,2,255,2019-02-10T16:00:00Z,False,5,12,51,1,50,28,22,62,36,26,-12,-14
Barkley,126,2,275,2019-02-27T20:00:00Z,True,5,16,0,0,50,28,22,60,27,33,-10,-5
Barkley,126,2,284,2019-03-03T14:05:00Z,False,5,8,77,2,53,31,22,17,15,2,36,7
Barkley,126,2,292,2019-03-10T14:05:00Z,True,5,19,0,0,56,31,25,43,24,19,13,12
Barkley,126,2,303,2019-03-17T16:30:00Z,False,5,7,64,2,57,32,25,37,22,15,20,3
Barkley,126,2,313,2019-03-31T13:05:00Z,False,5,4,90,2,57,32,25,28,20,8,29,5
Barkley,126,2,264,2019-04-03T18:45:00Z,True,5,2,0,0,60,32,28,33,22,11,27,21
Barkley,126,2,321,2019-04-08T19:00:00Z,True,5,18,20,4,63,35,28,42,27,15,21,20
Barkley,126,2,335,2019-04-14T15:30:00Z,False,5,11,15,1,66,38,28,82,44,38,-16,-16
Barkley,126,2,343,2019-04-22T19:00:00Z,True,5,3,0,0,66,38,28,39,23,16,27,22
Barkley,126,2,356,2019-04-28T15:30:00Z,False,5,13,0,0,67,39,28,64,35,29,3,-7
Barkley,126,2,363,2019-05-05T13:00:00Z,True,5,17,0,0,68,39,29,50,27,23,18,16
Barkley,126,2,374,2019-05-12T14:00:00Z,False,5,10,75,3,71,42,29,51,26,25,20,3
Drinkwater,127,2,3,2018-08-11T14:00:00Z,False,5,9,0,0,0,0,0,0,0,0,0,0
Drinkwater,127,2,13,2018-08-18T16:30:00Z,True,5,0,0,0,3,0,3,0,0,0,3,0
Drinkwater,127,2,26,2018-08-26T15:00:00Z,False,5,14,0,0,6,3,3,1,0,1,5,3
Drinkwater,127,2,33,2018-09-01T14:00:00Z,True,5,1,0,0,9,3,6,7,4,3,2,0
Drinkwater,127,2,41,2018-09-15T14:00:00Z,True,5,4,0,0,12,6,6,2,1,1,10,5
Drinkwater,127,2,59,2018-09-23T12:30:00Z,False,5,18,0,0,15,9,6,3,0,3,12,6
Drinkwater,127,2,63,2018-09-29T16:30:00Z,True,5,11,0,0,16,9,7,18,9,9,-2,0
Drinkwater,127,2,77,2018-10-07T13:15:00Z,False,5,15,0,0,17,10,7,5,2,3,12,5
Drinkwater,127,2,83,2018-10-20T11:30:00Z,True,5,13,0,0,20,10,10,13,7,6,7,4
Drinkwater,127,2,91,2018-10-28T13:30:00Z,False,5,3,0,0,21,11,10,8,4,4,13,6
Drinkwater,127,2,103,2018-11-04T16:00:00Z,True,5,6,0,0,24,11,13,8,2,6,16,5
Drinkwater,127,2,112,2018-11-11T14:15:00Z,True,5,7,0,0,27,14,13,18,13,5,9,9
Drinkwater,127,2,126,2018-11-24T17:30:00Z,False,5,16,0,0,28,15,13,27,6,21,1,7
Drinkwater,127,2,132,2018-12-02T12:00:00Z,True,5,8,0,0,28,15,13,8,7,1,20,14
Drinkwater,127,2,147,2018-12-05T19:45:00Z,False,5,19,0,0,31,18,13,16,8,8,15,5
Drinkwater,127,2,154,2018-12-08T17:30:00Z,True,5,12,0,0,31,18,13,41,24,17,-10,1
Drinkwater,127,2,160,2018-12-16T13:30:00Z,False,5,2,0,0,34,21,13,21,14,7,13,-1
Drinkwater,127,2,173,2018-12-22T15:00:00Z,True,5,10,0,0,37,21,16,22,11,11,15,10
Drinkwater,127,2,189,2018-12-26T19:30:00Z,False,5,17,0,0,37,21,16,27,15,12,10,1
Drinkwater,127,2,192,2018-12-30T12:00:00Z,False,5,6,0,0,40,21,19,19,9,10,21,10
Drinkwater,127,2,203,2019-01-02T19:45:00Z,True,5,15,0,0,43,21,22,15,8,7,28,14
Drinkwater,127,2,213,2019-01-12T17:30:00Z,True,5,14,0,0,44,22,22,18,7,11,26,11
Drinkwater,127,2,220,2019-01-19T17:30:00Z,False,5,0,0,0,47,25,22,41,26,15,6,-4
Drinkwater,127,2,231,2019-01-30T19:45:00Z,False,5,1,0,0,47,25,22,30,21,9,17,1
Drinkwater,127,2,243,2019-02-02T15:00:00Z,True,5,9,0,0,47,25,22,11,5,6,36,19
Drinkwater,127,2,255,2019-02-10T16:00:00Z,False,5,12,0,0,50,28,22,62,36,26,-12,-14
Drinkwater,127,2,275,2019-02-27T20:00:00Z,True,5,16,0,0,50,28,22,60,27,33,-10,-5
Drinkwater,127,2,284,2019-03-03T14:05:00Z,False,5,8,0,0,53,31,22,17,15,2,36,7
Drinkwater,127,2,292,2019-03-10T14:05:00Z,True,5,19,0,0,56,31,25,43,24,19,13,12
Drinkwater,127,2,303,2019-03-17T16:30:00Z,False,5,7,0,0,57,32,25,37,22,15,20,3
Drinkwater,127,2,313,2019-03-31T13:05:00Z,False,5,4,0,0,57,32,25,28,20,8,29,5
Drinkwater,127,2,264,2019-04-03T18:45:00Z,True,5,2,0,0,60,32,28,33,22,11,27,21
Drinkwater,127,2,321,2019-04-08T19:00:00Z,True,5,18,0,0,63,35,28,42,27,15,21,20
Drinkwater,127,2,335,2019-04-14T15:30:00Z,False,5,11,0,0,66,38,28,82,44,38,-16,-16
Drinkwater,127,2,343,2019-04-22T19:00:00Z,True,5,3,0,0,66,38,28,39,23,16,27,22
Drinkwater,127,2,356,2019-04-28T15:30:00Z,False,5,13,0,0,67,39,28,64,35,29,3,-7
Drinkwater,127,2,363,2019-05-05T13:00:00Z,True,5,17,0,0,68,39,29,50,27,23,18,16
Drinkwater,127,2,374,2019-05-12T14:00:00Z,False,5,10,0,0,71,42,29,51,26,25,20,3
Bakayoko,128,2,3,2018-08-11T14:00:00Z,False,5,9,0,0,0,0,0,0,0,0,0,0
Bakayoko,128,2,13,2018-08-18T16:30:00Z,True,5,0,0,0,3,0,3,0,0,0,3,0
Bakayoko,128,2,26,2018-08-26T15:00:00Z,False,5,14,0,0,6,3,3,1,0,1,5,3
Bakayoko,128,2,33,2018-09-01T14:00:00Z,True,5,1,0,0,9,3,6,7,4,3,2,0
Bakayoko,128,2,41,2018-09-15T14:00:00Z,True,5,4,0,0,12,6,6,2,1,1,10,5
Bakayoko,128,2,59,2018-09-23T12:30:00Z,False,5,18,0,0,15,9,6,3,0,3,12,6
Bakayoko,128,2,63,2018-09-29T16:30:00Z,True,5,11,0,0,16,9,7,18,9,9,-2,0
Bakayoko,128,2,77,2018-10-07T13:15:00Z,False,5,15,0,0,17,10,7,5,2,3,12,5
Bakayoko,128,2,83,2018-10-20T11:30:00Z,True,5,13,0,0,20,10,10,13,7,6,7,4
Bakayoko,128,2,91,2018-10-28T13:30:00Z,False,5,3,0,0,21,11,10,8,4,4,13,6
Bakayoko,128,2,103,2018-11-04T16:00:00Z,True,5,6,0,0,24,11,13,8,2,6,16,5
Bakayoko,128,2,112,2018-11-11T14:15:00Z,True,5,7,0,0,27,14,13,18,13,5,9,9
Bakayoko,128,2,126,2018-11-24T17:30:00Z,False,5,16,0,0,28,15,13,27,6,21,1,7
Bakayoko,128,2,132,2018-12-02T12:00:00Z,True,5,8,0,0,28,15,13,8,7,1,20,14
Bakayoko,128,2,147,2018-12-05T19:45:00Z,False,5,19,0,0,31,18,13,16,8,8,15,5
Bakayoko,128,2,154,2018-12-08T17:30:00Z,True,5,12,0,0,31,18,13,41,24,17,-10,1
Bakayoko,128,2,160,2018-12-16T13:30:00Z,False,5,2,0,0,34,21,13,21,14,7,13,-1
Bakayoko,128,2,173,2018-12-22T15:00:00Z,True,5,10,0,0,37,21,16,22,11,11,15,10
Bakayoko,128,2,189,2018-12-26T19:30:00Z,False,5,17,0,0,37,21,16,27,15,12,10,1
Bakayoko,128,2,192,2018-12-30T12:00:00Z,False,5,6,0,0,40,21,19,19,9,10,21,10
Bakayoko,128,2,203,2019-01-02T19:45:00Z,True,5,15,0,0,43,21,22,15,8,7,28,14
Bakayoko,128,2,213,2019-01-12T17:30:00Z,True,5,14,0,0,44,22,22,18,7,11,26,11
Bakayoko,128,2,220,2019-01-19T17:30:00Z,False,5,0,0,0,47,25,22,41,26,15,6,-4
Bakayoko,128,2,231,2019-01-30T19:45:00Z,False,5,1,0,0,47,25,22,30,21,9,17,1
Bakayoko,128,2,243,2019-02-02T15:00:00Z,True,5,9,0,0,47,25,22,11,5,6,36,19
Bakayoko,128,2,255,2019-02-10T16:00:00Z,False,5,12,0,0,50,28,22,62,36,26,-12,-14
Bakayoko,128,2,275,2019-02-27T20:00:00Z,True,5,16,0,0,50,28,22,60,27,33,-10,-5
Bakayoko,128,2,284,2019-03-03T14:05:00Z,False,5,8,0,0,53,31,22,17,15,2,36,7
Bakayoko,128,2,292,2019-03-10T14:05:00Z,True,5,19,0,0,56,31,25,43,24,19,13,12
Bakayoko,128,2,303,2019-03-17T16:30:00Z,False,5,7,0,0,57,32,25,37,22,15,20,3
Bakayoko,128,2,313,2019-03-31T13:05:00Z,False,5,4,0,0,57,32,25,28,20,8,29,5
Bakayoko,128,2,264,2019-04-03T18:45:00Z,True,5,2,0,0,60,32,28,33,22,11,27,21
Bakayoko,128,2,321,2019-04-08T19:00:00Z,True,5,18,0,0,63,35,28,42,27,15,21,20
Bakayoko,128,2,335,2019-04-14T15:30:00Z,False,5,11,0,0,66,38,28,82,44,38,-16,-16
Bakayoko,128,2,343,2019-04-22T19:00:00Z,True,5,3,0,0,66,38,28,39,23,16,27,22
Bakayoko,128,2,356,2019-04-28T15:30:00Z,False,5,13,0,0,67,39,28,64,35,29,3,-7
Bakayoko,128,2,363,2019-05-05T13:00:00Z,True,5,17,0,0,68,39,29,50,27,23,18,16
Bakayoko,128,2,374,2019-05-12T14:00:00Z,False,5,10,0,0,71,42,29,51,26,25,20,3
Ampadu,129,2,3,2018-08-11T14:00:00Z,False,5,9,0,0,0,0,0,0,0,0,0,0
Ampadu,129,2,13,2018-08-18T16:30:00Z,True,5,0,0,0,3,0,3,0,0,0,3,0
Ampadu,129,2,26,2018-08-26T15:00:00Z,False,5,14,0,0,6,3,3,1,0,1,5,3
Ampadu,129,2,33,2018-09-01T14:00:00Z,True,5,1,0,0,9,3,6,7,4,3,2,0
Ampadu,129,2,41,2018-09-15T14:00:00Z,True,5,4,0,0,12,6,6,2,1,1,10,5
Ampadu,129,2,59,2018-09-23T12:30:00Z,False,5,18,0,0,15,9,6,3,0,3,12,6
Ampadu,129,2,63,2018-09-29T16:30:00Z,True,5,11,0,0,16,9,7,18,9,9,-2,0
Ampadu,129,2,77,2018-10-07T13:15:00Z,False,5,15,0,0,17,10,7,5,2,3,12,5
Ampadu,129,2,83,2018-10-20T11:30:00Z,True,5,13,0,0,20,10,10,13,7,6,7,4
Ampadu,129,2,91,2018-10-28T13:30:00Z,False,5,3,0,0,21,11,10,8,4,4,13,6
Ampadu,129,2,103,2018-11-04T16:00:00Z,True,5,6,0,0,24,11,13,8,2,6,16,5
Ampadu,129,2,112,2018-11-11T14:15:00Z,True,5,7,0,0,27,14,13,18,13,5,9,9
Ampadu,129,2,126,2018-11-24T17:30:00Z,False,5,16,0,0,28,15,13,27,6,21,1,7
Ampadu,129,2,132,2018-12-02T12:00:00Z,True,5,8,0,0,28,15,13,8,7,1,20,14
Ampadu,129,2,147,2018-12-05T19:45:00Z,False,5,19,0,0,31,18,13,16,8,8,15,5
Ampadu,129,2,154,2018-12-08T17:30:00Z,True,5,12,0,0,31,18,13,41,24,17,-10,1
Ampadu,129,2,160,2018-12-16T13:30:00Z,False,5,2,0,0,34,21,13,21,14,7,13,-1
Ampadu,129,2,173,2018-12-22T15:00:00Z,True,5,10,0,0,37,21,16,22,11,11,15,10
Ampadu,129,2,189,2018-12-26T19:30:00Z,False,5,17,0,0,37,21,16,27,15,12,10,1
Ampadu,129,2,192,2018-12-30T12:00:00Z,False,5,6,0,0,40,21,19,19,9,10,21,10
Ampadu,129,2,203,2019-01-02T19:45:00Z,True,5,15,0,0,43,21,22,15,8,7,28,14
Ampadu,129,2,213,2019-01-12T17:30:00Z,True,5,14,0,0,44,22,22,18,7,11,26,11
Ampadu,129,2,220,2019-01-19T17:30:00Z,False,5,0,0,0,47,25,22,41,26,15,6,-4
Ampadu,129,2,231,2019-01-30T19:45:00Z,False,5,1,0,0,47,25,22,30,21,9,17,1
Ampadu,129,2,243,2019-02-02T15:00:00Z,True,5,9,0,0,47,25,22,11,5,6,36,19
Ampadu,129,2,255,2019-02-10T16:00:00Z,False,5,12,0,0,50,28,22,62,36,26,-12,-14
Ampadu,129,2,275,2019-02-27T20:00:00Z,True,5,16,0,0,50,28,22,60,27,33,-10,-5
Ampadu,129,2,284,2019-03-03T14:05:00Z,False,5,8,0,0,53,31,22,17,15,2,36,7
Ampadu,129,2,292,2019-03-10T14:05:00Z,True,5,19,0,0,56,31,25,43,24,19,13,12
Ampadu,129,2,303,2019-03-17T16:30:00Z,False,5,7,0,0,57,32,25,37,22,15,20,3
Ampadu,129,2,313,2019-03-31T13:05:00Z,False,5,4,0,0,57,32,25,28,20,8,29,5
Ampadu,129,2,264,2019-04-03T18:45:00Z,True,5,2,0,0,60,32,28,33,22,11,27,21
Ampadu,129,2,321,2019-04-08T19:00:00Z,True,5,18,0,0,63,35,28,42,27,15,21,20
Ampadu,129,2,335,2019-04-14T15:30:00Z,False,5,11,0,0,66,38,28,82,44,38,-16,-16
Ampadu,129,2,343,2019-04-22T19:00:00Z,True,5,3,0,0,66,38,28,39,23,16,27,22
Ampadu,129,2,356,2019-04-28T15:30:00Z,False,5,13,0,0,67,39,28,64,35,29,3,-7
Ampadu,129,2,363,2019-05-05T13:00:00Z,True,5,17,0,0,68,39,29,50,27,23,18,16
Ampadu,129,2,374,2019-05-12T14:00:00Z,False,5,10,0,0,71,42,29,51,26,25,20,3
Hudson-Odoi,130,2,3,2018-08-11T14:00:00Z,False,5,9,0,0,0,0,0,0,0,0,0,0
Hudson-Odoi,130,2,13,2018-08-18T16:30:00Z,True,5,0,0,0,3,0,3,0,0,0,3,0
Hudson-Odoi,130,2,26,2018-08-26T15:00:00Z,False,5,14,0,0,6,3,3,1,0,1,5,3
Hudson-Odoi,130,2,33,2018-09-01T14:00:00Z,True,5,1,0,0,9,3,6,7,4,3,2,0
Hudson-Odoi,130,2,41,2018-09-15T14:00:00Z,True,5,4,0,0,12,6,6,2,1,1,10,5
Hudson-Odoi,130,2,59,2018-09-23T12:30:00Z,False,5,18,0,0,15,9,6,3,0,3,12,6
Hudson-Odoi,130,2,63,2018-09-29T16:30:00Z,True,5,11,0,0,16,9,7,18,9,9,-2,0
Hudson-Odoi,130,2,77,2018-10-07T13:15:00Z,False,5,15,0,0,17,10,7,5,2,3,12,5
Hudson-Odoi,130,2,83,2018-10-20T11:30:00Z,True,5,13,0,0,20,10,10,13,7,6,7,4
Hudson-Odoi,130,2,91,2018-10-28T13:30:00Z,False,5,3,0,0,21,11,10,8,4,4,13,6
Hudson-Odoi,130,2,103,2018-11-04T16:00:00Z,True,5,6,0,0,24,11,13,8,2,6,16,5
Hudson-Odoi,130,2,112,2018-11-11T14:15:00Z,True,5,7,0,0,27,14,13,18,13,5,9,9
Hudson-Odoi,130,2,126,2018-11-24T17:30:00Z,False,5,16,0,0,28,15,13,27,6,21,1,7
Hudson-Odoi,130,2,132,2018-12-02T12:00:00Z,True,5,8,0,0,28,15,13,8,7,1,20,14
Hudson-Odoi,130,2,147,2018-12-05T19:45:00Z,False,5,19,0,0,31,18,13,16,8,8,15,5
Hudson-Odoi,130,2,154,2018-12-08T17:30:00Z,True,5,12,0,0,31,18,13,41,24,17,-10,1
Hudson-Odoi,130,2,160,2018-12-16T13:30:00Z,False,5,2,0,0,34,21,13,21,14,7,13,-1
Hudson-Odoi,130,2,173,2018-12-22T15:00:00Z,True,5,10,0,0,37,21,16,22,11,11,15,10
Hudson-Odoi,130,2,189,2018-12-26T19:30:00Z,False,5,17,42,1,37,21,16,27,15,12,10,1
Hudson-Odoi,130,2,192,2018-12-30T12:00:00Z,False,5,6,0,0,40,21,19,19,9,10,21,10
Hudson-Odoi,130,2,203,2019-01-02T19:45:00Z,True,5,15,0,0,43,21,22,15,8,7,28,14
Hudson-Odoi,130,2,213,2019-01-12T17:30:00Z,True,5,14,9,1,44,22,22,18,7,11,26,11
Hudson-Odoi,130,2,220,2019-01-19T17:30:00Z,False,5,0,10,1,47,25,22,41,26,15,6,-4
Hudson-Odoi,130,2,231,2019-01-30T19:45:00Z,False,5,1,0,0,47,25,22,30,21,9,17,1
Hudson-Odoi,130,2,243,2019-02-02T15:00:00Z,True,5,9,13,1,47,25,22,11,5,6,36,19
Hudson-Odoi,130,2,255,2019-02-10T16:00:00Z,False,5,12,0,0,50,28,22,62,36,26,-12,-14
Hudson-Odoi,130,2,275,2019-02-27T20:00:00Z,True,5,16,0,0,50,28,22,60,27,33,-10,-5
Hudson-Odoi,130,2,284,2019-03-03T14:05:00Z,False,5,8,0,0,53,31,22,17,15,2,36,7
Hudson-Odoi,130,2,292,2019-03-10T14:05:00Z,True,5,19,29,1,56,31,25,43,24,19,13,12
Hudson-Odoi,130,2,303,2019-03-17T16:30:00Z,False,5,7,16,1,57,32,25,37,22,15,20,3
Hudson-Odoi,130,2,313,2019-03-31T13:05:00Z,False,5,4,0,0,57,32,25,28,20,8,29,5
Hudson-Odoi,130,2,264,2019-04-03T18:45:00Z,True,5,2,90,7,60,32,28,33,22,11,27,21
Hudson-Odoi,130,2,321,2019-04-08T19:00:00Z,True,5,18,84,3,63,35,28,42,27,15,21,20
Hudson-Odoi,130,2,335,2019-04-14T15:30:00Z,False,5,11,55,1,66,38,28,82,44,38,-16,-16
Hudson-Odoi,130,2,343,2019-04-22T19:00:00Z,True,5,3,40,1,66,38,28,39,23,16,27,22
Hudson-Odoi,130,2,356,2019-04-28T15:30:00Z,False,5,13,0,0,67,39,28,64,35,29,3,-7
Hudson-Odoi,130,2,363,2019-05-05T13:00:00Z,True,5,17,0,0,68,39,29,50,27,23,18,16
Hudson-Odoi,130,2,374,2019-05-12T14:00:00Z,False,5,10,0,0,71,42,29,51,26,25,20,3
Loftus-Cheek,131,2,3,2018-08-11T14:00:00Z,False,5,9,22,1,0,0,0,0,0,0,0,0
Loftus-Cheek,131,2,13,2018-08-18T16:30:00Z,True,5,0,0,0,3,0,3,0,0,0,3,0
Loftus-Cheek,131,2,26,2018-08-26T15:00:00Z,False,5,14,0,0,6,3,3,1,0,1,5,3
Loftus-Cheek,131,2,33,2018-09-01T14:00:00Z,True,5,1,11,1,9,3,6,7,4,3,2,0
Loftus-Cheek,131,2,41,2018-09-15T14:00:00Z,True,5,4,0,0,12,6,6,2,1,1,10,5
Loftus-Cheek,131,2,59,2018-09-23T12:30:00Z,False,5,18,0,0,15,9,6,3,0,3,12,6
Loftus-Cheek,131,2,63,2018-09-29T16:30:00Z,True,5,11,0,0,16,9,7,18,9,9,-2,0
Loftus-Cheek,131,2,77,2018-10-07T13:15:00Z,False,5,15,0,0,17,10,7,5,2,3,12,5
Loftus-Cheek,131,2,83,2018-10-20T11:30:00Z,True,5,13,0,0,20,10,10,13,7,6,7,4
Loftus-Cheek,131,2,91,2018-10-28T13:30:00Z,False,5,3,60,8,21,11,10,8,4,4,13,6
Loftus-Cheek,131,2,103,2018-11-04T16:00:00Z,True,5,6,0,0,24,11,13,8,2,6,16,5
Loftus-Cheek,131,2,112,2018-11-11T14:15:00Z,True,5,7,0,0,27,14,13,18,13,5,9,9
Loftus-Cheek,131,2,126,2018-11-24T17:30:00Z,False,5,16,0,0,28,15,13,27,6,21,1,7
Loftus-Cheek,131,2,132,2018-12-02T12:00:00Z,True,5,8,23,6,28,15,13,8,7,1,20,14
Loftus-Cheek,131,2,147,2018-12-05T19:45:00Z,False,5,19,90,10,31,18,13,16,8,8,15,5
Loftus-Cheek,131,2,154,2018-12-08T17:30:00Z,True,5,12,15,1,31,18,13,41,24,17,-10,1
Loftus-Cheek,131,2,160,2018-12-16T13:30:00Z,False,5,2,24,1,34,21,13,21,14,7,13,-1
Loftus-Cheek,131,2,173,2018-12-22T15:00:00Z,True,5,10,29,1,37,21,16,22,11,11,15,10
Loftus-Cheek,131,2,189,2018-12-26T19:30:00Z,False,5,17,0,0,37,21,16,27,15,12,10,1
Loftus-Cheek,131,2,192,2018-12-30T12:00:00Z,False,5,6,0,0,40,21,19,19,9,10,21,10
Loftus-Cheek,131,2,203,2019-01-02T19:45:00Z,True,5,15,53,1,43,21,22,15,8,7,28,14
Loftus-Cheek,131,2,213,2019-01-12T17:30:00Z,True,5,14,0,0,44,22,22,18,7,11,26,11
Loftus-Cheek,131,2,220,2019-01-19T17:30:00Z,False,5,0,0,0,47,25,22,41,26,15,6,-4
Loftus-Cheek,131,2,231,2019-01-30T19:45:00Z,False,5,1,13,1,47,25,22,30,21,9,17,1
Loftus-Cheek,131,2,243,2019-02-02T15:00:00Z,True,5,9,7,1,47,25,22,11,5,6,36,19
Loftus-Cheek,131,2,255,2019-02-10T16:00:00Z,False,5,12,25,1,50,28,22,62,36,26,-12,-14
Loftus-Cheek,131,2,275,2019-02-27T20:00:00Z,True,5,16,13,1,50,28,22,60,27,33,-10,-5
Loftus-Cheek,131,2,284,2019-03-03T14:05:00Z,False,5,8,12,1,53,31,22,17,15,2,36,7
Loftus-Cheek,131,2,292,2019-03-10T14:05:00Z,True,5,19,34,1,56,31,25,43,24,19,13,12
Loftus-Cheek,131,2,303,2019-03-17T16:30:00Z,False,5,7,25,1,57,32,25,37,22,15,20,3
Loftus-Cheek,131,2,313,2019-03-31T13:05:00Z,False,5,4,26,6,57,32,25,28,20,8,29,5
Loftus-Cheek,131,2,264,2019-04-03T18:45:00Z,True,5,2,81,13,60,32,28,33,22,11,27,21
Loftus-Cheek,131,2,321,2019-04-08T19:00:00Z,True,5,18,69,6,63,35,28,42,27,15,21,20
Loftus-Cheek,131,2,335,2019-04-14T15:30:00Z,False,5,11,74,2,66,38,28,82,44,38,-16,-16
Loftus-Cheek,131,2,343,2019-04-22T19:00:00Z,True,5,3,90,2,66,38,28,39,23,16,27,22
Loftus-Cheek,131,2,356,2019-04-28T15:30:00Z,False,5,13,14,1,67,39,28,64,35,29,3,-7
Loftus-Cheek,131,2,363,2019-05-05T13:00:00Z,True,5,17,80,9,68,39,29,50,27,23,18,16
Loftus-Cheek,131,2,374,2019-05-12T14:00:00Z,False,5,10,90,3,71,42,29,51,26,25,20,3
Giroud,132,3,3,2018-08-11T14:00:00Z,False,5,9,0,0,0,0,0,0,0,0,0,0
Giroud,132,3,13,2018-08-18T16:30:00Z,True,5,0,15,1,3,0,3,0,0,0,3,0
Giroud,132,3,26,2018-08-26T15:00:00Z,False,5,14,25,1,6,3,3,1,0,1,5,3
Giroud,132,3,33,2018-09-01T14:00:00Z,True,5,1,29,4,9,3,6,7,4,3,2,0
Giroud,132,3,41,2018-09-15T14:00:00Z,True,5,4,90,10,12,6,6,2,1,1,10,5
Giroud,132,3,59,2018-09-23T12:30:00Z,False,5,18,64,2,15,9,6,3,0,3,12,6
Giroud,132,3,63,2018-09-29T16:30:00Z,True,5,11,64,2,16,9,7,18,9,9,-2,0
Giroud,132,3,77,2018-10-07T13:15:00Z,False,5,15,67,5,17,10,7,5,2,3,12,5
Giroud,132,3,83,2018-10-20T11:30:00Z,True,5,13,11,1,20,10,10,13,7,6,7,4
Giroud,132,3,91,2018-10-28T13:30:00Z,False,5,3,16,1,21,11,10,8,4,4,13,6
Giroud,132,3,103,2018-11-04T16:00:00Z,True,5,6,0,0,24,11,13,8,2,6,16,5
Giroud,132,3,112,2018-11-11T14:15:00Z,True,5,7,0,0,27,14,13,18,13,5,9,9
Giroud,132,3,126,2018-11-24T17:30:00Z,False,5,16,14,5,28,15,13,27,6,21,1,7
Giroud,132,3,132,2018-12-02T12:00:00Z,True,5,8,69,2,28,15,13,8,7,1,20,14
Giroud,132,3,147,2018-12-05T19:45:00Z,False,5,19,25,0,31,18,13,16,8,8,15,5
Giroud,132,3,154,2018-12-08T17:30:00Z,True,5,12,1,1,31,18,13,41,24,17,-10,1
Giroud,132,3,160,2018-12-16T13:30:00Z,False,5,2,7,1,34,21,13,21,14,7,13,-1
Giroud,132,3,173,2018-12-22T15:00:00Z,True,5,10,29,1,37,21,16,22,11,11,15,10
Giroud,132,3,189,2018-12-26T19:30:00Z,False,5,17,0,0,37,21,16,27,15,12,10,1
Giroud,132,3,192,2018-12-30T12:00:00Z,False,5,6,75,2,40,21,19,19,9,10,21,10
Giroud,132,3,203,2019-01-02T19:45:00Z,True,5,15,0,0,43,21,22,15,8,7,28,14
Giroud,132,3,213,2019-01-12T17:30:00Z,True,5,14,3,1,44,22,22,18,7,11,26,11
Giroud,132,3,220,2019-01-19T17:30:00Z,False,5,0,22,1,47,25,22,41,26,15,6,-4
Giroud,132,3,231,2019-01-30T19:45:00Z,False,5,1,25,1,47,25,22,30,21,9,17,1
Giroud,132,3,243,2019-02-02T15:00:00Z,True,5,9,0,0,47,25,22,11,5,6,36,19
Giroud,132,3,255,2019-02-10T16:00:00Z,False,5,12,0,0,50,28,22,62,36,26,-12,-14
Giroud,132,3,275,2019-02-27T20:00:00Z,True,5,16,6,1,50,28,22,60,27,33,-10,-5
Giroud,132,3,284,2019-03-03T14:05:00Z,False,5,8,0,0,53,31,22,17,15,2,36,7
Giroud,132,3,292,2019-03-10T14:05:00Z,True,5,19,0,0,56,31,25,43,24,19,13,12
Giroud,132,3,303,2019-03-17T16:30:00Z,False,5,7,24,1,57,32,25,37,22,15,20,3
Giroud,132,3,313,2019-03-31T13:05:00Z,False,5,4,13,1,57,32,25,28,20,8,29,5
Giroud,132,3,264,2019-04-03T18:45:00Z,True,5,2,90,6,60,32,28,33,22,11,27,21
Giroud,132,3,321,2019-04-08T19:00:00Z,True,5,18,14,1,63,35,28,42,27,15,21,20
Giroud,132,3,335,2019-04-14T15:30:00Z,False,5,11,0,0,66,38,28,82,44,38,-16,-16
Giroud,132,3,343,2019-04-22T19:00:00Z,True,5,3,13,1,66,38,28,39,23,16,27,22
Giroud,132,3,356,2019-04-28T15:30:00Z,False,5,13,0,0,67,39,28,64,35,29,3,-7
Giroud,132,3,363,2019-05-05T13:00:00Z,True,5,17,11,1,68,39,29,50,27,23,18,16
Giroud,132,3,374,2019-05-12T14:00:00Z,False,5,10,6,1,71,42,29,51,26,25,20,3
Morata,133,3,3,2018-08-11T14:00:00Z,False,5,9,90,2,0,0,0,0,0,0,0,0
Morata,133,3,13,2018-08-18T16:30:00Z,True,5,0,74,6,3,0,3,0,0,0,3,0
Morata,133,3,26,2018-08-26T15:00:00Z,False,5,14,64,2,6,3,3,1,0,1,5,3
Morata,133,3,33,2018-09-01T14:00:00Z,True,5,1,60,2,9,3,6,7,4,3,2,0
Morata,133,3,41,2018-09-15T14:00:00Z,True,5,4,0,0,12,6,6,2,1,1,10,5
Morata,133,3,59,2018-09-23T12:30:00Z,False,5,18,25,1,15,9,6,3,0,3,12,6
Morata,133,3,63,2018-09-29T16:30:00Z,True,5,11,25,1,16,9,7,18,9,9,-2,0
Morata,133,3,77,2018-10-07T13:15:00Z,False,5,15,22,5,17,10,7,5,2,3,12,5
Morata,133,3,83,2018-10-20T11:30:00Z,True,5,13,78,2,20,10,10,13,7,6,7,4
Morata,133,3,91,2018-10-28T13:30:00Z,False,5,3,73,5,21,11,10,8,4,4,13,6
Morata,133,3,103,2018-11-04T16:00:00Z,True,5,6,90,13,24,11,13,8,2,6,16,5
Morata,133,3,112,2018-11-11T14:15:00Z,True,5,7,90,1,27,14,13,18,13,5,9,9
Morata,133,3,126,2018-11-24T17:30:00Z,False,5,16,57,1,28,15,13,27,6,21,1,7
Morata,133,3,132,2018-12-02T12:00:00Z,True,5,8,20,0,28,15,13,8,7,1,20,14
Morata,133,3,147,2018-12-05T19:45:00Z,False,5,19,64,2,31,18,13,16,8,8,15,5
Morata,133,3,154,2018-12-08T17:30:00Z,True,5,12,0,0,31,18,13,41,24,17,-10,1
Morata,133,3,160,2018-12-16T13:30:00Z,False,5,2,0,0,34,21,13,21,14,7,13,-1
Morata,133,3,173,2018-12-22T15:00:00Z,True,5,10,0,0,37,21,16,22,11,11,15,10
Morata,133,3,189,2018-12-26T19:30:00Z,False,5,17,0,0,37,21,16,27,15,12,10,1
Morata,133,3,192,2018-12-30T12:00:00Z,False,5,6,14,1,40,21,19,19,9,10,21,10
Morata,133,3,203,2019-01-02T19:45:00Z,True,5,15,90,2,43,21,22,15,8,7,28,14
Morata,133,3,213,2019-01-12T17:30:00Z,True,5,14,0,0,44,22,22,18,7,11,26,11
Morata,133,3,220,2019-01-19T17:30:00Z,False,5,0,0,0,47,25,22,41,26,15,6,-4
Morata,133,3,231,2019-01-30T19:45:00Z,False,5,1,0,0,47,25,22,30,21,9,17,1
Morata,133,3,243,2019-02-02T15:00:00Z,True,5,9,0,0,47,25,22,11,5,6,36,19
Morata,133,3,255,2019-02-10T16:00:00Z,False,5,12,0,0,50,28,22,62,36,26,-12,-14
Morata,133,3,275,2019-02-27T20:00:00Z,True,5,16,0,0,50,28,22,60,27,33,-10,-5
Morata,133,3,284,2019-03-03T14:05:00Z,False,5,8,0,0,53,31,22,17,15,2,36,7
Morata,133,3,292,2019-03-10T14:05:00Z,True,5,19,0,0,56,31,25,43,24,19,13,12
Morata,133,3,303,2019-03-17T16:30:00Z,False,5,7,0,0,57,32,25,37,22,15,20,3
Morata,133,3,313,2019-03-31T13:05:00Z,False,5,4,0,0,57,32,25,28,20,8,29,5
Morata,133,3,264,2019-04-03T18:45:00Z,True,5,2,0,0,60,32,28,33,22,11,27,21
Morata,133,3,321,2019-04-08T19:00:00Z,True,5,18,0,0,63,35,28,42,27,15,21,20
Morata,133,3,335,2019-04-14T15:30:00Z,False,5,11,0,0,66,38,28,82,44,38,-16,-16
Morata,133,3,343,2019-04-22T19:00:00Z,True,5,3,0,0,66,38,28,39,23,16,27,22
Morata,133,3,356,2019-04-28T15:30:00Z,False,5,13,0,0,67,39,28,64,35,29,3,-7
Morata,133,3,363,2019-05-05T13:00:00Z,True,5,17,0,0,68,39,29,50,27,23,18,16
Morata,133,3,374,2019-05-12T14:00:00Z,False,5,10,0,0,71,42,29,51,26,25,20,3
Hennessey,134,0,2,2018-08-11T14:00:00Z,False,6,8,90,9,0,0,0,0,0,0,0,0
Hennessey,134,0,14,2018-08-20T19:00:00Z,True,6,11,90,2,3,0,3,3,3,0,0,0
Hennessey,134,0,28,2018-08-26T12:30:00Z,False,6,17,90,2,3,0,3,6,3,3,-3,0
Hennessey,134,0,34,2018-09-01T14:00:00Z,True,6,15,90,8,3,0,3,1,1,0,2,0
Hennessey,134,0,43,2018-09-15T14:00:00Z,False,6,9,90,6,3,0,3,2,1,1,1,2
Hennessey,134,0,54,2018-09-22T14:00:00Z,True,6,14,90,8,6,0,6,1,0,1,5,-1
Hennessey,134,0,61,2018-10-01T19:00:00Z,False,6,1,90,2,7,1,6,10,7,3,-3,-1
Hennessey,134,0,72,2018-10-06T14:00:00Z,True,6,19,90,2,7,1,6,12,8,4,-5,-3
Hennessey,134,0,84,2018-10-21T15:00:00Z,False,6,7,90,1,7,1,6,12,7,5,-5,-1
Hennessey,134,0,92,2018-10-28T13:30:00Z,True,6,0,90,1,7,1,6,21,12,9,-14,-8
Hennessey,134,0,103,2018-11-04T16:00:00Z,False,6,5,90,2,8,2,6,24,11,13,-16,-5
Hennessey,134,0,113,2018-11-10T17:30:00Z,True,6,16,90,2,8,2,6,24,6,18,-16,-16
Hennessey,134,0,125,2018-11-24T15:00:00Z,False,6,13,90,10,8,2,6,20,10,10,-12,-4
Hennessey,134,0,133,2018-12-01T15:00:00Z,True,6,3,90,6,9,2,7,9,4,5,0,-3
Hennessey,134,0,141,2018-12-04T19:45:00Z,False,6,2,90,1,12,5,7,18,11,7,-6,-4
Hennessey,134,0,159,2018-12-08T15:00:00Z,False,6,18,90,2,12,5,7,18,10,8,-6,-3
Hennessey,134,0,161,2018-12-15T15:00:00Z,True,6,10,0,0,12,5,7,22,11,11,-10,-6
Hennessey,134,0,176,2018-12-22T15:00:00Z,False,6,12,0,0,15,8,7,44,27,17,-29,-20
Hennessey,134,0,182,2018-12-26T15:00:00Z,True,6,4,0,0,18,8,10,14,13,1,4,7
Hennessey,134,0,192,2018-12-30T12:00:00Z,True,6,5,0,0,19,9,10,40,21,19,-21,-10
Hennessey,134,0,209,2019-01-02T19:45:00Z,False,6,19,0,0,19,9,10,29,14,15,-10,-4
Hennessey,134,0,214,2019-01-12T15:00:00Z,True,6,17,45,0,22,9,13,29,16,13,-7,-4
Hennessey,134,0,224,2019-01-19T15:00:00Z,False,6,11,0,0,22,9,13,57,28,29,-35,-15
Hennessey,134,0,238,2019-01-30T19:45:00Z,False,6,15,0,0,22,9,13,22,11,11,0,2
Hennessey,134,0,244,2019-02-02T15:00:00Z,True,6,8,0,0,23,9,14,17,15,2,6,7
Hennessey,134,0,251,2019-02-09T15:00:00Z,True,6,18,0,0,26,12,14,32,18,14,-6,-2
Hennessey,134,0,266,2019-02-23T17:30:00Z,False,6,10,0,0,27,13,14,32,14,18,-5,0
Hennessey,134,0,272,2019-02-27T20:00:00Z,True,6,13,0,0,30,13,17,52,26,26,-22,-13
Hennessey,134,0,282,2019-03-02T15:00:00Z,False,6,3,90,3,30,13,17,30,17,13,0,0
Hennessey,134,0,293,2019-03-09T12:30:00Z,True,6,2,0,0,33,13,20,30,22,8,3,5
Hennessey,134,0,314,2019-03-30T15:00:00Z,True,6,9,0,0,33,13,20,14,8,6,19,7
Hennessey,134,0,306,2019-04-03T18:45:00Z,False,6,16,0,0,36,16,20,61,28,33,-25,-8
Hennessey,134,0,325,2019-04-06T14:00:00Z,False,6,14,0,0,36,16,20,35,22,13,1,-2
Hennessey,134,0,332,2019-04-14T13:05:00Z,True,6,12,0,0,39,16,23,80,48,32,-41,-16
Hennessey,134,0,340,2019-04-21T15:00:00Z,False,6,0,0,0,39,16,23,66,44,22,-27,-21
Hennessey,134,0,352,2019-04-27T14:00:00Z,True,6,7,0,0,42,16,26,49,31,18,-7,-2
Hennessey,134,0,362,2019-05-04T16:30:00Z,False,6,4,0,0,43,17,26,31,20,11,12,6
Hennessey,134,0,372,2019-05-12T14:00:00Z,True,6,1,0,0,46,17,29,45,29,16,1,1
Speroni,135,0,2,2018-08-11T14:00:00Z,False,6,8,0,0,0,0,0,0,0,0,0,0
Speroni,135,0,14,2018-08-20T19:00:00Z,True,6,11,0,0,3,0,3,3,3,0,0,0
Speroni,135,0,28,2018-08-26T12:30:00Z,False,6,17,0,0,3,0,3,6,3,3,-3,0
Speroni,135,0,34,2018-09-01T14:00:00Z,True,6,15,0,0,3,0,3,1,1,0,2,0
Speroni,135,0,43,2018-09-15T14:00:00Z,False,6,9,0,0,3,0,3,2,1,1,1,2
Speroni,135,0,54,2018-09-22T14:00:00Z,True,6,14,0,0,6,0,6,1,0,1,5,-1
Speroni,135,0,61,2018-10-01T19:00:00Z,False,6,1,0,0,7,1,6,10,7,3,-3,-1
Speroni,135,0,72,2018-10-06T14:00:00Z,True,6,19,0,0,7,1,6,12,8,4,-5,-3
Speroni,135,0,84,2018-10-21T15:00:00Z,False,6,7,0,0,7,1,6,12,7,5,-5,-1
Speroni,135,0,92,2018-10-28T13:30:00Z,True,6,0,0,0,7,1,6,21,12,9,-14,-8
Speroni,135,0,103,2018-11-04T16:00:00Z,False,6,5,0,0,8,2,6,24,11,13,-16,-5
Speroni,135,0,113,2018-11-10T17:30:00Z,True,6,16,0,0,8,2,6,24,6,18,-16,-16
Speroni,135,0,125,2018-11-24T15:00:00Z,False,6,13,0,0,8,2,6,20,10,10,-12,-4
Speroni,135,0,133,2018-12-01T15:00:00Z,True,6,3,0,0,9,2,7,9,4,5,0,-3
Speroni,135,0,141,2018-12-04T19:45:00Z,False,6,2,0,0,12,5,7,18,11,7,-6,-4
Speroni,135,0,159,2018-12-08T15:00:00Z,False,6,18,0,0,12,5,7,18,10,8,-6,-3
Speroni,135,0,161,2018-12-15T15:00:00Z,True,6,10,0,0,12,5,7,22,11,11,-10,-6
Speroni,135,0,176,2018-12-22T15:00:00Z,False,6,12,0,0,15,8,7,44,27,17,-29,-20
Speroni,135,0,182,2018-12-26T15:00:00Z,True,6,4,0,0,18,8,10,14,13,1,4,7
Speroni,135,0,192,2018-12-30T12:00:00Z,True,6,5,0,0,19,9,10,40,21,19,-21,-10
Speroni,135,0,209,2019-01-02T19:45:00Z,False,6,19,0,0,19,9,10,29,14,15,-10,-4
Speroni,135,0,214,2019-01-12T15:00:00Z,True,6,17,0,0,22,9,13,29,16,13,-7,-4
Speroni,135,0,224,2019-01-19T15:00:00Z,False,6,11,90,1,22,9,13,57,28,29,-35,-15
Speroni,135,0,238,2019-01-30T19:45:00Z,False,6,15,0,0,22,9,13,22,11,11,0,2
Speroni,135,0,244,2019-02-02T15:00:00Z,True,6,8,0,0,23,9,14,17,15,2,6,7
Speroni,135,0,251,2019-02-09T15:00:00Z,True,6,18,0,0,26,12,14,32,18,14,-6,-2
Speroni,135,0,266,2019-02-23T17:30:00Z,False,6,10,0,0,27,13,14,32,14,18,-5,0
Speroni,135,0,272,2019-02-27T20:00:00Z,True,6,13,0,0,30,13,17,52,26,26,-22,-13
Speroni,135,0,282,2019-03-02T15:00:00Z,False,6,3,0,0,30,13,17,30,17,13,0,0
Speroni,135,0,293,2019-03-09T12:30:00Z,True,6,2,0,0,33,13,20,30,22,8,3,5
Speroni,135,0,314,2019-03-30T15:00:00Z,True,6,9,0,0,33,13,20,14,8,6,19,7
Speroni,135,0,306,2019-04-03T18:45:00Z,False,6,16,0,0,36,16,20,61,28,33,-25,-8
Speroni,135,0,325,2019-04-06T14:00:00Z,False,6,14,0,0,36,16,20,35,22,13,1,-2
Speroni,135,0,332,2019-04-14T13:05:00Z,True,6,12,0,0,39,16,23,80,48,32,-41,-16
Speroni,135,0,340,2019-04-21T15:00:00Z,False,6,0,0,0,39,16,23,66,44,22,-27,-21
Speroni,135,0,352,2019-04-27T14:00:00Z,True,6,7,0,0,42,16,26,49,31,18,-7,-2
Speroni,135,0,362,2019-05-04T16:30:00Z,False,6,4,0,0,43,17,26,31,20,11,12,6
Speroni,135,0,372,2019-05-12T14:00:00Z,True,6,1,0,0,46,17,29,45,29,16,1,1
Guaita,136,0,2,2018-08-11T14:00:00Z,False,6,8,0,0,0,0,0,0,0,0,0,0
Guaita,136,0,14,2018-08-20T19:00:00Z,True,6,11,0,0,3,0,3,3,3,0,0,0
Guaita,136,0,28,2018-08-26T12:30:00Z,False,6,17,0,0,3,0,3,6,3,3,-3,0
Guaita,136,0,34,2018-09-01T14:00:00Z,True,6,15,0,0,3,0,3,1,1,0,2,0
Guaita,136,0,43,2018-09-15T14:00:00Z,False,6,9,0,0,3,0,3,2,1,1,1,2
Guaita,136,0,54,2018-09-22T14:00:00Z,True,6,14,0,0,6,0,6,1,0,1,5,-1
Guaita,136,0,61,2018-10-01T19:00:00Z,False,6,1,0,0,7,1,6,10,7,3,-3,-1
Guaita,136,0,72,2018-10-06T14:00:00Z,True,6,19,0,0,7,1,6,12,8,4,-5,-3
Guaita,136,0,84,2018-10-21T15:00:00Z,False,6,7,0,0,7,1,6,12,7,5,-5,-1
Guaita,136,0,92,2018-10-28T13:30:00Z,True,6,0,0,0,7,1,6,21,12,9,-14,-8
Guaita,136,0,103,2018-11-04T16:00:00Z,False,6,5,0,0,8,2,6,24,11,13,-16,-5
Guaita,136,0,113,2018-11-10T17:30:00Z,True,6,16,0,0,8,2,6,24,6,18,-16,-16
Guaita,136,0,125,2018-11-24T15:00:00Z,False,6,13,0,0,8,2,6,20,10,10,-12,-4
Guaita,136,0,133,2018-12-01T15:00:00Z,True,6,3,0,0,9,2,7,9,4,5,0,-3
Guaita,136,0,141,2018-12-04T19:45:00Z,False,6,2,0,0,12,5,7,18,11,7,-6,-4
Guaita,136,0,159,2018-12-08T15:00:00Z,False,6,18,0,0,12,5,7,18,10,8,-6,-3
Guaita,136,0,161,2018-12-15T15:00:00Z,True,6,10,90,5,12,5,7,22,11,11,-10,-6
Guaita,136,0,176,2018-12-22T15:00:00Z,False,6,12,90,1,15,8,7,44,27,17,-29,-20
Guaita,136,0,182,2018-12-26T15:00:00Z,True,6,4,90,9,18,8,10,14,13,1,4,7
Guaita,136,0,192,2018-12-30T12:00:00Z,True,6,5,90,3,19,9,10,40,21,19,-21,-10
Guaita,136,0,209,2019-01-02T19:45:00Z,False,6,19,90,6,19,9,10,29,14,15,-10,-4
Guaita,136,0,214,2019-01-12T15:00:00Z,True,6,17,44,1,22,9,13,29,16,13,-7,-4
Guaita,136,0,224,2019-01-19T15:00:00Z,False,6,11,0,0,22,9,13,57,28,29,-35,-15
Guaita,136,0,238,2019-01-30T19:45:00Z,False,6,15,90,3,22,9,13,22,11,11,0,2
Guaita,136,0,244,2019-02-02T15:00:00Z,True,6,8,90,6,23,9,14,17,15,2,6,7
Guaita,136,0,251,2019-02-09T15:00:00Z,True,6,18,90,3,26,12,14,32,18,14,-6,-2
Guaita,136,0,266,2019-02-23T17:30:00Z,False,6,10,90,3,27,13,14,32,14,18,-5,0
Guaita,136,0,272,2019-02-27T20:00:00Z,True,6,13,90,1,30,13,17,52,26,26,-22,-13
Guaita,136,0,282,2019-03-02T15:00:00Z,False,6,3,0,0,30,13,17,30,17,13,0,0
Guaita,136,0,293,2019-03-09T12:30:00Z,True,6,2,90,1,33,13,20,30,22,8,3,5
Guaita,136,0,314,2019-03-30T15:00:00Z,True,6,9,90,9,33,13,20,14,8,6,19,7
Guaita,136,0,306,2019-04-03T18:45:00Z,False,6,16,90,3,36,16,20,61,28,33,-25,-8
Guaita,136,0,325,2019-04-06T14:00:00Z,False,6,14,90,10,36,16,20,35,22,13,1,-2
Guaita,136,0,332,2019-04-14T13:05:00Z,True,6,12,90,2,39,16,23,80,48,32,-41,-16
Guaita,136,0,340,2019-04-21T15:00:00Z,False,6,0,90,2,39,16,23,66,44,22,-27,-21
Guaita,136,0,352,2019-04-27T14:00:00Z,True,6,7,90,8,42,16,26,49,31,18,-7,-2
Guaita,136,0,362,2019-05-04T16:30:00Z,False,6,4,90,3,43,17,26,31,20,11,12,6
Guaita,136,0,372,2019-05-12T14:00:00Z,True,6,1,90,2,46,17,29,45,29,16,1,1
Tomkins,137,1,2,2018-08-11T14:00:00Z,False,6,8,90,6,0,0,0,0,0,0,0,0
Tomkins,137,1,14,2018-08-20T19:00:00Z,True,6,11,90,1,3,0,3,3,3,0,0,0
Tomkins,137,1,28,2018-08-26T12:30:00Z,False,6,17,0,0,3,0,3,6,3,3,-3,0
Tomkins,137,1,34,2018-09-01T14:00:00Z,True,6,15,0,0,3,0,3,1,1,0,2,0
Tomkins,137,1,43,2018-09-15T14:00:00Z,False,6,9,90,6,3,0,3,2,1,1,1,2
Tomkins,137,1,54,2018-09-22T14:00:00Z,True,6,14,90,5,6,0,6,1,0,1,5,-1
Tomkins,137,1,61,2018-10-01T19:00:00Z,False,6,1,90,0,7,1,6,10,7,3,-3,-1
Tomkins,137,1,72,2018-10-06T14:00:00Z,True,6,19,90,2,7,1,6,12,8,4,-5,-3
Tomkins,137,1,84,2018-10-21T15:00:00Z,False,6,7,90,1,7,1,6,12,7,5,-5,-1
Tomkins,137,1,92,2018-10-28T13:30:00Z,True,6,0,90,1,7,1,6,21,12,9,-14,-8
Tomkins,137,1,103,2018-11-04T16:00:00Z,False,6,5,90,1,8,2,6,24,11,13,-16,-5
Tomkins,137,1,113,2018-11-10T17:30:00Z,True,6,16,59,0,8,2,6,24,6,18,-16,-16
Tomkins,137,1,125,2018-11-24T15:00:00Z,False,6,13,90,6,8,2,6,20,10,10,-12,-4
Tomkins,137,1,133,2018-12-01T15:00:00Z,True,6,3,90,6,9,2,7,9,4,5,0,-3
Tomkins,137,1,141,2018-12-04T19:45:00Z,False,6,2,90,0,12,5,7,18,11,7,-6,-4
Tomkins,137,1,159,2018-12-08T15:00:00Z,False,6,18,90,3,12,5,7,18,10,8,-6,-3
Tomkins,137,1,161,2018-12-15T15:00:00Z,True,6,10,0,0,12,5,7,22,11,11,-10,-6
Tomkins,137,1,176,2018-12-22T15:00:00Z,False,6,12,90,1,15,8,7,44,27,17,-29,-20
Tomkins,137,1,182,2018-12-26T15:00:00Z,True,6,4,90,6,18,8,10,14,13,1,4,7
Tomkins,137,1,192,2018-12-30T12:00:00Z,True,6,5,90,2,19,9,10,40,21,19,-21,-10
Tomkins,137,1,209,2019-01-02T19:45:00Z,False,6,19,90,6,19,9,10,29,14,15,-10,-4
Tomkins,137,1,214,2019-01-12T15:00:00Z,True,6,17,90,1,22,9,13,29,16,13,-7,-4
Tomkins,137,1,224,2019-01-19T15:00:00Z,False,6,11,90,6,22,9,13,57,28,29,-35,-15
Tomkins,137,1,238,2019-01-30T19:45:00Z,False,6,15,90,2,22,9,13,22,11,11,0,2
Tomkins,137,1,244,2019-02-02T15:00:00Z,True,6,8,90,6,23,9,14,17,15,2,6,7
Tomkins,137,1,251,2019-02-09T15:00:00Z,True,6,18,0,0,26,12,14,32,18,14,-6,-2
Tomkins,137,1,266,2019-02-23T17:30:00Z,False,6,10,90,2,27,13,14,32,14,18,-5,0
Tomkins,137,1,272,2019-02-27T20:00:00Z,True,6,13,90,1,30,13,17,52,26,26,-22,-13
Tomkins,137,1,282,2019-03-02T15:00:00Z,False,6,3,90,1,30,13,17,30,17,13,0,0
Tomkins,137,1,293,2019-03-09T12:30:00Z,True,6,2,90,1,33,13,20,30,22,8,3,5
Tomkins,137,1,314,2019-03-30T15:00:00Z,True,6,9,90,6,33,13,20,14,8,6,19,7
Tomkins,137,1,306,2019-04-03T18:45:00Z,False,6,16,90,1,36,16,20,61,28,33,-25,-8
Tomkins,137,1,325,2019-04-06T14:00:00Z,False,6,14,72,6,36,16,20,35,22,13,1,-2
Tomkins,137,1,332,2019-04-14T13:05:00Z,True,6,12,0,0,39,16,23,80,48,32,-41,-16
Tomkins,137,1,340,2019-04-21T15:00:00Z,False,6,0,0,0,39,16,23,66,44,22,-27,-21
Tomkins,137,1,352,2019-04-27T14:00:00Z,True,6,7,0,0,42,16,26,49,31,18,-7,-2
Tomkins,137,1,362,2019-05-04T16:30:00Z,False,6,4,0,0,43,17,26,31,20,11,12,6
Tomkins,137,1,372,2019-05-12T14:00:00Z,True,6,1,0,0,46,17,29,45,29,16,1,1
Dann,138,1,2,2018-08-11T14:00:00Z,False,6,8,0,0,0,0,0,0,0,0,0,0
Dann,138,1,14,2018-08-20T19:00:00Z,True,6,11,0,0,3,0,3,3,3,0,0,0
Dann,138,1,28,2018-08-26T12:30:00Z,False,6,17,0,0,3,0,3,6,3,3,-3,0
Dann,138,1,34,2018-09-01T14:00:00Z,True,6,15,0,0,3,0,3,1,1,0,2,0
Dann,138,1,43,2018-09-15T14:00:00Z,False,6,9,0,0,3,0,3,2,1,1,1,2
Dann,138,1,54,2018-09-22T14:00:00Z,True,6,14,0,0,6,0,6,1,0,1,5,-1
Dann,138,1,61,2018-10-01T19:00:00Z,False,6,1,0,0,7,1,6,10,7,3,-3,-1
Dann,138,1,72,2018-10-06T14:00:00Z,True,6,19,0,0,7,1,6,12,8,4,-5,-3
Dann,138,1,84,2018-10-21T15:00:00Z,False,6,7,0,0,7,1,6,12,7,5,-5,-1
Dann,138,1,92,2018-10-28T13:30:00Z,True,6,0,0,0,7,1,6,21,12,9,-14,-8
Dann,138,1,103,2018-11-04T16:00:00Z,False,6,5,0,0,8,2,6,24,11,13,-16,-5
Dann,138,1,113,2018-11-10T17:30:00Z,True,6,16,0,0,8,2,6,24,6,18,-16,-16
Dann,138,1,125,2018-11-24T15:00:00Z,False,6,13,0,0,8,2,6,20,10,10,-12,-4
Dann,138,1,133,2018-12-01T15:00:00Z,True,6,3,0,0,9,2,7,9,4,5,0,-3
Dann,138,1,141,2018-12-04T19:45:00Z,False,6,2,0,0,12,5,7,18,11,7,-6,-4
Dann,138,1,159,2018-12-08T15:00:00Z,False,6,18,0,0,12,5,7,18,10,8,-6,-3
Dann,138,1,161,2018-12-15T15:00:00Z,True,6,10,0,0,12,5,7,22,11,11,-10,-6
Dann,138,1,176,2018-12-22T15:00:00Z,False,6,12,0,0,15,8,7,44,27,17,-29,-20
Dann,138,1,182,2018-12-26T15:00:00Z,True,6,4,0,0,18,8,10,14,13,1,4,7
Dann,138,1,192,2018-12-30T12:00:00Z,True,6,5,0,0,19,9,10,40,21,19,-21,-10
Dann,138,1,209,2019-01-02T19:45:00Z,False,6,19,0,0,19,9,10,29,14,15,-10,-4
Dann,138,1,214,2019-01-12T15:00:00Z,True,6,17,0,0,22,9,13,29,16,13,-7,-4
Dann,138,1,224,2019-01-19T15:00:00Z,False,6,11,0,0,22,9,13,57,28,29,-35,-15
Dann,138,1,238,2019-01-30T19:45:00Z,False,6,15,1,1,22,9,13,22,11,11,0,2
Dann,138,1,244,2019-02-02T15:00:00Z,True,6,8,0,0,23,9,14,17,15,2,6,7
Dann,138,1,251,2019-02-09T15:00:00Z,True,6,18,0,0,26,12,14,32,18,14,-6,-2
Dann,138,1,266,2019-02-23T17:30:00Z,False,6,10,13,1,27,13,14,32,14,18,-5,0
Dann,138,1,272,2019-02-27T20:00:00Z,True,6,13,0,0,30,13,17,52,26,26,-22,-13
Dann,138,1,282,2019-03-02T15:00:00Z,False,6,3,90,2,30,13,17,30,17,13,0,0
Dann,138,1,293,2019-03-09T12:30:00Z,True,6,2,90,0,33,13,20,30,22,8,3,5
Dann,138,1,314,2019-03-30T15:00:00Z,True,6,9,90,6,33,13,20,14,8,6,19,7
Dann,138,1,306,2019-04-03T18:45:00Z,False,6,16,0,0,36,16,20,61,28,33,-25,-8
Dann,138,1,325,2019-04-06T14:00:00Z,False,6,14,17,1,36,16,20,35,22,13,1,-2
Dann,138,1,332,2019-04-14T13:05:00Z,True,6,12,90,1,39,16,23,80,48,32,-41,-16
Dann,138,1,340,2019-04-21T15:00:00Z,False,6,0,90,4,39,16,23,66,44,22,-27,-21
Dann,138,1,352,2019-04-27T14:00:00Z,True,6,7,90,6,42,16,26,49,31,18,-7,-2
Dann,138,1,362,2019-05-04T16:30:00Z,False,6,4,90,1,43,17,26,31,20,11,12,6
Dann,138,1,372,2019-05-12T14:00:00Z,True,6,1,0,0,46,17,29,45,29,16,1,1
Kelly,139,1,2,2018-08-11T14:00:00Z,False,6,8,0,0,0,0,0,0,0,0,0,0
Kelly,139,1,14,2018-08-20T19:00:00Z,True,6,11,0,0,3,0,3,3,3,0,0,0
Kelly,139,1,28,2018-08-26T12:30:00Z,False,6,17,90,1,3,0,3,6,3,3,-3,0
Kelly,139,1,34,2018-09-01T14:00:00Z,True,6,15,90,1,3,0,3,1,1,0,2,0
Kelly,139,1,43,2018-09-15T14:00:00Z,False,6,9,0,0,3,0,3,2,1,1,1,2
Kelly,139,1,54,2018-09-22T14:00:00Z,True,6,14,0,0,6,0,6,1,0,1,5,-1
Kelly,139,1,61,2018-10-01T19:00:00Z,False,6,1,0,0,7,1,6,10,7,3,-3,-1
Kelly,139,1,72,2018-10-06T14:00:00Z,True,6,19,0,0,7,1,6,12,8,4,-5,-3
Kelly,139,1,84,2018-10-21T15:00:00Z,False,6,7,0,0,7,1,6,12,7,5,-5,-1
Kelly,139,1,92,2018-10-28T13:30:00Z,True,6,0,0,0,7,1,6,21,12,9,-14,-8
Kelly,139,1,103,2018-11-04T16:00:00Z,False,6,5,0,0,8,2,6,24,11,13,-16,-5
Kelly,139,1,113,2018-11-10T17:30:00Z,True,6,16,30,1,8,2,6,24,6,18,-16,-16
Kelly,139,1,125,2018-11-24T15:00:00Z,False,6,13,0,0,8,2,6,20,10,10,-12,-4
Kelly,139,1,133,2018-12-01T15:00:00Z,True,6,3,0,0,9,2,7,9,4,5,0,-3
Kelly,139,1,141,2018-12-04T19:45:00Z,False,6,2,0,0,12,5,7,18,11,7,-6,-4
Kelly,139,1,159,2018-12-08T15:00:00Z,False,6,18,0,0,12,5,7,18,10,8,-6,-3
Kelly,139,1,161,2018-12-15T15:00:00Z,True,6,10,90,7,12,5,7,22,11,11,-10,-6
Kelly,139,1,176,2018-12-22T15:00:00Z,False,6,12,0,0,15,8,7,44,27,17,-29,-20
Kelly,139,1,182,2018-12-26T15:00:00Z,True,6,4,0,0,18,8,10,14,13,1,4,7
Kelly,139,1,192,2018-12-30T12:00:00Z,True,6,5,0,0,19,9,10,40,21,19,-21,-10
Kelly,139,1,209,2019-01-02T19:45:00Z,False,6,19,0,0,19,9,10,29,14,15,-10,-4
Kelly,139,1,214,2019-01-12T15:00:00Z,True,6,17,0,0,22,9,13,29,16,13,-7,-4
Kelly,139,1,224,2019-01-19T15:00:00Z,False,6,11,0,0,22,9,13,57,28,29,-35,-15
Kelly,139,1,238,2019-01-30T19:45:00Z,False,6,15,0,0,22,9,13,22,11,11,0,2
Kelly,139,1,244,2019-02-02T15:00:00Z,True,6,8,0,0,23,9,14,17,15,2,6,7
Kelly,139,1,251,2019-02-09T15:00:00Z,True,6,18,90,2,26,12,14,32,18,14,-6,-2
Kelly,139,1,266,2019-02-23T17:30:00Z,False,6,10,0,0,27,13,14,32,14,18,-5,0
Kelly,139,1,272,2019-02-27T20:00:00Z,True,6,13,90,0,30,13,17,52,26,26,-22,-13
Kelly,139,1,282,2019-03-02T15:00:00Z,False,6,3,0,0,30,13,17,30,17,13,0,0
Kelly,139,1,293,2019-03-09T12:30:00Z,True,6,2,0,0,33,13,20,30,22,8,3,5
Kelly,139,1,314,2019-03-30T15:00:00Z,True,6,9,0,0,33,13,20,14,8,6,19,7
Kelly,139,1,306,2019-04-03T18:45:00Z,False,6,16,90,1,36,16,20,61,28,33,-25,-8
Kelly,139,1,325,2019-04-06T14:00:00Z,False,6,14,90,5,36,16,20,35,22,13,1,-2
Kelly,139,1,332,2019-04-14T13:05:00Z,True,6,12,90,1,39,16,23,80,48,32,-41,-16
Kelly,139,1,340,2019-04-21T15:00:00Z,False,6,0,90,1,39,16,23,66,44,22,-27,-21
Kelly,139,1,352,2019-04-27T14:00:00Z,True,6,7,90,6,42,16,26,49,31,18,-7,-2
Kelly,139,1,362,2019-05-04T16:30:00Z,False,6,4,90,-1,43,17,26,31,20,11,12,6
Kelly,139,1,372,2019-05-12T14:00:00Z,True,6,1,90,1,46,17,29,45,29,16,1,1
Schlupp,140,1,2,2018-08-11T14:00:00Z,False,6,8,90,11,0,0,0,0,0,0,0,0
Schlupp,140,1,14,2018-08-20T19:00:00Z,True,6,11,82,2,3,0,3,3,3,0,0,0
Schlupp,140,1,28,2018-08-26T12:30:00Z,False,6,17,74,1,3,0,3,6,3,3,-3,0
Schlupp,140,1,34,2018-09-01T14:00:00Z,True,6,15,75,2,3,0,3,1,1,0,2,0
Schlupp,140,1,43,2018-09-15T14:00:00Z,False,6,9,1,1,3,0,3,2,1,1,1,2
Schlupp,140,1,54,2018-09-22T14:00:00Z,True,6,14,0,0,6,0,6,1,0,1,5,-1
Schlupp,140,1,61,2018-10-01T19:00:00Z,False,6,1,13,1,7,1,6,10,7,3,-3,-1
Schlupp,140,1,72,2018-10-06T14:00:00Z,True,6,19,81,2,7,1,6,12,8,4,-5,-3
Schlupp,140,1,84,2018-10-21T15:00:00Z,False,6,7,90,1,7,1,6,12,7,5,-5,-1
Schlupp,140,1,92,2018-10-28T13:30:00Z,True,6,0,0,0,7,1,6,21,12,9,-14,-8
Schlupp,140,1,103,2018-11-04T16:00:00Z,False,6,5,10,1,8,2,6,24,11,13,-16,-5
Schlupp,140,1,113,2018-11-10T17:30:00Z,True,6,16,23,1,8,2,6,24,6,18,-16,-16
Schlupp,140,1,125,2018-11-24T15:00:00Z,False,6,13,2,1,8,2,6,20,10,10,-12,-4
Schlupp,140,1,133,2018-12-01T15:00:00Z,True,6,3,12,1,9,2,7,9,4,5,0,-3
Schlupp,140,1,141,2018-12-04T19:45:00Z,False,6,2,17,1,12,5,7,18,11,7,-6,-4
Schlupp,140,1,159,2018-12-08T15:00:00Z,False,6,18,35,6,12,5,7,18,10,8,-6,-3
Schlupp,140,1,161,2018-12-15T15:00:00Z,True,6,10,25,1,12,5,7,22,11,11,-10,-6
Schlupp,140,1,176,2018-12-22T15:00:00Z,False,6,12,90,7,15,8,7,44,27,17,-29,-20
Schlupp,140,1,182,2018-12-26T15:00:00Z,True,6,4,0,0,18,8,10,14,13,1,4,7
Schlupp,140,1,192,2018-12-30T12:00:00Z,True,6,5,68,2,19,9,10,40,21,19,-21,-10
Schlupp,140,1,209,2019-01-02T19:45:00Z,False,6,19,0,0,19,9,10,29,14,15,-10,-4
Schlupp,140,1,214,2019-01-12T15:00:00Z,True,6,17,7,1,22,9,13,29,16,13,-7,-4
Schlupp,140,1,224,2019-01-19T15:00:00Z,False,6,11,15,1,22,9,13,57,28,29,-35,-15
Schlupp,140,1,238,2019-01-30T19:45:00Z,False,6,15,19,1,22,9,13,22,11,11,0,2
Schlupp,140,1,244,2019-02-02T15:00:00Z,True,6,8,90,14,23,9,14,17,15,2,6,7
Schlupp,140,1,251,2019-02-09T15:00:00Z,True,6,18,90,2,26,12,14,32,18,14,-6,-2
Schlupp,140,1,266,2019-02-23T17:30:00Z,False,6,10,90,5,27,13,14,32,14,18,-5,0
Schlupp,140,1,272,2019-02-27T20:00:00Z,True,6,13,90,5,30,13,17,52,26,26,-22,-13
Schlupp,140,1,282,2019-03-02T15:00:00Z,False,6,3,90,5,30,13,17,30,17,13,0,0
Schlupp,140,1,293,2019-03-09T12:30:00Z,True,6,2,90,1,33,13,20,30,22,8,3,5
Schlupp,140,1,314,2019-03-30T15:00:00Z,True,6,9,90,6,33,13,20,14,8,6,19,7
Schlupp,140,1,306,2019-04-03T18:45:00Z,False,6,16,90,1,36,16,20,61,28,33,-25,-8
Schlupp,140,1,325,2019-04-06T14:00:00Z,False,6,14,90,6,36,16,20,35,22,13,1,-2
Schlupp,140,1,332,2019-04-14T13:05:00Z,True,6,12,21,1,39,16,23,80,48,32,-41,-16
Schlupp,140,1,340,2019-04-21T15:00:00Z,False,6,0,0,0,39,16,23,66,44,22,-27,-21
Schlupp,140,1,352,2019-04-27T14:00:00Z,True,6,7,0,0,42,16,26,49,31,18,-7,-2
Schlupp,140,1,362,2019-05-04T16:30:00Z,False,6,4,0,0,43,17,26,31,20,11,12,6
Schlupp,140,1,372,2019-05-12T14:00:00Z,True,6,1,0,0,46,17,29,45,29,16,1,1
van Aanholt,141,1,2,2018-08-11T14:00:00Z,False,6,8,90,11,0,0,0,0,0,0,0,0
van Aanholt,141,1,14,2018-08-20T19:00:00Z,True,6,11,90,0,3,0,3,3,3,0,0,0
van Aanholt,141,1,28,2018-08-26T12:30:00Z,False,6,17,90,1,3,0,3,6,3,3,-3,0
van Aanholt,141,1,34,2018-09-01T14:00:00Z,True,6,15,90,1,3,0,3,1,1,0,2,0
van Aanholt,141,1,43,2018-09-15T14:00:00Z,False,6,9,90,6,3,0,3,2,1,1,1,2
van Aanholt,141,1,54,2018-09-22T14:00:00Z,True,6,14,90,6,6,0,6,1,0,1,5,-1
van Aanholt,141,1,61,2018-10-01T19:00:00Z,False,6,1,90,10,7,1,6,10,7,3,-3,-1
van Aanholt,141,1,72,2018-10-06T14:00:00Z,True,6,19,90,1,7,1,6,12,8,4,-5,-3
van Aanholt,141,1,84,2018-10-21T15:00:00Z,False,6,7,90,1,7,1,6,12,7,5,-5,-1
van Aanholt,141,1,92,2018-10-28T13:30:00Z,True,6,0,90,1,7,1,6,21,12,9,-14,-8
van Aanholt,141,1,103,2018-11-04T16:00:00Z,False,6,5,90,1,8,2,6,24,11,13,-16,-5
van Aanholt,141,1,113,2018-11-10T17:30:00Z,True,6,16,90,2,8,2,6,24,6,18,-16,-16
van Aanholt,141,1,125,2018-11-24T15:00:00Z,False,6,13,90,6,8,2,6,20,10,10,-12,-4
van Aanholt,141,1,133,2018-12-01T15:00:00Z,True,6,3,90,7,9,2,7,9,4,5,0,-3
van Aanholt,141,1,141,2018-12-04T19:45:00Z,False,6,2,90,1,12,5,7,18,11,7,-6,-4
van Aanholt,141,1,159,2018-12-08T15:00:00Z,False,6,18,54,1,12,5,7,18,10,8,-6,-3
van Aanholt,141,1,161,2018-12-15T15:00:00Z,True,6,10,90,6,12,5,7,22,11,11,-10,-6
van Aanholt,141,1,176,2018-12-22T15:00:00Z,False,6,12,90,0,15,8,7,44,27,17,-29,-20
van Aanholt,141,1,182,2018-12-26T15:00:00Z,True,6,4,90,8,18,8,10,14,13,1,4,7
van Aanholt,141,1,192,2018-12-30T12:00:00Z,True,6,5,90,2,19,9,10,40,21,19,-21,-10
van Aanholt,141,1,209,2019-01-02T19:45:00Z,False,6,19,90,12,19,9,10,29,14,15,-10,-4
van Aanholt,141,1,214,2019-01-12T15:00:00Z,True,6,17,90,1,22,9,13,29,16,13,-7,-4
van Aanholt,141,1,224,2019-01-19T15:00:00Z,False,6,11,90,0,22,9,13,57,28,29,-35,-15
van Aanholt,141,1,238,2019-01-30T19:45:00Z,False,6,15,90,3,22,9,13,22,11,11,0,2
van Aanholt,141,1,244,2019-02-02T15:00:00Z,True,6,8,90,6,23,9,14,17,15,2,6,7
van Aanholt,141,1,251,2019-02-09T15:00:00Z,True,6,18,90,3,26,12,14,32,18,14,-6,-2
van Aanholt,141,1,266,2019-02-23T17:30:00Z,False,6,10,90,2,27,13,14,32,14,18,-5,0
van Aanholt,141,1,272,2019-02-27T20:00:00Z,True,6,13,82,1,30,13,17,52,26,26,-22,-13
van Aanholt,141,1,282,2019-03-02T15:00:00Z,False,6,3,90,2,30,13,17,30,17,13,0,0
van Aanholt,141,1,293,2019-03-09T12:30:00Z,True,6,2,90,1,33,13,20,30,22,8,3,5
van Aanholt,141,1,314,2019-03-30T15:00:00Z,True,6,9,90,15,33,13,20,14,8,6,19,7
van Aanholt,141,1,306,2019-04-03T18:45:00Z,False,6,16,90,1,36,16,20,61,28,33,-25,-8
van Aanholt,141,1,325,2019-04-06T14:00:00Z,False,6,14,90,6,36,16,20,35,22,13,1,-2
van Aanholt,141,1,332,2019-04-14T13:05:00Z,True,6,12,90,1,39,16,23,80,48,32,-41,-16
van Aanholt,141,1,340,2019-04-21T15:00:00Z,False,6,0,0,0,39,16,23,66,44,22,-27,-21
van Aanholt,141,1,352,2019-04-27T14:00:00Z,True,6,7,90,7,42,16,26,49,31,18,-7,-2
van Aanholt,141,1,362,2019-05-04T16:30:00Z,False,6,4,0,0,43,17,26,31,20,11,12,6
van Aanholt,141,1,372,2019-05-12T14:00:00Z,True,6,1,90,7,46,17,29,45,29,16,1,1
Sakho,142,1,2,2018-08-11T14:00:00Z,False,6,8,90,7,0,0,0,0,0,0,0,0
Sakho,142,1,14,2018-08-20T19:00:00Z,True,6,11,90,1,3,0,3,3,3,0,0,0
Sakho,142,1,28,2018-08-26T12:30:00Z,False,6,17,90,3,3,0,3,6,3,3,-3,0
Sakho,142,1,34,2018-09-01T14:00:00Z,True,6,15,90,1,3,0,3,1,1,0,2,0
Sakho,142,1,43,2018-09-15T14:00:00Z,False,6,9,90,8,3,0,3,2,1,1,1,2
Sakho,142,1,54,2018-09-22T14:00:00Z,True,6,14,90,6,6,0,6,1,0,1,5,-1
Sakho,142,1,61,2018-10-01T19:00:00Z,False,6,1,90,0,7,1,6,10,7,3,-3,-1
Sakho,142,1,72,2018-10-06T14:00:00Z,True,6,19,90,2,7,1,6,12,8,4,-5,-3
Sakho,142,1,84,2018-10-21T15:00:00Z,False,6,7,90,1,7,1,6,12,7,5,-5,-1
Sakho,142,1,92,2018-10-28T13:30:00Z,True,6,0,90,1,7,1,6,21,12,9,-14,-8
Sakho,142,1,103,2018-11-04T16:00:00Z,False,6,5,90,1,8,2,6,24,11,13,-16,-5
Sakho,142,1,113,2018-11-10T17:30:00Z,True,6,16,90,2,8,2,6,24,6,18,-16,-16
Sakho,142,1,125,2018-11-24T15:00:00Z,False,6,13,90,5,8,2,6,20,10,10,-12,-4
Sakho,142,1,133,2018-12-01T15:00:00Z,True,6,3,90,7,9,2,7,9,4,5,0,-3
Sakho,142,1,141,2018-12-04T19:45:00Z,False,6,2,90,1,12,5,7,18,11,7,-6,-4
Sakho,142,1,159,2018-12-08T15:00:00Z,False,6,18,90,1,12,5,7,18,10,8,-6,-3
Sakho,142,1,161,2018-12-15T15:00:00Z,True,6,10,90,8,12,5,7,22,11,11,-10,-6
Sakho,142,1,176,2018-12-22T15:00:00Z,False,6,12,90,1,15,8,7,44,27,17,-29,-20
Sakho,142,1,182,2018-12-26T15:00:00Z,True,6,4,90,6,18,8,10,14,13,1,4,7
Sakho,142,1,192,2018-12-30T12:00:00Z,True,6,5,90,2,19,9,10,40,21,19,-21,-10
Sakho,142,1,209,2019-01-02T19:45:00Z,False,6,19,90,7,19,9,10,29,14,15,-10,-4
Sakho,142,1,214,2019-01-12T15:00:00Z,True,6,17,90,3,22,9,13,29,16,13,-7,-4
Sakho,142,1,224,2019-01-19T15:00:00Z,False,6,11,90,0,22,9,13,57,28,29,-35,-15
Sakho,142,1,238,2019-01-30T19:45:00Z,False,6,15,90,2,22,9,13,22,11,11,0,2
Sakho,142,1,244,2019-02-02T15:00:00Z,True,6,8,90,7,23,9,14,17,15,2,6,7
Sakho,142,1,251,2019-02-09T15:00:00Z,True,6,18,90,3,26,12,14,32,18,14,-6,-2
Sakho,142,1,266,2019-02-23T17:30:00Z,False,6,10,76,2,27,13,14,32,14,18,-5,0
Sakho,142,1,272,2019-02-27T20:00:00Z,True,6,13,0,0,30,13,17,52,26,26,-22,-13
Sakho,142,1,282,2019-03-02T15:00:00Z,False,6,3,0,0,30,13,17,30,17,13,0,0
Sakho,142,1,293,2019-03-09T12:30:00Z,True,6,2,0,0,33,13,20,30,22,8,3,5
Sakho,142,1,314,2019-03-30T15:00:00Z,True,6,9,0,0,33,13,20,14,8,6,19,7
Sakho,142,1,306,2019-04-03T18:45:00Z,False,6,16,0,0,36,16,20,61,28,33,-25,-8
Sakho,142,1,325,2019-04-06T14:00:00Z,False,6,14,0,0,36,16,20,35,22,13,1,-2
Sakho,142,1,332,2019-04-14T13:05:00Z,True,6,12,0,0,39,16,23,80,48,32,-41,-16
Sakho,142,1,340,2019-04-21T15:00:00Z,False,6,0,0,0,39,16,23,66,44,22,-27,-21
Sakho,142,1,352,2019-04-27T14:00:00Z,True,6,7,0,0,42,16,26,49,31,18,-7,-2
Sakho,142,1,362,2019-05-04T16:30:00Z,False,6,4,0,0,43,17,26,31,20,11,12,6
Sakho,142,1,372,2019-05-12T14:00:00Z,True,6,1,0,0,46,17,29,45,29,16,1,1
Riedewald,143,1,2,2018-08-11T14:00:00Z,False,6,8,0,0,0,0,0,0,0,0,0,0
Riedewald,143,1,14,2018-08-20T19:00:00Z,True,6,11,0,0,3,0,3,3,3,0,0,0
Riedewald,143,1,28,2018-08-26T12:30:00Z,False,6,17,0,0,3,0,3,6,3,3,-3,0
Riedewald,143,1,34,2018-09-01T14:00:00Z,True,6,15,0,0,3,0,3,1,1,0,2,0
Riedewald,143,1,43,2018-09-15T14:00:00Z,False,6,9,0,0,3,0,3,2,1,1,1,2
Riedewald,143,1,54,2018-09-22T14:00:00Z,True,6,14,0,0,6,0,6,1,0,1,5,-1
Riedewald,143,1,61,2018-10-01T19:00:00Z,False,6,1,0,0,7,1,6,10,7,3,-3,-1
Riedewald,143,1,72,2018-10-06T14:00:00Z,True,6,19,0,0,7,1,6,12,8,4,-5,-3
Riedewald,143,1,84,2018-10-21T15:00:00Z,False,6,7,0,0,7,1,6,12,7,5,-5,-1
Riedewald,143,1,92,2018-10-28T13:30:00Z,True,6,0,0,0,7,1,6,21,12,9,-14,-8
Riedewald,143,1,103,2018-11-04T16:00:00Z,False,6,5,0,0,8,2,6,24,11,13,-16,-5
Riedewald,143,1,113,2018-11-10T17:30:00Z,True,6,16,0,0,8,2,6,24,6,18,-16,-16
Riedewald,143,1,125,2018-11-24T15:00:00Z,False,6,13,0,0,8,2,6,20,10,10,-12,-4
Riedewald,143,1,133,2018-12-01T15:00:00Z,True,6,3,0,0,9,2,7,9,4,5,0,-3
Riedewald,143,1,141,2018-12-04T19:45:00Z,False,6,2,0,0,12,5,7,18,11,7,-6,-4
Riedewald,143,1,159,2018-12-08T15:00:00Z,False,6,18,0,0,12,5,7,18,10,8,-6,-3
Riedewald,143,1,161,2018-12-15T15:00:00Z,True,6,10,0,0,12,5,7,22,11,11,-10,-6
Riedewald,143,1,176,2018-12-22T15:00:00Z,False,6,12,0,0,15,8,7,44,27,17,-29,-20
Riedewald,143,1,182,2018-12-26T15:00:00Z,True,6,4,0,0,18,8,10,14,13,1,4,7
Riedewald,143,1,192,2018-12-30T12:00:00Z,True,6,5,0,0,19,9,10,40,21,19,-21,-10
Riedewald,143,1,209,2019-01-02T19:45:00Z,False,6,19,0,0,19,9,10,29,14,15,-10,-4
Riedewald,143,1,214,2019-01-12T15:00:00Z,True,6,17,0,0,22,9,13,29,16,13,-7,-4
Riedewald,143,1,224,2019-01-19T15:00:00Z,False,6,11,0,0,22,9,13,57,28,29,-35,-15
Riedewald,143,1,238,2019-01-30T19:45:00Z,False,6,15,0,0,22,9,13,22,11,11,0,2
Riedewald,143,1,244,2019-02-02T15:00:00Z,True,6,8,0,0,23,9,14,17,15,2,6,7
Riedewald,143,1,251,2019-02-09T15:00:00Z,True,6,18,0,0,26,12,14,32,18,14,-6,-2
Riedewald,143,1,266,2019-02-23T17:30:00Z,False,6,10,0,0,27,13,14,32,14,18,-5,0
Riedewald,143,1,272,2019-02-27T20:00:00Z,True,6,13,0,0,30,13,17,52,26,26,-22,-13
Riedewald,143,1,282,2019-03-02T15:00:00Z,False,6,3,0,0,30,13,17,30,17,13,0,0
Riedewald,143,1,293,2019-03-09T12:30:00Z,True,6,2,0,0,33,13,20,30,22,8,3,5
Riedewald,143,1,314,2019-03-30T15:00:00Z,True,6,9,0,0,33,13,20,14,8,6,19,7
Riedewald,143,1,306,2019-04-03T18:45:00Z,False,6,16,0,0,36,16,20,61,28,33,-25,-8
Riedewald,143,1,325,2019-04-06T14:00:00Z,False,6,14,0,0,36,16,20,35,22,13,1,-2
Riedewald,143,1,332,2019-04-14T13:05:00Z,True,6,12,0,0,39,16,23,80,48,32,-41,-16
Riedewald,143,1,340,2019-04-21T15:00:00Z,False,6,0,0,0,39,16,23,66,44,22,-27,-21
Riedewald,143,1,352,2019-04-27T14:00:00Z,True,6,7,0,0,42,16,26,49,31,18,-7,-2
Riedewald,143,1,362,2019-05-04T16:30:00Z,False,6,4,0,0,43,17,26,31,20,11,12,6
Riedewald,143,1,372,2019-05-12T14:00:00Z,True,6,1,0,0,46,17,29,45,29,16,1,1
Wan-Bissaka,144,1,2,2018-08-11T14:00:00Z,False,6,8,90,12,0,0,0,0,0,0,0,0
Wan-Bissaka,144,1,14,2018-08-20T19:00:00Z,True,6,11,74,-2,3,0,3,3,3,0,0,0
Wan-Bissaka,144,1,28,2018-08-26T12:30:00Z,False,6,17,0,0,3,0,3,6,3,3,-3,0
Wan-Bissaka,144,1,34,2018-09-01T14:00:00Z,True,6,15,90,0,3,0,3,1,1,0,2,0
Wan-Bissaka,144,1,43,2018-09-15T14:00:00Z,False,6,9,90,9,3,0,3,2,1,1,1,2
Wan-Bissaka,144,1,54,2018-09-22T14:00:00Z,True,6,14,90,9,6,0,6,1,0,1,5,-1
Wan-Bissaka,144,1,61,2018-10-01T19:00:00Z,False,6,1,90,1,7,1,6,10,7,3,-3,-1
Wan-Bissaka,144,1,72,2018-10-06T14:00:00Z,True,6,19,90,2,7,1,6,12,8,4,-5,-3
Wan-Bissaka,144,1,84,2018-10-21T15:00:00Z,False,6,7,90,1,7,1,6,12,7,5,-5,-1
Wan-Bissaka,144,1,92,2018-10-28T13:30:00Z,True,6,0,90,1,7,1,6,21,12,9,-14,-8
Wan-Bissaka,144,1,103,2018-11-04T16:00:00Z,False,6,5,90,1,8,2,6,24,11,13,-16,-5
Wan-Bissaka,144,1,113,2018-11-10T17:30:00Z,True,6,16,90,2,8,2,6,24,6,18,-16,-16
Wan-Bissaka,144,1,125,2018-11-24T15:00:00Z,False,6,13,90,6,8,2,6,20,10,10,-12,-4
Wan-Bissaka,144,1,133,2018-12-01T15:00:00Z,True,6,3,90,6,9,2,7,9,4,5,0,-3
Wan-Bissaka,144,1,141,2018-12-04T19:45:00Z,False,6,2,90,1,12,5,7,18,11,7,-6,-4
Wan-Bissaka,144,1,159,2018-12-08T15:00:00Z,False,6,18,90,1,12,5,7,18,10,8,-6,-3
Wan-Bissaka,144,1,161,2018-12-15T15:00:00Z,True,6,10,90,6,12,5,7,22,11,11,-10,-6
Wan-Bissaka,144,1,176,2018-12-22T15:00:00Z,False,6,12,90,1,15,8,7,44,27,17,-29,-20
Wan-Bissaka,144,1,182,2018-12-26T15:00:00Z,True,6,4,90,8,18,8,10,14,13,1,4,7
Wan-Bissaka,144,1,192,2018-12-30T12:00:00Z,True,6,5,90,2,19,9,10,40,21,19,-21,-10
Wan-Bissaka,144,1,209,2019-01-02T19:45:00Z,False,6,19,90,6,19,9,10,29,14,15,-10,-4
Wan-Bissaka,144,1,214,2019-01-12T15:00:00Z,True,6,17,90,4,22,9,13,29,16,13,-7,-4
Wan-Bissaka,144,1,224,2019-01-19T15:00:00Z,False,6,11,90,0,22,9,13,57,28,29,-35,-15
Wan-Bissaka,144,1,238,2019-01-30T19:45:00Z,False,6,15,90,1,22,9,13,22,11,11,0,2
Wan-Bissaka,144,1,244,2019-02-02T15:00:00Z,True,6,8,90,5,23,9,14,17,15,2,6,7
Wan-Bissaka,144,1,251,2019-02-09T15:00:00Z,True,6,18,90,1,26,12,14,32,18,14,-6,-2
Wan-Bissaka,144,1,266,2019-02-23T17:30:00Z,False,6,10,0,0,27,13,14,32,14,18,-5,0
Wan-Bissaka,144,1,272,2019-02-27T20:00:00Z,True,6,13,0,0,30,13,17,52,26,26,-22,-13
Wan-Bissaka,144,1,282,2019-03-02T15:00:00Z,False,6,3,90,5,30,13,17,30,17,13,0,0
Wan-Bissaka,144,1,293,2019-03-09T12:30:00Z,True,6,2,90,1,33,13,20,30,22,8,3,5
Wan-Bissaka,144,1,314,2019-03-30T15:00:00Z,True,6,9,90,6,33,13,20,14,8,6,19,7
Wan-Bissaka,144,1,306,2019-04-03T18:45:00Z,False,6,16,90,1,36,16,20,61,28,33,-25,-8
Wan-Bissaka,144,1,325,2019-04-06T14:00:00Z,False,6,14,90,7,36,16,20,35,22,13,1,-2
Wan-Bissaka,144,1,332,2019-04-14T13:05:00Z,True,6,12,90,1,39,16,23,80,48,32,-41,-16
Wan-Bissaka,144,1,340,2019-04-21T15:00:00Z,False,6,0,90,1,39,16,23,66,44,22,-27,-21
Wan-Bissaka,144,1,352,2019-04-27T14:00:00Z,True,6,7,90,9,42,16,26,49,31,18,-7,-2
Wan-Bissaka,144,1,362,2019-05-04T16:30:00Z,False,6,4,90,1,43,17,26,31,20,11,12,6
Wan-Bissaka,144,1,372,2019-05-12T14:00:00Z,True,6,1,90,4,46,17,29,45,29,16,1,1
Puncheon,145,2,2,2018-08-11T14:00:00Z,False,6,8,0,0,0,0,0,0,0,0,0,0
Puncheon,145,2,14,2018-08-20T19:00:00Z,True,6,11,0,0,3,0,3,3,3,0,0,0
Puncheon,145,2,28,2018-08-26T12:30:00Z,False,6,17,0,0,3,0,3,6,3,3,-3,0
Puncheon,145,2,34,2018-09-01T14:00:00Z,True,6,15,0,0,3,0,3,1,1,0,2,0
Puncheon,145,2,43,2018-09-15T14:00:00Z,False,6,9,0,0,3,0,3,2,1,1,1,2
Puncheon,145,2,54,2018-09-22T14:00:00Z,True,6,14,0,0,6,0,6,1,0,1,5,-1
Puncheon,145,2,61,2018-10-01T19:00:00Z,False,6,1,0,0,7,1,6,10,7,3,-3,-1
Puncheon,145,2,72,2018-10-06T14:00:00Z,True,6,19,0,0,7,1,6,12,8,4,-5,-3
Puncheon,145,2,84,2018-10-21T15:00:00Z,False,6,7,0,0,7,1,6,12,7,5,-5,-1
Puncheon,145,2,92,2018-10-28T13:30:00Z,True,6,0,2,1,7,1,6,21,12,9,-14,-8
Puncheon,145,2,103,2018-11-04T16:00:00Z,False,6,5,0,0,8,2,6,24,11,13,-16,-5
Puncheon,145,2,113,2018-11-10T17:30:00Z,True,6,16,0,0,8,2,6,24,6,18,-16,-16
Puncheon,145,2,125,2018-11-24T15:00:00Z,False,6,13,0,0,8,2,6,20,10,10,-12,-4
Puncheon,145,2,133,2018-12-01T15:00:00Z,True,6,3,1,1,9,2,7,9,4,5,0,-3
Puncheon,145,2,141,2018-12-04T19:45:00Z,False,6,2,0,0,12,5,7,18,11,7,-6,-4
Puncheon,145,2,159,2018-12-08T15:00:00Z,False,6,18,6,1,12,5,7,18,10,8,-6,-3
Puncheon,145,2,161,2018-12-15T15:00:00Z,True,6,10,1,1,12,5,7,22,11,11,-10,-6
Puncheon,145,2,176,2018-12-22T15:00:00Z,False,6,12,1,1,15,8,7,44,27,17,-29,-20
Puncheon,145,2,182,2018-12-26T15:00:00Z,True,6,4,0,0,18,8,10,14,13,1,4,7
Puncheon,145,2,192,2018-12-30T12:00:00Z,True,6,5,0,0,19,9,10,40,21,19,-21,-10
Puncheon,145,2,209,2019-01-02T19:45:00Z,False,6,19,0,0,19,9,10,29,14,15,-10,-4
Puncheon,145,2,212,2019-01-12T15:00:00Z,False,9,4,90,3,10,5,5,18,13,5,-8,-8
Puncheon,145,2,223,2019-01-20T13:30:00Z,True,9,12,90,2,11,5,6,53,33,20,-42,-15
Puncheon,145,2,233,2019-01-29T19:45:00Z,True,9,7,90,1,11,5,6,30,21,9,-19,-4
Puncheon,145,2,243,2019-02-02T15:00:00Z,False,9,5,0,0,11,5,6,47,25,22,-36,-19
Puncheon,145,2,253,2019-02-09T15:00:00Z,True,9,0,65,2,11,5,6,47,32,15,-36,-10
Puncheon,145,2,268,2019-02-23T15:00:00Z,False,9,14,23,1,11,5,6,25,13,12,-14,-7
Puncheon,145,2,273,2019-02-26T19:45:00Z,True,9,19,0,0,11,5,6,40,21,19,-29,-14
Puncheon,145,2,281,2019-03-02T15:00:00Z,False,9,2,0,0,14,8,6,27,19,8,-13,-13
Puncheon,145,2,294,2019-03-09T15:00:00Z,True,9,1,0,0,14,8,6,34,25,9,-20,-1
Puncheon,145,2,308,2019-03-16T15:00:00Z,False,9,18,23,1,14,8,6,39,24,15,-25,-18
Puncheon,145,2,314,2019-03-30T15:00:00Z,False,9,6,0,0,14,8,6,33,13,20,-19,-7
Puncheon,145,2,323,2019-04-06T14:00:00Z,True,9,10,0,0,14,8,6,44,23,21,-30,-13
Puncheon,145,2,338,2019-04-13T11:30:00Z,False,9,16,0,0,14,8,6,64,31,33,-50,-25
Puncheon,145,2,345,2019-04-20T14:00:00Z,True,9,17,0,0,14,8,6,46,26,20,-32,-12
Puncheon,145,2,355,2019-04-26T19:00:00Z,False,9,11,0,0,14,8,6,88,47,41,-74,-41
Puncheon,145,2,365,2019-05-05T13:00:00Z,True,9,13,0,0,14,8,6,65,36,29,-51,-21
Puncheon,145,2,377,2019-05-12T14:00:00Z,False,9,15,0,0,15,9,6,38,22,16,-23,-16
McArthur,146,2,2,2018-08-11T14:00:00Z,False,6,8,90,3,0,0,0,0,0,0,0,0
McArthur,146,2,14,2018-08-20T19:00:00Z,True,6,11,90,2,3,0,3,3,3,0,0,0
McArthur,146,2,28,2018-08-26T12:30:00Z,False,6,17,90,2,3,0,3,6,3,3,-3,0
McArthur,146,2,34,2018-09-01T14:00:00Z,True,6,15,90,2,3,0,3,1,1,0,2,0
McArthur,146,2,43,2018-09-15T14:00:00Z,False,6,9,90,2,3,0,3,2,1,1,1,2
McArthur,146,2,54,2018-09-22T14:00:00Z,True,6,14,90,3,6,0,6,1,0,1,5,-1
McArthur,146,2,61,2018-10-01T19:00:00Z,False,6,1,76,2,7,1,6,10,7,3,-3,-1
McArthur,146,2,72,2018-10-06T14:00:00Z,True,6,19,62,1,7,1,6,12,8,4,-5,-3
McArthur,146,2,84,2018-10-21T15:00:00Z,False,6,7,88,2,7,1,6,12,7,5,-5,-1
McArthur,146,2,92,2018-10-28T13:30:00Z,True,6,0,60,2,7,1,6,21,12,9,-14,-8
McArthur,146,2,103,2018-11-04T16:00:00Z,False,6,5,79,5,8,2,6,24,11,13,-16,-5
McArthur,146,2,113,2018-11-10T17:30:00Z,True,6,16,69,2,8,2,6,24,6,18,-16,-16
McArthur,146,2,125,2018-11-24T15:00:00Z,False,6,13,90,3,8,2,6,20,10,10,-12,-4
McArthur,146,2,133,2018-12-01T15:00:00Z,True,6,3,77,10,9,2,7,9,4,5,0,-3
McArthur,146,2,141,2018-12-04T19:45:00Z,False,6,2,72,2,12,5,7,18,11,7,-6,-4
McArthur,146,2,159,2018-12-08T15:00:00Z,False,6,18,65,10,12,5,7,18,10,8,-6,-3
McArthur,146,2,161,2018-12-15T15:00:00Z,True,6,10,90,2,12,5,7,22,11,11,-10,-6
McArthur,146,2,176,2018-12-22T15:00:00Z,False,6,12,90,4,15,8,7,44,27,17,-29,-20
McArthur,146,2,182,2018-12-26T15:00:00Z,True,6,4,90,3,18,8,10,14,13,1,4,7
McArthur,146,2,192,2018-12-30T12:00:00Z,True,6,5,90,2,19,9,10,40,21,19,-21,-10
McArthur,146,2,209,2019-01-02T19:45:00Z,False,6,19,90,3,19,9,10,29,14,15,-10,-4
McArthur,146,2,214,2019-01-12T15:00:00Z,True,6,17,77,2,22,9,13,29,16,13,-7,-4
McArthur,146,2,224,2019-01-19T15:00:00Z,False,6,11,80,2,22,9,13,57,28,29,-35,-15
McArthur,146,2,238,2019-01-30T19:45:00Z,False,6,15,90,2,22,9,13,22,11,11,0,2
McArthur,146,2,244,2019-02-02T15:00:00Z,True,6,8,90,3,23,9,14,17,15,2,6,7
McArthur,146,2,251,2019-02-09T15:00:00Z,True,6,18,78,4,26,12,14,32,18,14,-6,-2
McArthur,146,2,266,2019-02-23T17:30:00Z,False,6,10,90,7,27,13,14,32,14,18,-5,0
McArthur,146,2,272,2019-02-27T20:00:00Z,True,6,13,60,2,30,13,17,52,26,26,-22,-13
McArthur,146,2,282,2019-03-02T15:00:00Z,False,6,3,19,1,30,13,17,30,17,13,0,0
McArthur,146,2,293,2019-03-09T12:30:00Z,True,6,2,76,2,33,13,20,30,22,8,3,5
McArthur,146,2,314,2019-03-30T15:00:00Z,True,6,9,45,1,33,13,20,14,8,6,19,7
McArthur,146,2,306,2019-04-03T18:45:00Z,False,6,16,90,2,36,16,20,61,28,33,-25,-8
McArthur,146,2,325,2019-04-06T14:00:00Z,False,6,14,90,3,36,16,20,35,22,13,1,-2
McArthur,146,2,332,2019-04-14T13:05:00Z,True,6,12,84,5,39,16,23,80,48,32,-41,-16
McArthur,146,2,340,2019-04-21T15:00:00Z,False,6,0,90,9,39,16,23,66,44,22,-27,-21
McArthur,146,2,352,2019-04-27T14:00:00Z,True,6,7,90,3,42,16,26,49,31,18,-7,-2
McArthur,146,2,362,2019-05-04T16:30:00Z,False,6,4,90,5,43,17,26,31,20,11,12,6
McArthur,146,2,372,2019-05-12T14:00:00Z,True,6,1,90,1,46,17,29,45,29,16,1,1
Sako,147,2,2,2018-08-11T14:00:00Z,False,6,8,0,0,0,0,0,0,0,0,0,0
Sako,147,2,14,2018-08-20T19:00:00Z,True,6,11,0,0,3,0,3,3,3,0,0,0
Sako,147,2,28,2018-08-26T12:30:00Z,False,6,17,0,0,3,0,3,6,3,3,-3,0
Sako,147,2,34,2018-09-01T14:00:00Z,True,6,15,0,0,3,0,3,1,1,0,2,0
Sako,147,2,43,2018-09-15T14:00:00Z,False,6,9,0,0,3,0,3,2,1,1,1,2
Sako,147,2,54,2018-09-22T14:00:00Z,True,6,14,0,0,6,0,6,1,0,1,5,-1
Sako,147,2,61,2018-10-01T19:00:00Z,False,6,1,0,0,7,1,6,10,7,3,-3,-1
Sako,147,2,72,2018-10-06T14:00:00Z,True,6,19,0,0,7,1,6,12,8,4,-5,-3
Sako,147,2,84,2018-10-21T15:00:00Z,False,6,7,0,0,7,1,6,12,7,5,-5,-1
Sako,147,2,92,2018-10-28T13:30:00Z,True,6,0,0,0,7,1,6,21,12,9,-14,-8
Sako,147,2,103,2018-11-04T16:00:00Z,False,6,5,0,0,8,2,6,24,11,13,-16,-5
Sako,147,2,113,2018-11-10T17:30:00Z,True,6,16,0,0,8,2,6,24,6,18,-16,-16
Sako,147,2,125,2018-11-24T15:00:00Z,False,6,13,0,0,8,2,6,20,10,10,-12,-4
Sako,147,2,133,2018-12-01T15:00:00Z,True,6,3,0,0,9,2,7,9,4,5,0,-3
Sako,147,2,141,2018-12-04T19:45:00Z,False,6,2,0,0,12,5,7,18,11,7,-6,-4
Sako,147,2,159,2018-12-08T15:00:00Z,False,6,18,0,0,12,5,7,18,10,8,-6,-3
Sako,147,2,161,2018-12-15T15:00:00Z,True,6,10,0,0,12,5,7,22,11,11,-10,-6
Sako,147,2,176,2018-12-22T15:00:00Z,False,6,12,0,0,15,8,7,44,27,17,-29,-20
Sako,147,2,182,2018-12-26T15:00:00Z,True,6,4,0,0,18,8,10,14,13,1,4,7
Sako,147,2,192,2018-12-30T12:00:00Z,True,6,5,0,0,19,9,10,40,21,19,-21,-10
Sako,147,2,209,2019-01-02T19:45:00Z,False,6,19,0,0,19,9,10,29,14,15,-10,-4
Sako,147,2,214,2019-01-12T15:00:00Z,True,6,17,0,0,22,9,13,29,16,13,-7,-4
Sako,147,2,224,2019-01-19T15:00:00Z,False,6,11,0,0,22,9,13,57,28,29,-35,-15
Sako,147,2,238,2019-01-30T19:45:00Z,False,6,15,0,0,22,9,13,22,11,11,0,2
Sako,147,2,244,2019-02-02T15:00:00Z,True,6,8,1,1,23,9,14,17,15,2,6,7
Sako,147,2,251,2019-02-09T15:00:00Z,True,6,18,0,0,26,12,14,32,18,14,-6,-2
Sako,147,2,266,2019-02-23T17:30:00Z,False,6,10,0,0,27,13,14,32,14,18,-5,0
Sako,147,2,272,2019-02-27T20:00:00Z,True,6,13,0,0,30,13,17,52,26,26,-22,-13
Sako,147,2,282,2019-03-02T15:00:00Z,False,6,3,0,0,30,13,17,30,17,13,0,0
Sako,147,2,293,2019-03-09T12:30:00Z,True,6,2,0,0,33,13,20,30,22,8,3,5
Sako,147,2,314,2019-03-30T15:00:00Z,True,6,9,0,0,33,13,20,14,8,6,19,7
Sako,147,2,306,2019-04-03T18:45:00Z,False,6,16,0,0,36,16,20,61,28,33,-25,-8
Sako,147,2,325,2019-04-06T14:00:00Z,False,6,14,0,0,36,16,20,35,22,13,1,-2
Sako,147,2,332,2019-04-14T13:05:00Z,True,6,12,5,1,39,16,23,80,48,32,-41,-16
Sako,147,2,340,2019-04-21T15:00:00Z,False,6,0,0,0,39,16,23,66,44,22,-27,-21
Sako,147,2,352,2019-04-27T14:00:00Z,True,6,7,0,0,42,16,26,49,31,18,-7,-2
Sako,147,2,362,2019-05-04T16:30:00Z,False,6,4,17,1,43,17,26,31,20,11,12,6
Sako,147,2,372,2019-05-12T14:00:00Z,True,6,1,3,1,46,17,29,45,29,16,1,1
Townsend,148,2,2,2018-08-11T14:00:00Z,False,6,8,87,3,0,0,0,0,0,0,0,0
Townsend,148,2,14,2018-08-20T19:00:00Z,True,6,11,78,2,3,0,3,3,3,0,0,0
Townsend,148,2,28,2018-08-26T12:30:00Z,False,6,17,90,2,3,0,3,6,3,3,-3,0
Townsend,148,2,34,2018-09-01T14:00:00Z,True,6,15,71,2,3,0,3,1,1,0,2,0
Townsend,148,2,43,2018-09-15T14:00:00Z,False,6,9,90,3,3,0,3,2,1,1,1,2
Townsend,148,2,54,2018-09-22T14:00:00Z,True,6,14,90,3,6,0,6,1,0,1,5,-1
Townsend,148,2,61,2018-10-01T19:00:00Z,False,6,1,90,1,7,1,6,10,7,3,-3,-1
Townsend,148,2,72,2018-10-06T14:00:00Z,True,6,19,90,2,7,1,6,12,8,4,-5,-3
Townsend,148,2,84,2018-10-21T15:00:00Z,False,6,7,90,2,7,1,6,12,7,5,-5,-1
Townsend,148,2,92,2018-10-28T13:30:00Z,True,6,0,90,2,7,1,6,21,12,9,-14,-8
Townsend,148,2,103,2018-11-04T16:00:00Z,False,6,5,90,7,8,2,6,24,11,13,-16,-5
Townsend,148,2,113,2018-11-10T17:30:00Z,True,6,16,90,2,8,2,6,24,6,18,-16,-16
Townsend,148,2,125,2018-11-24T15:00:00Z,False,6,13,87,3,8,2,6,20,10,10,-12,-4
Townsend,148,2,133,2018-12-01T15:00:00Z,True,6,3,87,14,9,2,7,9,4,5,0,-3
Townsend,148,2,141,2018-12-04T19:45:00Z,False,6,2,90,2,12,5,7,18,11,7,-6,-4
Townsend,148,2,159,2018-12-08T15:00:00Z,False,6,18,90,2,12,5,7,18,10,8,-6,-3
Townsend,148,2,161,2018-12-15T15:00:00Z,True,6,10,90,6,12,5,7,22,11,11,-10,-6
Townsend,148,2,176,2018-12-22T15:00:00Z,False,6,12,90,9,15,8,7,44,27,17,-29,-20
Townsend,148,2,182,2018-12-26T15:00:00Z,True,6,4,90,3,18,8,10,14,13,1,4,7
Townsend,148,2,192,2018-12-30T12:00:00Z,True,6,5,90,2,19,9,10,40,21,19,-21,-10
Townsend,148,2,209,2019-01-02T19:45:00Z,False,6,19,90,3,19,9,10,29,14,15,-10,-4
Townsend,148,2,214,2019-01-12T15:00:00Z,True,6,17,90,2,22,9,13,29,16,13,-7,-4
Townsend,148,2,224,2019-01-19T15:00:00Z,False,6,11,90,7,22,9,13,57,28,29,-35,-15
Townsend,148,2,238,2019-01-30T19:45:00Z,False,6,15,90,5,22,9,13,22,11,11,0,2
Townsend,148,2,244,2019-02-02T15:00:00Z,True,6,8,90,3,23,9,14,17,15,2,6,7
Townsend,148,2,251,2019-02-09T15:00:00Z,True,6,18,90,2,26,12,14,32,18,14,-6,-2
Townsend,148,2,266,2019-02-23T17:30:00Z,False,6,10,79,2,27,13,14,32,14,18,-5,0
Townsend,148,2,272,2019-02-27T20:00:00Z,True,6,13,90,2,30,13,17,52,26,26,-22,-13
Townsend,148,2,282,2019-03-02T15:00:00Z,False,6,3,11,1,30,13,17,30,17,13,0,0
Townsend,148,2,293,2019-03-09T12:30:00Z,True,6,2,76,5,33,13,20,30,22,8,3,5
Townsend,148,2,314,2019-03-30T15:00:00Z,True,6,9,79,3,33,13,20,14,8,6,19,7
Townsend,148,2,306,2019-04-03T18:45:00Z,False,6,16,11,1,36,16,20,61,28,33,-25,-8
Townsend,148,2,325,2019-04-06T14:00:00Z,False,6,14,84,3,36,16,20,35,22,13,1,-2
Townsend,148,2,332,2019-04-14T13:05:00Z,True,6,12,76,2,39,16,23,80,48,32,-41,-16
Townsend,148,2,340,2019-04-21T15:00:00Z,False,6,0,10,1,39,16,23,66,44,22,-27,-21
Townsend,148,2,352,2019-04-27T14:00:00Z,True,6,7,18,1,42,16,26,49,31,18,-7,-2
Townsend,148,2,362,2019-05-04T16:30:00Z,False,6,4,83,13,43,17,26,31,20,11,12,6
Townsend,148,2,372,2019-05-12T14:00:00Z,True,6,1,90,7,46,17,29,45,29,16,1,1
Milivojevic,149,2,2,2018-08-11T14:00:00Z,False,6,8,90,3,0,0,0,0,0,0,0,0
Milivojevic,149,2,14,2018-08-20T19:00:00Z,True,6,11,90,2,3,0,3,3,3,0,0,0
Milivojevic,149,2,28,2018-08-26T12:30:00Z,False,6,17,90,2,3,0,3,6,3,3,-3,0
Milivojevic,149,2,34,2018-09-01T14:00:00Z,True,6,15,90,2,3,0,3,1,1,0,2,0
Milivojevic,149,2,43,2018-09-15T14:00:00Z,False,6,9,90,3,3,0,3,2,1,1,1,2
Milivojevic,149,2,54,2018-09-22T14:00:00Z,True,6,14,90,3,6,0,6,1,0,1,5,-1
Milivojevic,149,2,61,2018-10-01T19:00:00Z,False,6,1,90,2,7,1,6,10,7,3,-3,-1
Milivojevic,149,2,72,2018-10-06T14:00:00Z,True,6,19,90,2,7,1,6,12,8,4,-5,-3
Milivojevic,149,2,84,2018-10-21T15:00:00Z,False,6,7,90,-1,7,1,6,12,7,5,-5,-1
Milivojevic,149,2,92,2018-10-28T13:30:00Z,True,6,0,90,15,7,1,6,21,12,9,-14,-8
Milivojevic,149,2,103,2018-11-04T16:00:00Z,False,6,5,90,1,8,2,6,24,11,13,-16,-5
Milivojevic,149,2,113,2018-11-10T17:30:00Z,True,6,16,90,2,8,2,6,24,6,18,-16,-16
Milivojevic,149,2,125,2018-11-24T15:00:00Z,False,6,13,90,2,8,2,6,20,10,10,-12,-4
Milivojevic,149,2,133,2018-12-01T15:00:00Z,True,6,3,90,3,9,2,7,9,4,5,0,-3
Milivojevic,149,2,141,2018-12-04T19:45:00Z,False,6,2,90,9,12,5,7,18,11,7,-6,-4
Milivojevic,149,2,159,2018-12-08T15:00:00Z,False,6,18,90,2,12,5,7,18,10,8,-6,-3
Milivojevic,149,2,161,2018-12-15T15:00:00Z,True,6,10,90,11,12,5,7,22,11,11,-10,-6
Milivojevic,149,2,176,2018-12-22T15:00:00Z,False,6,12,90,10,15,8,7,44,27,17,-29,-20
Milivojevic,149,2,182,2018-12-26T15:00:00Z,True,6,4,90,3,18,8,10,14,13,1,4,7
Milivojevic,149,2,192,2018-12-30T12:00:00Z,True,6,5,90,2,19,9,10,40,21,19,-21,-10
Milivojevic,149,2,209,2019-01-02T19:45:00Z,False,6,19,90,7,19,9,10,29,14,15,-10,-4
Milivojevic,149,2,214,2019-01-12T15:00:00Z,True,6,17,90,1,22,9,13,29,16,13,-7,-4
Milivojevic,149,2,224,2019-01-19T15:00:00Z,False,6,11,90,5,22,9,13,57,28,29,-35,-15
Milivojevic,149,2,238,2019-01-30T19:45:00Z,False,6,15,90,1,22,9,13,22,11,11,0,2
Milivojevic,149,2,244,2019-02-02T15:00:00Z,True,6,8,90,11,23,9,14,17,15,2,6,7
Milivojevic,149,2,251,2019-02-09T15:00:00Z,True,6,18,90,1,26,12,14,32,18,14,-6,-2
Milivojevic,149,2,266,2019-02-23T17:30:00Z,False,6,10,90,9,27,13,14,32,14,18,-5,0
Milivojevic,149,2,272,2019-02-27T20:00:00Z,True,6,13,90,2,30,13,17,52,26,26,-22,-13
Milivojevic,149,2,282,2019-03-02T15:00:00Z,False,6,3,90,2,30,13,17,30,17,13,0,0
Milivojevic,149,2,293,2019-03-09T12:30:00Z,True,6,2,90,10,33,13,20,30,22,8,3,5
Milivojevic,149,2,314,2019-03-30T15:00:00Z,True,6,9,90,9,33,13,20,14,8,6,19,7
Milivojevic,149,2,306,2019-04-03T18:45:00Z,False,6,16,90,2,36,16,20,61,28,33,-25,-8
Milivojevic,149,2,325,2019-04-06T14:00:00Z,False,6,14,90,10,36,16,20,35,22,13,1,-2
Milivojevic,149,2,332,2019-04-14T13:05:00Z,True,6,12,90,8,39,16,23,80,48,32,-41,-16
Milivojevic,149,2,340,2019-04-21T15:00:00Z,False,6,0,90,5,39,16,23,66,44,22,-27,-21
Milivojevic,149,2,352,2019-04-27T14:00:00Z,True,6,7,90,2,42,16,26,49,31,18,-7,-2
Milivojevic,149,2,362,2019-05-04T16:30:00Z,False,6,4,90,2,43,17,26,31,20,11,12,6
Milivojevic,149,2,372,2019-05-12T14:00:00Z,True,6,1,90,1,46,17,29,45,29,16,1,1
Zaha,150,3,2,2018-08-11T14:00:00Z,False,6,8,90,5,0,0,0,0,0,0,0,0
Zaha,150,3,14,2018-08-20T19:00:00Z,True,6,11,90,2,3,0,3,3,3,0,0,0
Zaha,150,3,28,2018-08-26T12:30:00Z,False,6,17,90,5,3,0,3,6,3,3,-3,0
Zaha,150,3,34,2018-09-01T14:00:00Z,True,6,15,0,0,3,0,3,1,1,0,2,0
Zaha,150,3,43,2018-09-15T14:00:00Z,False,6,9,90,7,3,0,3,2,1,1,1,2
Zaha,150,3,54,2018-09-22T14:00:00Z,True,6,14,90,2,6,0,6,1,0,1,5,-1
Zaha,150,3,61,2018-10-01T19:00:00Z,False,6,1,90,6,7,1,6,10,7,3,-3,-1
Zaha,150,3,72,2018-10-06T14:00:00Z,True,6,19,90,2,7,1,6,12,8,4,-5,-3
Zaha,150,3,84,2018-10-21T15:00:00Z,False,6,7,90,2,7,1,6,12,7,5,-5,-1
Zaha,150,3,92,2018-10-28T13:30:00Z,True,6,0,90,5,7,1,6,21,12,9,-14,-8
Zaha,150,3,103,2018-11-04T16:00:00Z,False,6,5,90,2,8,2,6,24,11,13,-16,-5
Zaha,150,3,113,2018-11-10T17:30:00Z,True,6,16,0,0,8,2,6,24,6,18,-16,-16
Zaha,150,3,125,2018-11-24T15:00:00Z,False,6,13,90,2,8,2,6,20,10,10,-12,-4
Zaha,150,3,133,2018-12-01T15:00:00Z,True,6,3,90,2,9,2,7,9,4,5,0,-3
Zaha,150,3,141,2018-12-04T19:45:00Z,False,6,2,90,4,12,5,7,18,11,7,-6,-4
Zaha,150,3,159,2018-12-08T15:00:00Z,False,6,18,90,1,12,5,7,18,10,8,-6,-3
Zaha,150,3,161,2018-12-15T15:00:00Z,True,6,10,0,0,12,5,7,22,11,11,-10,-6
Zaha,150,3,176,2018-12-22T15:00:00Z,False,6,12,87,1,15,8,7,44,27,17,-29,-20
Zaha,150,3,182,2018-12-26T15:00:00Z,True,6,4,90,2,18,8,10,14,13,1,4,7
Zaha,150,3,192,2018-12-30T12:00:00Z,True,6,5,90,2,19,9,10,40,21,19,-21,-10
Zaha,150,3,209,2019-01-02T19:45:00Z,False,6,19,90,5,19,9,10,29,14,15,-10,-4
Zaha,150,3,214,2019-01-12T15:00:00Z,True,6,17,90,2,22,9,13,29,16,13,-7,-4
Zaha,150,3,224,2019-01-19T15:00:00Z,False,6,11,90,5,22,9,13,57,28,29,-35,-15
Zaha,150,3,238,2019-01-30T19:45:00Z,False,6,15,86,3,22,9,13,22,11,11,0,2
Zaha,150,3,244,2019-02-02T15:00:00Z,True,6,8,0,0,23,9,14,17,15,2,6,7
Zaha,150,3,251,2019-02-09T15:00:00Z,True,6,18,90,9,26,12,14,32,18,14,-6,-2
Zaha,150,3,266,2019-02-23T17:30:00Z,False,6,10,90,13,27,13,14,32,14,18,-5,0
Zaha,150,3,272,2019-02-27T20:00:00Z,True,6,13,90,1,30,13,17,52,26,26,-22,-13
Zaha,150,3,282,2019-03-02T15:00:00Z,False,6,3,78,9,30,13,17,30,17,13,0,0
Zaha,150,3,293,2019-03-09T12:30:00Z,True,6,2,90,2,33,13,20,30,22,8,3,5
Zaha,150,3,314,2019-03-30T15:00:00Z,True,6,9,90,8,33,13,20,14,8,6,19,7
Zaha,150,3,306,2019-04-03T18:45:00Z,False,6,16,90,2,36,16,20,61,28,33,-25,-8
Zaha,150,3,325,2019-04-06T14:00:00Z,False,6,14,90,5,36,16,20,35,22,13,1,-2
Zaha,150,3,332,2019-04-14T13:05:00Z,True,6,12,90,2,39,16,23,80,48,32,-41,-16
Zaha,150,3,340,2019-04-21T15:00:00Z,False,6,0,90,6,39,16,23,66,44,22,-27,-21
Zaha,150,3,352,2019-04-27T14:00:00Z,True,6,7,90,2,42,16,26,49,31,18,-7,-2
Zaha,150,3,362,2019-05-04T16:30:00Z,False,6,4,90,7,43,17,26,31,20,11,12,6
Zaha,150,3,372,2019-05-12T14:00:00Z,True,6,1,86,10,46,17,29,45,29,16,1,1
Benteke,151,3,2,2018-08-11T14:00:00Z,False,6,8,82,2,0,0,0,0,0,0,0,0
Benteke,151,3,14,2018-08-20T19:00:00Z,True,6,11,69,2,3,0,3,3,3,0,0,0
Benteke,151,3,28,2018-08-26T12:30:00Z,False,6,17,84,2,3,0,3,6,3,3,-3,0
Benteke,151,3,34,2018-09-01T14:00:00Z,True,6,15,90,2,3,0,3,1,1,0,2,0
Benteke,151,3,43,2018-09-15T14:00:00Z,False,6,9,0,0,3,0,3,2,1,1,1,2
Benteke,151,3,54,2018-09-22T14:00:00Z,True,6,14,0,0,6,0,6,1,0,1,5,-1
Benteke,151,3,61,2018-10-01T19:00:00Z,False,6,1,0,0,7,1,6,10,7,3,-3,-1
Benteke,151,3,72,2018-10-06T14:00:00Z,True,6,19,0,0,7,1,6,12,8,4,-5,-3
Benteke,151,3,84,2018-10-21T15:00:00Z,False,6,7,0,0,7,1,6,12,7,5,-5,-1
Benteke,151,3,92,2018-10-28T13:30:00Z,True,6,0,0,0,7,1,6,21,12,9,-14,-8
Benteke,151,3,103,2018-11-04T16:00:00Z,False,6,5,0,0,8,2,6,24,11,13,-16,-5
Benteke,151,3,113,2018-11-10T17:30:00Z,True,6,16,0,0,8,2,6,24,6,18,-16,-16
Benteke,151,3,125,2018-11-24T15:00:00Z,False,6,13,0,0,8,2,6,20,10,10,-12,-4
Benteke,151,3,133,2018-12-01T15:00:00Z,True,6,3,0,0,9,2,7,9,4,5,0,-3
Benteke,151,3,141,2018-12-04T19:45:00Z,False,6,2,0,0,12,5,7,18,11,7,-6,-4
Benteke,151,3,159,2018-12-08T15:00:00Z,False,6,18,0,0,12,5,7,18,10,8,-6,-3
Benteke,151,3,161,2018-12-15T15:00:00Z,True,6,10,0,0,12,5,7,22,11,11,-10,-6
Benteke,151,3,176,2018-12-22T15:00:00Z,False,6,12,0,0,15,8,7,44,27,17,-29,-20
Benteke,151,3,182,2018-12-26T15:00:00Z,True,6,4,0,0,18,8,10,14,13,1,4,7
Benteke,151,3,192,2018-12-30T12:00:00Z,True,6,5,0,0,19,9,10,40,21,19,-21,-10
Benteke,151,3,209,2019-01-02T19:45:00Z,False,6,19,0,0,19,9,10,29,14,15,-10,-4
Benteke,151,3,214,2019-01-12T15:00:00Z,True,6,17,12,1,22,9,13,29,16,13,-7,-4
Benteke,151,3,224,2019-01-19T15:00:00Z,False,6,11,0,0,22,9,13,57,28,29,-35,-15
Benteke,151,3,238,2019-01-30T19:45:00Z,False,6,15,0,0,22,9,13,22,11,11,0,2
Benteke,151,3,244,2019-02-02T15:00:00Z,True,6,8,71,2,23,9,14,17,15,2,6,7
Benteke,151,3,251,2019-02-09T15:00:00Z,True,6,18,59,1,26,12,14,32,18,14,-6,-2
Benteke,151,3,266,2019-02-23T17:30:00Z,False,6,10,0,0,27,13,14,32,14,18,-5,0
Benteke,151,3,272,2019-02-27T20:00:00Z,True,6,13,12,1,30,13,17,52,26,26,-22,-13
Benteke,151,3,282,2019-03-02T15:00:00Z,False,6,3,7,1,30,13,17,30,17,13,0,0
Benteke,151,3,293,2019-03-09T12:30:00Z,True,6,2,13,1,33,13,20,30,22,8,3,5
Benteke,151,3,314,2019-03-30T15:00:00Z,True,6,9,17,1,33,13,20,14,8,6,19,7
Benteke,151,3,306,2019-04-03T18:45:00Z,False,6,16,9,1,36,16,20,61,28,33,-25,-8
Benteke,151,3,325,2019-04-06T14:00:00Z,False,6,14,25,0,36,16,20,35,22,13,1,-2
Benteke,151,3,332,2019-04-14T13:05:00Z,True,6,12,90,2,39,16,23,80,48,32,-41,-16
Benteke,151,3,340,2019-04-21T15:00:00Z,False,6,0,77,12,39,16,23,66,44,22,-27,-21
Benteke,151,3,352,2019-04-27T14:00:00Z,True,6,7,90,2,42,16,26,49,31,18,-7,-2
Benteke,151,3,362,2019-05-04T16:30:00Z,False,6,4,0,0,43,17,26,31,20,11,12,6
Benteke,151,3,372,2019-05-12T14:00:00Z,True,6,1,0,0,46,17,29,45,29,16,1,1
Srloth,152,3,2,2018-08-11T14:00:00Z,False,6,8,7,1,0,0,0,0,0,0,0,0
Srloth,152,3,14,2018-08-20T19:00:00Z,True,6,11,20,1,3,0,3,3,3,0,0,0
Srloth,152,3,28,2018-08-26T12:30:00Z,False,6,17,5,1,3,0,3,6,3,3,-3,0
Srloth,152,3,34,2018-09-01T14:00:00Z,True,6,15,14,1,3,0,3,1,1,0,2,0
Srloth,152,3,43,2018-09-15T14:00:00Z,False,6,9,0,0,3,0,3,2,1,1,1,2
Srloth,152,3,54,2018-09-22T14:00:00Z,True,6,14,19,1,6,0,6,1,0,1,5,-1
Srloth,152,3,61,2018-10-01T19:00:00Z,False,6,1,8,1,7,1,6,10,7,3,-3,-1
Srloth,152,3,72,2018-10-06T14:00:00Z,True,6,19,8,1,7,1,6,12,8,4,-5,-3
Srloth,152,3,84,2018-10-21T15:00:00Z,False,6,7,0,0,7,1,6,12,7,5,-5,-1
Srloth,152,3,92,2018-10-28T13:30:00Z,True,6,0,26,1,7,1,6,21,12,9,-14,-8
Srloth,152,3,103,2018-11-04T16:00:00Z,False,6,5,0,0,8,2,6,24,11,13,-16,-5
Srloth,152,3,113,2018-11-10T17:30:00Z,True,6,16,20,1,8,2,6,24,6,18,-16,-16
Srloth,152,3,125,2018-11-24T15:00:00Z,False,6,13,0,0,8,2,6,20,10,10,-12,-4
Srloth,152,3,133,2018-12-01T15:00:00Z,True,6,3,2,1,9,2,7,9,4,5,0,-3
Srloth,152,3,141,2018-12-04T19:45:00Z,False,6,2,32,1,12,5,7,18,11,7,-6,-4
Srloth,152,3,159,2018-12-08T15:00:00Z,False,6,18,0,0,12,5,7,18,10,8,-6,-3
Srloth,152,3,161,2018-12-15T15:00:00Z,True,6,10,12,1,12,5,7,22,11,11,-10,-6
Srloth,152,3,176,2018-12-22T15:00:00Z,False,6,12,0,0,15,8,7,44,27,17,-29,-20
Srloth,152,3,182,2018-12-26T15:00:00Z,True,6,4,0,0,18,8,10,14,13,1,4,7
Srloth,152,3,192,2018-12-30T12:00:00Z,True,6,5,0,0,19,9,10,40,21,19,-21,-10
Srloth,152,3,209,2019-01-02T19:45:00Z,False,6,19,0,0,19,9,10,29,14,15,-10,-4
Srloth,152,3,214,2019-01-12T15:00:00Z,True,6,17,0,0,22,9,13,29,16,13,-7,-4
Srloth,152,3,224,2019-01-19T15:00:00Z,False,6,11,0,0,22,9,13,57,28,29,-35,-15
Srloth,152,3,238,2019-01-30T19:45:00Z,False,6,15,0,0,22,9,13,22,11,11,0,2
Srloth,152,3,244,2019-02-02T15:00:00Z,True,6,8,0,0,23,9,14,17,15,2,6,7
Srloth,152,3,251,2019-02-09T15:00:00Z,True,6,18,0,0,26,12,14,32,18,14,-6,-2
Srloth,152,3,266,2019-02-23T17:30:00Z,False,6,10,0,0,27,13,14,32,14,18,-5,0
Srloth,152,3,272,2019-02-27T20:00:00Z,True,6,13,0,0,30,13,17,52,26,26,-22,-13
Srloth,152,3,282,2019-03-02T15:00:00Z,False,6,3,0,0,30,13,17,30,17,13,0,0
Srloth,152,3,293,2019-03-09T12:30:00Z,True,6,2,0,0,33,13,20,30,22,8,3,5
Srloth,152,3,314,2019-03-30T15:00:00Z,True,6,9,0,0,33,13,20,14,8,6,19,7
Srloth,152,3,306,2019-04-03T18:45:00Z,False,6,16,0,0,36,16,20,61,28,33,-25,-8
Srloth,152,3,325,2019-04-06T14:00:00Z,False,6,14,0,0,36,16,20,35,22,13,1,-2
Srloth,152,3,332,2019-04-14T13:05:00Z,True,6,12,0,0,39,16,23,80,48,32,-41,-16
Srloth,152,3,340,2019-04-21T15:00:00Z,False,6,0,0,0,39,16,23,66,44,22,-27,-21
Srloth,152,3,352,2019-04-27T14:00:00Z,True,6,7,0,0,42,16,26,49,31,18,-7,-2
Srloth,152,3,362,2019-05-04T16:30:00Z,False,6,4,0,0,43,17,26,31,20,11,12,6
Srloth,152,3,372,2019-05-12T14:00:00Z,True,6,1,0,0,46,17,29,45,29,16,1,1
Pickford,153,0,9,2018-08-11T16:30:00Z,False,7,19,90,1,0,0,0,0,0,0,0,0
Pickford,153,0,15,2018-08-18T14:00:00Z,True,7,15,90,3,1,0,1,1,1,0,0,0
Pickford,153,0,21,2018-08-25T14:00:00Z,False,7,1,90,2,4,3,1,6,3,3,-2,-2
Pickford,153,0,35,2018-09-01T14:00:00Z,True,7,9,90,3,5,3,2,1,1,0,4,3
Pickford,153,0,42,2018-09-16T15:00:00Z,True,7,18,90,1,6,4,2,0,0,0,6,4
Pickford,153,0,50,2018-09-23T15:00:00Z,False,7,0,90,2,6,4,2,9,3,6,-3,-1
Pickford,153,0,64,2018-09-29T14:00:00Z,True,7,8,90,6,6,4,2,5,4,1,1,3
Pickford,153,0,74,2018-10-06T14:00:00Z,False,7,10,90,2,9,7,2,12,6,6,-3,-4
Pickford,153,0,84,2018-10-21T15:00:00Z,True,7,6,90,15,12,7,5,7,1,6,5,1
Pickford,153,0,96,2018-10-28T16:00:00Z,False,7,13,90,11,15,10,5,14,7,7,1,-2
Pickford,153,0,104,2018-11-03T15:00:00Z,True,7,2,90,2,15,10,5,14,10,4,1,6
Pickford,153,0,112,2018-11-11T14:15:00Z,False,7,5,90,7,18,13,5,27,14,13,-9,-9
Pickford,153,0,123,2018-11-24T15:00:00Z,True,7,4,90,6,19,13,6,8,7,1,11,12
Pickford,153,0,136,2018-12-02T16:15:00Z,False,7,11,90,2,22,16,6,33,16,17,-11,-10
Pickford,153,0,148,2018-12-05T19:45:00Z,True,7,14,90,3,22,16,6,12,6,6,10,10
Pickford,153,0,155,2018-12-10T20:00:00Z,True,7,17,90,1,23,17,6,20,12,8,3,9
Pickford,153,0,165,2018-12-15T12:30:00Z,False,7,12,90,2,24,18,6,41,24,17,-17,-18
Pickford,153,0,174,2018-12-23T16:00:00Z,True,7,16,90,-1,24,18,6,39,15,24,-15,-6
Pickford,153,0,181,2018-12-26T15:00:00Z,False,7,3,90,2,24,18,6,12,7,5,12,-1
Pickford,153,0,190,2018-12-29T15:00:00Z,False,7,2,90,2,27,18,9,22,15,7,5,-6
Pickford,153,0,204,2019-01-01T12:30:00Z,True,7,10,90,3,27,18,9,28,14,14,-1,4
Pickford,153,0,215,2019-01-13T14:15:00Z,True,7,1,90,9,27,18,9,27,18,9,0,9
Pickford,153,0,227,2019-01-19T15:00:00Z,False,7,15,90,2,30,21,9,19,8,11,11,1
Pickford,153,0,233,2019-01-29T19:45:00Z,False,7,9,90,8,30,21,9,11,5,6,19,4
Pickford,153,0,245,2019-02-02T15:00:00Z,True,7,19,90,1,33,21,12,35,20,15,-2,6
Pickford,153,0,265,2019-02-06T19:45:00Z,True,7,12,90,1,33,21,12,59,36,23,-26,-2
Pickford,153,0,258,2019-02-09T15:00:00Z,False,7,17,90,2,33,21,12,34,17,17,-1,-5
Pickford,153,0,271,2019-02-26T19:45:00Z,False,7,4,90,6,33,21,12,25,17,8,8,-5
Pickford,153,0,283,2019-03-03T16:15:00Z,True,7,11,90,7,36,21,15,69,38,31,-33,-10
Pickford,153,0,298,2019-03-09T15:00:00Z,False,7,14,90,7,37,22,15,31,19,12,6,-4
Pickford,153,0,303,2019-03-17T16:30:00Z,True,7,5,90,9,37,22,15,57,32,25,-20,-3
Pickford,153,0,319,2019-03-30T17:30:00Z,False,7,18,90,6,40,25,15,42,27,15,-2,-12
Pickford,153,0,322,2019-04-07T13:05:00Z,True,7,0,90,7,43,25,18,63,44,19,-20,6
Pickford,153,0,333,2019-04-13T14:00:00Z,False,7,8,90,2,46,28,18,17,15,2,29,3
Pickford,153,0,344,2019-04-21T12:30:00Z,True,7,13,90,6,46,28,18,64,35,29,-18,-1
Pickford,153,0,352,2019-04-27T14:00:00Z,False,7,6,90,6,49,31,18,42,16,26,7,2
Pickford,153,0,364,2019-05-03T19:00:00Z,True,7,3,90,6,50,31,19,40,23,17,10,14
Pickford,153,0,378,2019-05-12T14:00:00Z,False,7,16,90,1,53,34,19,70,37,33,-17,-18
Stekelenburg,154,0,9,2018-08-11T16:30:00Z,False,7,19,0,0,0,0,0,0,0,0,0,0
Stekelenburg,154,0,15,2018-08-18T14:00:00Z,True,7,15,0,0,1,0,1,1,1,0,0,0
Stekelenburg,154,0,21,2018-08-25T14:00:00Z,False,7,1,0,0,4,3,1,6,3,3,-2,-2
Stekelenburg,154,0,35,2018-09-01T14:00:00Z,True,7,9,0,0,5,3,2,1,1,0,4,3
Stekelenburg,154,0,42,2018-09-16T15:00:00Z,True,7,18,0,0,6,4,2,0,0,0,6,4
Stekelenburg,154,0,50,2018-09-23T15:00:00Z,False,7,0,0,0,6,4,2,9,3,6,-3,-1
Stekelenburg,154,0,64,2018-09-29T14:00:00Z,True,7,8,0,0,6,4,2,5,4,1,1,3
Stekelenburg,154,0,74,2018-10-06T14:00:00Z,False,7,10,0,0,9,7,2,12,6,6,-3,-4
Stekelenburg,154,0,84,2018-10-21T15:00:00Z,True,7,6,0,0,12,7,5,7,1,6,5,1
Stekelenburg,154,0,96,2018-10-28T16:00:00Z,False,7,13,0,0,15,10,5,14,7,7,1,-2
Stekelenburg,154,0,104,2018-11-03T15:00:00Z,True,7,2,0,0,15,10,5,14,10,4,1,6
Stekelenburg,154,0,112,2018-11-11T14:15:00Z,False,7,5,0,0,18,13,5,27,14,13,-9,-9
Stekelenburg,154,0,123,2018-11-24T15:00:00Z,True,7,4,0,0,19,13,6,8,7,1,11,12
Stekelenburg,154,0,136,2018-12-02T16:15:00Z,False,7,11,0,0,22,16,6,33,16,17,-11,-10
Stekelenburg,154,0,148,2018-12-05T19:45:00Z,True,7,14,0,0,22,16,6,12,6,6,10,10
Stekelenburg,154,0,155,2018-12-10T20:00:00Z,True,7,17,0,0,23,17,6,20,12,8,3,9
Stekelenburg,154,0,165,2018-12-15T12:30:00Z,False,7,12,0,0,24,18,6,41,24,17,-17,-18
Stekelenburg,154,0,174,2018-12-23T16:00:00Z,True,7,16,0,0,24,18,6,39,15,24,-15,-6
Stekelenburg,154,0,181,2018-12-26T15:00:00Z,False,7,3,0,0,24,18,6,12,7,5,12,-1
Stekelenburg,154,0,190,2018-12-29T15:00:00Z,False,7,2,0,0,27,18,9,22,15,7,5,-6
Stekelenburg,154,0,204,2019-01-01T12:30:00Z,True,7,10,0,0,27,18,9,28,14,14,-1,4
Stekelenburg,154,0,215,2019-01-13T14:15:00Z,True,7,1,0,0,27,18,9,27,18,9,0,9
Stekelenburg,154,0,227,2019-01-19T15:00:00Z,False,7,15,0,0,30,21,9,19,8,11,11,1
Stekelenburg,154,0,233,2019-01-29T19:45:00Z,False,7,9,0,0,30,21,9,11,5,6,19,4
Stekelenburg,154,0,245,2019-02-02T15:00:00Z,True,7,19,0,0,33,21,12,35,20,15,-2,6
Stekelenburg,154,0,265,2019-02-06T19:45:00Z,True,7,12,0,0,33,21,12,59,36,23,-26,-2
Stekelenburg,154,0,258,2019-02-09T15:00:00Z,False,7,17,0,0,33,21,12,34,17,17,-1,-5
Stekelenburg,154,0,271,2019-02-26T19:45:00Z,False,7,4,0,0,33,21,12,25,17,8,8,-5
Stekelenburg,154,0,283,2019-03-03T16:15:00Z,True,7,11,0,0,36,21,15,69,38,31,-33,-10
Stekelenburg,154,0,298,2019-03-09T15:00:00Z,False,7,14,0,0,37,22,15,31,19,12,6,-4
Stekelenburg,154,0,303,2019-03-17T16:30:00Z,True,7,5,0,0,37,22,15,57,32,25,-20,-3
Stekelenburg,154,0,319,2019-03-30T17:30:00Z,False,7,18,0,0,40,25,15,42,27,15,-2,-12
Stekelenburg,154,0,322,2019-04-07T13:05:00Z,True,7,0,0,0,43,25,18,63,44,19,-20,6
Stekelenburg,154,0,333,2019-04-13T14:00:00Z,False,7,8,0,0,46,28,18,17,15,2,29,3
Stekelenburg,154,0,344,2019-04-21T12:30:00Z,True,7,13,0,0,46,28,18,64,35,29,-18,-1
Stekelenburg,154,0,352,2019-04-27T14:00:00Z,False,7,6,0,0,49,31,18,42,16,26,7,2
Stekelenburg,154,0,364,2019-05-03T19:00:00Z,True,7,3,0,0,50,31,19,40,23,17,10,14
Stekelenburg,154,0,378,2019-05-12T14:00:00Z,False,7,16,0,0,53,34,19,70,37,33,-17,-18
Baines,155,1,9,2018-08-11T16:30:00Z,False,7,19,90,1,0,0,0,0,0,0,0,0
Baines,155,1,15,2018-08-18T14:00:00Z,True,7,15,90,2,1,0,1,1,1,0,0,0
Baines,155,1,21,2018-08-25T14:00:00Z,False,7,1,90,1,4,3,1,6,3,3,-2,-2
Baines,155,1,35,2018-09-01T14:00:00Z,True,7,9,14,1,5,3,2,1,1,0,4,3
Baines,155,1,42,2018-09-16T15:00:00Z,True,7,18,0,0,6,4,2,0,0,0,6,4
Baines,155,1,50,2018-09-23T15:00:00Z,False,7,0,0,0,6,4,2,9,3,6,-3,-1
Baines,155,1,64,2018-09-29T14:00:00Z,True,7,8,0,0,6,4,2,5,4,1,1,3
Baines,155,1,74,2018-10-06T14:00:00Z,False,7,10,0,0,9,7,2,12,6,6,-3,-4
Baines,155,1,84,2018-10-21T15:00:00Z,True,7,6,0,0,12,7,5,7,1,6,5,1
Baines,155,1,96,2018-10-28T16:00:00Z,False,7,13,0,0,15,10,5,14,7,7,1,-2
Baines,155,1,104,2018-11-03T15:00:00Z,True,7,2,0,0,15,10,5,14,10,4,1,6
Baines,155,1,112,2018-11-11T14:15:00Z,False,7,5,0,0,18,13,5,27,14,13,-9,-9
Baines,155,1,123,2018-11-24T15:00:00Z,True,7,4,0,0,19,13,6,8,7,1,11,12
Baines,155,1,136,2018-12-02T16:15:00Z,False,7,11,0,0,22,16,6,33,16,17,-11,-10
Baines,155,1,148,2018-12-05T19:45:00Z,True,7,14,0,0,22,16,6,12,6,6,10,10
Baines,155,1,155,2018-12-10T20:00:00Z,True,7,17,0,0,23,17,6,20,12,8,3,9
Baines,155,1,165,2018-12-15T12:30:00Z,False,7,12,0,0,24,18,6,41,24,17,-17,-18
Baines,155,1,174,2018-12-23T16:00:00Z,True,7,16,0,0,24,18,6,39,15,24,-15,-6
Baines,155,1,181,2018-12-26T15:00:00Z,False,7,3,0,0,24,18,6,12,7,5,12,-1
Baines,155,1,190,2018-12-29T15:00:00Z,False,7,2,0,0,27,18,9,22,15,7,5,-6
Baines,155,1,204,2019-01-01T12:30:00Z,True,7,10,0,0,27,18,9,28,14,14,-1,4
Baines,155,1,215,2019-01-13T14:15:00Z,True,7,1,0,0,27,18,9,27,18,9,0,9
Baines,155,1,227,2019-01-19T15:00:00Z,False,7,15,0,0,30,21,9,19,8,11,11,1
Baines,155,1,233,2019-01-29T19:45:00Z,False,7,9,54,1,30,21,9,11,5,6,19,4
Baines,155,1,245,2019-02-02T15:00:00Z,True,7,19,36,1,33,21,12,35,20,15,-2,6
Baines,155,1,265,2019-02-06T19:45:00Z,True,7,12,0,0,33,21,12,59,36,23,-26,-2
Baines,155,1,258,2019-02-09T15:00:00Z,False,7,17,0,0,33,21,12,34,17,17,-1,-5
Baines,155,1,271,2019-02-26T19:45:00Z,False,7,4,0,0,33,21,12,25,17,8,8,-5
Baines,155,1,283,2019-03-03T16:15:00Z,True,7,11,0,0,36,21,15,69,38,31,-33,-10
Baines,155,1,298,2019-03-09T15:00:00Z,False,7,14,0,0,37,22,15,31,19,12,6,-4
Baines,155,1,303,2019-03-17T16:30:00Z,True,7,5,0,0,37,22,15,57,32,25,-20,-3
Baines,155,1,319,2019-03-30T17:30:00Z,False,7,18,0,0,40,25,15,42,27,15,-2,-12
Baines,155,1,322,2019-04-07T13:05:00Z,True,7,0,0,0,43,25,18,63,44,19,-20,6
Baines,155,1,333,2019-04-13T14:00:00Z,False,7,8,0,0,46,28,18,17,15,2,29,3
Baines,155,1,344,2019-04-21T12:30:00Z,True,7,13,0,0,46,28,18,64,35,29,-18,-1
Baines,155,1,352,2019-04-27T14:00:00Z,False,7,6,0,0,49,31,18,42,16,26,7,2
Baines,155,1,364,2019-05-03T19:00:00Z,True,7,3,0,0,50,31,19,40,23,17,10,14
Baines,155,1,378,2019-05-12T14:00:00Z,False,7,16,0,0,53,34,19,70,37,33,-17,-18
Coleman,156,1,9,2018-08-11T16:30:00Z,False,7,19,90,1,0,0,0,0,0,0,0,0
Coleman,156,1,15,2018-08-18T14:00:00Z,True,7,15,90,2,1,0,1,1,1,0,0,0
Coleman,156,1,21,2018-08-25T14:00:00Z,False,7,1,90,1,4,3,1,6,3,3,-2,-2
Coleman,156,1,35,2018-09-01T14:00:00Z,True,7,9,90,2,5,3,2,1,1,0,4,3
Coleman,156,1,42,2018-09-16T15:00:00Z,True,7,18,0,0,6,4,2,0,0,0,6,4
Coleman,156,1,50,2018-09-23T15:00:00Z,False,7,0,0,0,6,4,2,9,3,6,-3,-1
Coleman,156,1,64,2018-09-29T14:00:00Z,True,7,8,0,0,6,4,2,5,4,1,1,3
Coleman,156,1,74,2018-10-06T14:00:00Z,False,7,10,0,0,9,7,2,12,6,6,-3,-4
Coleman,156,1,84,2018-10-21T15:00:00Z,True,7,6,90,5,12,7,5,7,1,6,5,1
Coleman,156,1,96,2018-10-28T16:00:00Z,False,7,13,90,1,15,10,5,14,7,7,1,-2
Coleman,156,1,104,2018-11-03T15:00:00Z,True,7,2,90,10,15,10,5,14,10,4,1,6
Coleman,156,1,112,2018-11-11T14:15:00Z,False,7,5,90,6,18,13,5,27,14,13,-9,-9
Coleman,156,1,123,2018-11-24T15:00:00Z,True,7,4,90,6,19,13,6,8,7,1,11,12
Coleman,156,1,136,2018-12-02T16:15:00Z,False,7,11,90,2,22,16,6,33,16,17,-11,-10
Coleman,156,1,148,2018-12-05T19:45:00Z,True,7,14,90,2,22,16,6,12,6,6,10,10
Coleman,156,1,155,2018-12-10T20:00:00Z,True,7,17,90,-1,23,17,6,20,12,8,3,9
Coleman,156,1,165,2018-12-15T12:30:00Z,False,7,12,56,0,24,18,6,41,24,17,-17,-18
Coleman,156,1,174,2018-12-23T16:00:00Z,True,7,16,90,-1,24,18,6,39,15,24,-15,-6
Coleman,156,1,181,2018-12-26T15:00:00Z,False,7,3,90,2,24,18,6,12,7,5,12,-1
Coleman,156,1,190,2018-12-29T15:00:00Z,False,7,2,90,2,27,18,9,22,15,7,5,-6
Coleman,156,1,204,2019-01-01T12:30:00Z,True,7,10,0,0,27,18,9,28,14,14,-1,4
Coleman,156,1,215,2019-01-13T14:15:00Z,True,7,1,90,6,27,18,9,27,18,9,0,9
Coleman,156,1,227,2019-01-19T15:00:00Z,False,7,15,90,1,30,21,9,19,8,11,11,1
Coleman,156,1,233,2019-01-29T19:45:00Z,False,7,9,90,7,30,21,9,11,5,6,19,4
Coleman,156,1,245,2019-02-02T15:00:00Z,True,7,19,72,1,33,21,12,35,20,15,-2,6
Coleman,156,1,265,2019-02-06T19:45:00Z,True,7,12,0,0,33,21,12,59,36,23,-26,-2
Coleman,156,1,258,2019-02-09T15:00:00Z,False,7,17,0,0,33,21,12,34,17,17,-1,-5
Coleman,156,1,271,2019-02-26T19:45:00Z,False,7,4,90,11,33,21,12,25,17,8,8,-5
Coleman,156,1,283,2019-03-03T16:15:00Z,True,7,11,90,6,36,21,15,69,38,31,-33,-10
Coleman,156,1,298,2019-03-09T15:00:00Z,False,7,14,0,0,37,22,15,31,19,12,6,-4
Coleman,156,1,303,2019-03-17T16:30:00Z,True,7,5,90,8,37,22,15,57,32,25,-20,-3
Coleman,156,1,319,2019-03-30T17:30:00Z,False,7,18,90,11,40,25,15,42,27,15,-2,-12
Coleman,156,1,322,2019-04-07T13:05:00Z,True,7,0,90,6,43,25,18,63,44,19,-20,6
Coleman,156,1,333,2019-04-13T14:00:00Z,False,7,8,90,1,46,28,18,17,15,2,29,3
Coleman,156,1,344,2019-04-21T12:30:00Z,True,7,13,90,7,46,28,18,64,35,29,-18,-1
Coleman,156,1,352,2019-04-27T14:00:00Z,False,7,6,90,6,49,31,18,42,16,26,7,2
Coleman,156,1,364,2019-05-03T19:00:00Z,True,7,3,90,14,50,31,19,40,23,17,10,14
Coleman,156,1,378,2019-05-12T14:00:00Z,False,7,16,0,0,53,34,19,70,37,33,-17,-18
Jagielka,157,1,9,2018-08-11T16:30:00Z,False,7,19,39,-3,0,0,0,0,0,0,0,0
Jagielka,157,1,15,2018-08-18T14:00:00Z,True,7,15,0,0,1,0,1,1,1,0,0,0
Jagielka,157,1,21,2018-08-25T14:00:00Z,False,7,1,0,0,4,3,1,6,3,3,-2,-2
Jagielka,157,1,35,2018-09-01T14:00:00Z,True,7,9,0,0,5,3,2,1,1,0,4,3
Jagielka,157,1,42,2018-09-16T15:00:00Z,True,7,18,0,0,6,4,2,0,0,0,6,4
Jagielka,157,1,50,2018-09-23T15:00:00Z,False,7,0,0,0,6,4,2,9,3,6,-3,-1
Jagielka,157,1,64,2018-09-29T14:00:00Z,True,7,8,0,0,6,4,2,5,4,1,1,3
Jagielka,157,1,74,2018-10-06T14:00:00Z,False,7,10,0,0,9,7,2,12,6,6,-3,-4
Jagielka,157,1,84,2018-10-21T15:00:00Z,True,7,6,0,0,12,7,5,7,1,6,5,1
Jagielka,157,1,96,2018-10-28T16:00:00Z,False,7,13,0,0,15,10,5,14,7,7,1,-2
Jagielka,157,1,104,2018-11-03T15:00:00Z,True,7,2,0,0,15,10,5,14,10,4,1,6
Jagielka,157,1,112,2018-11-11T14:15:00Z,False,7,5,14,1,18,13,5,27,14,13,-9,-9
Jagielka,157,1,123,2018-11-24T15:00:00Z,True,7,4,0,0,19,13,6,8,7,1,11,12
Jagielka,157,1,136,2018-12-02T16:15:00Z,False,7,11,0,0,22,16,6,33,16,17,-11,-10
Jagielka,157,1,148,2018-12-05T19:45:00Z,True,7,14,0,0,22,16,6,12,6,6,10,10
Jagielka,157,1,155,2018-12-10T20:00:00Z,True,7,17,0,0,23,17,6,20,12,8,3,9
Jagielka,157,1,165,2018-12-15T12:30:00Z,False,7,12,0,0,24,18,6,41,24,17,-17,-18
Jagielka,157,1,174,2018-12-23T16:00:00Z,True,7,16,0,0,24,18,6,39,15,24,-15,-6
Jagielka,157,1,181,2018-12-26T15:00:00Z,False,7,3,0,0,24,18,6,12,7,5,12,-1
Jagielka,157,1,190,2018-12-29T15:00:00Z,False,7,2,0,0,27,18,9,22,15,7,5,-6
Jagielka,157,1,204,2019-01-01T12:30:00Z,True,7,10,0,0,27,18,9,28,14,14,-1,4
Jagielka,157,1,215,2019-01-13T14:15:00Z,True,7,1,0,0,27,18,9,27,18,9,0,9
Jagielka,157,1,227,2019-01-19T15:00:00Z,False,7,15,0,0,30,21,9,19,8,11,11,1
Jagielka,157,1,233,2019-01-29T19:45:00Z,False,7,9,0,0,30,21,9,11,5,6,19,4
Jagielka,157,1,245,2019-02-02T15:00:00Z,True,7,19,0,0,33,21,12,35,20,15,-2,6
Jagielka,157,1,265,2019-02-06T19:45:00Z,True,7,12,0,0,33,21,12,59,36,23,-26,-2
Jagielka,157,1,258,2019-02-09T15:00:00Z,False,7,17,0,0,33,21,12,34,17,17,-1,-5
Jagielka,157,1,271,2019-02-26T19:45:00Z,False,7,4,90,6,33,21,12,25,17,8,8,-5
Jagielka,157,1,283,2019-03-03T16:15:00Z,True,7,11,0,0,36,21,15,69,38,31,-33,-10
Jagielka,157,1,298,2019-03-09T15:00:00Z,False,7,14,0,0,37,22,15,31,19,12,6,-4
Jagielka,157,1,303,2019-03-17T16:30:00Z,True,7,5,0,0,37,22,15,57,32,25,-20,-3
Jagielka,157,1,319,2019-03-30T17:30:00Z,False,7,18,0,0,40,25,15,42,27,15,-2,-12
Jagielka,157,1,322,2019-04-07T13:05:00Z,True,7,0,90,15,43,25,18,63,44,19,-20,6
Jagielka,157,1,333,2019-04-13T14:00:00Z,False,7,8,90,1,46,28,18,17,15,2,29,3
Jagielka,157,1,344,2019-04-21T12:30:00Z,True,7,13,5,1,46,28,18,64,35,29,-18,-1
Jagielka,157,1,352,2019-04-27T14:00:00Z,False,7,6,0,0,49,31,18,42,16,26,7,2
Jagielka,157,1,364,2019-05-03T19:00:00Z,True,7,3,1,1,50,31,19,40,23,17,10,14
Jagielka,157,1,378,2019-05-12T14:00:00Z,False,7,16,0,0,53,34,19,70,37,33,-17,-18
Williams,158,1,9,2018-08-11T16:30:00Z,False,7,19,0,0,0,0,0,0,0,0,0,0
Williams,158,1,15,2018-08-18T14:00:00Z,True,7,15,0,0,1,0,1,1,1,0,0,0
Williams,158,1,21,2018-08-25T14:00:00Z,False,7,1,0,0,4,3,1,6,3,3,-2,-2
Williams,158,1,35,2018-09-01T14:00:00Z,True,7,9,0,0,5,3,2,1,1,0,4,3
Williams,158,1,42,2018-09-16T15:00:00Z,True,7,18,0,0,6,4,2,0,0,0,6,4
Williams,158,1,50,2018-09-23T15:00:00Z,False,7,0,0,0,6,4,2,9,3,6,-3,-1
Williams,158,1,64,2018-09-29T14:00:00Z,True,7,8,0,0,6,4,2,5,4,1,1,3
Williams,158,1,74,2018-10-06T14:00:00Z,False,7,10,0,0,9,7,2,12,6,6,-3,-4
Williams,158,1,84,2018-10-21T15:00:00Z,True,7,6,0,0,12,7,5,7,1,6,5,1
Williams,158,1,96,2018-10-28T16:00:00Z,False,7,13,0,0,15,10,5,14,7,7,1,-2
Williams,158,1,104,2018-11-03T15:00:00Z,True,7,2,0,0,15,10,5,14,10,4,1,6
Williams,158,1,112,2018-11-11T14:15:00Z,False,7,5,0,0,18,13,5,27,14,13,-9,-9
Williams,158,1,123,2018-11-24T15:00:00Z,True,7,4,0,0,19,13,6,8,7,1,11,12
Williams,158,1,136,2018-12-02T16:15:00Z,False,7,11,0,0,22,16,6,33,16,17,-11,-10
Williams,158,1,148,2018-12-05T19:45:00Z,True,7,14,0,0,22,16,6,12,6,6,10,10
Williams,158,1,155,2018-12-10T20:00:00Z,True,7,17,0,0,23,17,6,20,12,8,3,9
Williams,158,1,165,2018-12-15T12:30:00Z,False,7,12,0,0,24,18,6,41,24,17,-17,-18
Williams,158,1,174,2018-12-23T16:00:00Z,True,7,16,0,0,24,18,6,39,15,24,-15,-6
Williams,158,1,181,2018-12-26T15:00:00Z,False,7,3,0,0,24,18,6,12,7,5,12,-1
Williams,158,1,190,2018-12-29T15:00:00Z,False,7,2,0,0,27,18,9,22,15,7,5,-6
Williams,158,1,204,2019-01-01T12:30:00Z,True,7,10,0,0,27,18,9,28,14,14,-1,4
Williams,158,1,215,2019-01-13T14:15:00Z,True,7,1,0,0,27,18,9,27,18,9,0,9
Williams,158,1,227,2019-01-19T15:00:00Z,False,7,15,0,0,30,21,9,19,8,11,11,1
Williams,158,1,233,2019-01-29T19:45:00Z,False,7,9,0,0,30,21,9,11,5,6,19,4
Williams,158,1,245,2019-02-02T15:00:00Z,True,7,19,0,0,33,21,12,35,20,15,-2,6
Williams,158,1,265,2019-02-06T19:45:00Z,True,7,12,0,0,33,21,12,59,36,23,-26,-2
Williams,158,1,258,2019-02-09T15:00:00Z,False,7,17,0,0,33,21,12,34,17,17,-1,-5
Williams,158,1,271,2019-02-26T19:45:00Z,False,7,4,0,0,33,21,12,25,17,8,8,-5
Williams,158,1,283,2019-03-03T16:15:00Z,True,7,11,0,0,36,21,15,69,38,31,-33,-10
Williams,158,1,298,2019-03-09T15:00:00Z,False,7,14,0,0,37,22,15,31,19,12,6,-4
Williams,158,1,303,2019-03-17T16:30:00Z,True,7,5,0,0,37,22,15,57,32,25,-20,-3
Williams,158,1,319,2019-03-30T17:30:00Z,False,7,18,0,0,40,25,15,42,27,15,-2,-12
Williams,158,1,322,2019-04-07T13:05:00Z,True,7,0,0,0,43,25,18,63,44,19,-20,6
Williams,158,1,333,2019-04-13T14:00:00Z,False,7,8,0,0,46,28,18,17,15,2,29,3
Williams,158,1,344,2019-04-21T12:30:00Z,True,7,13,0,0,46,28,18,64,35,29,-18,-1
Williams,158,1,352,2019-04-27T14:00:00Z,False,7,6,0,0,49,31,18,42,16,26,7,2
Williams,158,1,364,2019-05-03T19:00:00Z,True,7,3,0,0,50,31,19,40,23,17,10,14
Williams,158,1,378,2019-05-12T14:00:00Z,False,7,16,0,0,53,34,19,70,37,33,-17,-18
Holgate,159,1,9,2018-08-11T16:30:00Z,False,7,19,47,0,0,0,0,0,0,0,0,0
Holgate,159,1,15,2018-08-18T14:00:00Z,True,7,15,90,2,1,0,1,1,1,0,0,0
Holgate,159,1,21,2018-08-25T14:00:00Z,False,7,1,90,1,4,3,1,6,3,3,-2,-2
Holgate,159,1,35,2018-09-01T14:00:00Z,True,7,9,90,1,5,3,2,1,1,0,4,3
Holgate,159,1,42,2018-09-16T15:00:00Z,True,7,18,90,1,6,4,2,0,0,0,6,4
Holgate,159,1,50,2018-09-23T15:00:00Z,False,7,0,0,0,6,4,2,9,3,6,-3,-1
Holgate,159,1,64,2018-09-29T14:00:00Z,True,7,8,0,0,6,4,2,5,4,1,1,3
Holgate,159,1,74,2018-10-06T14:00:00Z,False,7,10,0,0,9,7,2,12,6,6,-3,-4
Holgate,159,1,84,2018-10-21T15:00:00Z,True,7,6,0,0,12,7,5,7,1,6,5,1
Holgate,159,1,96,2018-10-28T16:00:00Z,False,7,13,0,0,15,10,5,14,7,7,1,-2
Holgate,159,1,104,2018-11-03T15:00:00Z,True,7,2,0,0,15,10,5,14,10,4,1,6
Holgate,159,1,112,2018-11-11T14:15:00Z,False,7,5,0,0,18,13,5,27,14,13,-9,-9
Holgate,159,1,123,2018-11-24T15:00:00Z,True,7,4,0,0,19,13,6,8,7,1,11,12
Holgate,159,1,136,2018-12-02T16:15:00Z,False,7,11,0,0,22,16,6,33,16,17,-11,-10
Holgate,159,1,148,2018-12-05T19:45:00Z,True,7,14,0,0,22,16,6,12,6,6,10,10
Holgate,159,1,155,2018-12-10T20:00:00Z,True,7,17,0,0,23,17,6,20,12,8,3,9
Holgate,159,1,165,2018-12-15T12:30:00Z,False,7,12,0,0,24,18,6,41,24,17,-17,-18
Holgate,159,1,174,2018-12-23T16:00:00Z,True,7,16,0,0,24,18,6,39,15,24,-15,-6
Holgate,159,1,181,2018-12-26T15:00:00Z,False,7,3,0,0,24,18,6,12,7,5,12,-1
Holgate,159,1,190,2018-12-29T15:00:00Z,False,7,2,0,0,27,18,9,22,15,7,5,-6
Holgate,159,1,204,2019-01-01T12:30:00Z,True,7,10,0,0,27,18,9,28,14,14,-1,4
Holgate,159,1,215,2019-01-13T14:15:00Z,True,7,1,0,0,27,18,9,27,18,9,0,9
Holgate,159,1,227,2019-01-19T15:00:00Z,False,7,15,0,0,30,21,9,19,8,11,11,1
Holgate,159,1,233,2019-01-29T19:45:00Z,False,7,9,0,0,30,21,9,11,5,6,19,4
Holgate,159,1,245,2019-02-02T15:00:00Z,True,7,19,0,0,33,21,12,35,20,15,-2,6
Holgate,159,1,265,2019-02-06T19:45:00Z,True,7,12,0,0,33,21,12,59,36,23,-26,-2
Holgate,159,1,258,2019-02-09T15:00:00Z,False,7,17,0,0,33,21,12,34,17,17,-1,-5
Holgate,159,1,271,2019-02-26T19:45:00Z,False,7,4,0,0,33,21,12,25,17,8,8,-5
Holgate,159,1,283,2019-03-03T16:15:00Z,True,7,11,0,0,36,21,15,69,38,31,-33,-10
Holgate,159,1,298,2019-03-09T15:00:00Z,False,7,14,0,0,37,22,15,31,19,12,6,-4
Holgate,159,1,303,2019-03-17T16:30:00Z,True,7,5,0,0,37,22,15,57,32,25,-20,-3
Holgate,159,1,319,2019-03-30T17:30:00Z,False,7,18,0,0,40,25,15,42,27,15,-2,-12
Holgate,159,1,322,2019-04-07T13:05:00Z,True,7,0,0,0,43,25,18,63,44,19,-20,6
Holgate,159,1,333,2019-04-13T14:00:00Z,False,7,8,0,0,46,28,18,17,15,2,29,3
Holgate,159,1,344,2019-04-21T12:30:00Z,True,7,13,0,0,46,28,18,64,35,29,-18,-1
Holgate,159,1,352,2019-04-27T14:00:00Z,False,7,6,0,0,49,31,18,42,16,26,7,2
Holgate,159,1,364,2019-05-03T19:00:00Z,True,7,3,0,0,50,31,19,40,23,17,10,14
Holgate,159,1,378,2019-05-12T14:00:00Z,False,7,16,0,0,53,34,19,70,37,33,-17,-18
Kenny,160,1,9,2018-08-11T16:30:00Z,False,7,19,0,0,0,0,0,0,0,0,0,0
Kenny,160,1,15,2018-08-18T14:00:00Z,True,7,15,0,0,1,0,1,1,1,0,0,0
Kenny,160,1,21,2018-08-25T14:00:00Z,False,7,1,0,0,4,3,1,6,3,3,-2,-2
Kenny,160,1,35,2018-09-01T14:00:00Z,True,7,9,0,0,5,3,2,1,1,0,4,3
Kenny,160,1,42,2018-09-16T15:00:00Z,True,7,18,90,4,6,4,2,0,0,0,6,4
Kenny,160,1,50,2018-09-23T15:00:00Z,False,7,0,90,1,6,4,2,9,3,6,-3,-1
Kenny,160,1,64,2018-09-29T14:00:00Z,True,7,8,90,6,6,4,2,5,4,1,1,3
Kenny,160,1,74,2018-10-06T14:00:00Z,False,7,10,90,2,9,7,2,12,6,6,-3,-4
Kenny,160,1,84,2018-10-21T15:00:00Z,True,7,6,0,0,12,7,5,7,1,6,5,1
Kenny,160,1,96,2018-10-28T16:00:00Z,False,7,13,0,0,15,10,5,14,7,7,1,-2
Kenny,160,1,104,2018-11-03T15:00:00Z,True,7,2,0,0,15,10,5,14,10,4,1,6
Kenny,160,1,112,2018-11-11T14:15:00Z,False,7,5,0,0,18,13,5,27,14,13,-9,-9
Kenny,160,1,123,2018-11-24T15:00:00Z,True,7,4,0,0,19,13,6,8,7,1,11,12
Kenny,160,1,136,2018-12-02T16:15:00Z,False,7,11,0,0,22,16,6,33,16,17,-11,-10
Kenny,160,1,148,2018-12-05T19:45:00Z,True,7,14,0,0,22,16,6,12,6,6,10,10
Kenny,160,1,155,2018-12-10T20:00:00Z,True,7,17,0,0,23,17,6,20,12,8,3,9
Kenny,160,1,165,2018-12-15T12:30:00Z,False,7,12,0,0,24,18,6,41,24,17,-17,-18
Kenny,160,1,174,2018-12-23T16:00:00Z,True,7,16,0,0,24,18,6,39,15,24,-15,-6
Kenny,160,1,181,2018-12-26T15:00:00Z,False,7,3,0,0,24,18,6,12,7,5,12,-1
Kenny,160,1,190,2018-12-29T15:00:00Z,False,7,2,0,0,27,18,9,22,15,7,5,-6
Kenny,160,1,204,2019-01-01T12:30:00Z,True,7,10,90,2,27,18,9,28,14,14,-1,4
Kenny,160,1,215,2019-01-13T14:15:00Z,True,7,1,0,0,27,18,9,27,18,9,0,9
Kenny,160,1,227,2019-01-19T15:00:00Z,False,7,15,0,0,30,21,9,19,8,11,11,1
Kenny,160,1,233,2019-01-29T19:45:00Z,False,7,9,20,1,30,21,9,11,5,6,19,4
Kenny,160,1,245,2019-02-02T15:00:00Z,True,7,19,53,0,33,21,12,35,20,15,-2,6
Kenny,160,1,265,2019-02-06T19:45:00Z,True,7,12,90,1,33,21,12,59,36,23,-26,-2
Kenny,160,1,258,2019-02-09T15:00:00Z,False,7,17,90,2,33,21,12,34,17,17,-1,-5
Kenny,160,1,271,2019-02-26T19:45:00Z,False,7,4,0,0,33,21,12,25,17,8,8,-5
Kenny,160,1,283,2019-03-03T16:15:00Z,True,7,11,0,0,36,21,15,69,38,31,-33,-10
Kenny,160,1,298,2019-03-09T15:00:00Z,False,7,14,86,0,37,22,15,31,19,12,6,-4
Kenny,160,1,303,2019-03-17T16:30:00Z,True,7,5,0,0,37,22,15,57,32,25,-20,-3
Kenny,160,1,319,2019-03-30T17:30:00Z,False,7,18,0,0,40,25,15,42,27,15,-2,-12
Kenny,160,1,322,2019-04-07T13:05:00Z,True,7,0,0,0,43,25,18,63,44,19,-20,6
Kenny,160,1,333,2019-04-13T14:00:00Z,False,7,8,0,0,46,28,18,17,15,2,29,3
Kenny,160,1,344,2019-04-21T12:30:00Z,True,7,13,0,0,46,28,18,64,35,29,-18,-1
Kenny,160,1,352,2019-04-27T14:00:00Z,False,7,6,0,0,49,31,18,42,16,26,7,2
Kenny,160,1,364,2019-05-03T19:00:00Z,True,7,3,0,0,50,31,19,40,23,17,10,14
Kenny,160,1,378,2019-05-12T14:00:00Z,False,7,16,0,0,53,34,19,70,37,33,-17,-18
Keane,161,1,9,2018-08-11T16:30:00Z,False,7,19,90,5,0,0,0,0,0,0,0,0
Keane,161,1,15,2018-08-18T14:00:00Z,True,7,15,90,2,1,0,1,1,1,0,0,0
Keane,161,1,21,2018-08-25T14:00:00Z,False,7,1,90,10,4,3,1,6,3,3,-2,-2
Keane,161,1,35,2018-09-01T14:00:00Z,True,7,9,0,0,5,3,2,1,1,0,4,3
Keane,161,1,42,2018-09-16T15:00:00Z,True,7,18,0,0,6,4,2,0,0,0,6,4
Keane,161,1,50,2018-09-23T15:00:00Z,False,7,0,90,1,6,4,2,9,3,6,-3,-1
Keane,161,1,64,2018-09-29T14:00:00Z,True,7,8,90,8,6,4,2,5,4,1,1,3
Keane,161,1,74,2018-10-06T14:00:00Z,False,7,10,90,2,9,7,2,12,6,6,-3,-4
Keane,161,1,84,2018-10-21T15:00:00Z,True,7,6,90,11,12,7,5,7,1,6,5,1
Keane,161,1,96,2018-10-28T16:00:00Z,False,7,13,90,1,15,10,5,14,7,7,1,-2
Keane,161,1,104,2018-11-03T15:00:00Z,True,7,2,90,2,15,10,5,14,10,4,1,6
Keane,161,1,112,2018-11-11T14:15:00Z,False,7,5,90,7,18,13,5,27,14,13,-9,-9
Keane,161,1,123,2018-11-24T15:00:00Z,True,7,4,90,8,19,13,6,8,7,1,11,12
Keane,161,1,136,2018-12-02T16:15:00Z,False,7,11,90,2,22,16,6,33,16,17,-11,-10
Keane,161,1,148,2018-12-05T19:45:00Z,True,7,14,0,0,22,16,6,12,6,6,10,10
Keane,161,1,155,2018-12-10T20:00:00Z,True,7,17,90,1,23,17,6,20,12,8,3,9
Keane,161,1,165,2018-12-15T12:30:00Z,False,7,12,90,1,24,18,6,41,24,17,-17,-18
Keane,161,1,174,2018-12-23T16:00:00Z,True,7,16,90,-1,24,18,6,39,15,24,-15,-6
Keane,161,1,181,2018-12-26T15:00:00Z,False,7,3,90,2,24,18,6,12,7,5,12,-1
Keane,161,1,190,2018-12-29T15:00:00Z,False,7,2,90,2,27,18,9,22,15,7,5,-6
Keane,161,1,204,2019-01-01T12:30:00Z,True,7,10,90,2,27,18,9,28,14,14,-1,4
Keane,161,1,215,2019-01-13T14:15:00Z,True,7,1,90,5,27,18,9,27,18,9,0,9
Keane,161,1,227,2019-01-19T15:00:00Z,False,7,15,90,1,30,21,9,19,8,11,11,1
Keane,161,1,233,2019-01-29T19:45:00Z,False,7,9,90,9,30,21,9,11,5,6,19,4
Keane,161,1,245,2019-02-02T15:00:00Z,True,7,19,90,0,33,21,12,35,20,15,-2,6
Keane,161,1,265,2019-02-06T19:45:00Z,True,7,12,90,1,33,21,12,59,36,23,-26,-2
Keane,161,1,258,2019-02-09T15:00:00Z,False,7,17,90,2,33,21,12,34,17,17,-1,-5
Keane,161,1,271,2019-02-26T19:45:00Z,False,7,4,90,6,33,21,12,25,17,8,8,-5
Keane,161,1,283,2019-03-03T16:15:00Z,True,7,11,90,6,36,21,15,69,38,31,-33,-10
Keane,161,1,298,2019-03-09T15:00:00Z,False,7,14,90,1,37,22,15,31,19,12,6,-4
Keane,161,1,303,2019-03-17T16:30:00Z,True,7,5,90,6,37,22,15,57,32,25,-20,-3
Keane,161,1,319,2019-03-30T17:30:00Z,False,7,18,90,6,40,25,15,42,27,15,-2,-12
Keane,161,1,322,2019-04-07T13:05:00Z,True,7,0,0,0,43,25,18,63,44,19,-20,6
Keane,161,1,333,2019-04-13T14:00:00Z,False,7,8,0,0,46,28,18,17,15,2,29,3
Keane,161,1,344,2019-04-21T12:30:00Z,True,7,13,90,6,46,28,18,64,35,29,-18,-1
Keane,161,1,352,2019-04-27T14:00:00Z,False,7,6,90,7,49,31,18,42,16,26,7,2
Keane,161,1,364,2019-05-03T19:00:00Z,True,7,3,90,6,50,31,19,40,23,17,10,14
Keane,161,1,378,2019-05-12T14:00:00Z,False,7,16,90,1,53,34,19,70,37,33,-17,-18
Martina,162,1,9,2018-08-11T16:30:00Z,False,7,19,0,0,0,0,0,0,0,0,0,0
Martina,162,1,15,2018-08-18T14:00:00Z,True,7,15,0,0,1,0,1,1,1,0,0,0
Martina,162,1,21,2018-08-25T14:00:00Z,False,7,1,0,0,4,3,1,6,3,3,-2,-2
Martina,162,1,35,2018-09-01T14:00:00Z,True,7,9,0,0,5,3,2,1,1,0,4,3
Martina,162,1,42,2018-09-16T15:00:00Z,True,7,18,0,0,6,4,2,0,0,0,6,4
Martina,162,1,50,2018-09-23T15:00:00Z,False,7,0,0,0,6,4,2,9,3,6,-3,-1
Martina,162,1,64,2018-09-29T14:00:00Z,True,7,8,0,0,6,4,2,5,4,1,1,3
Martina,162,1,74,2018-10-06T14:00:00Z,False,7,10,0,0,9,7,2,12,6,6,-3,-4
Martina,162,1,84,2018-10-21T15:00:00Z,True,7,6,0,0,12,7,5,7,1,6,5,1
Martina,162,1,96,2018-10-28T16:00:00Z,False,7,13,0,0,15,10,5,14,7,7,1,-2
Martina,162,1,104,2018-11-03T15:00:00Z,True,7,2,0,0,15,10,5,14,10,4,1,6
Martina,162,1,112,2018-11-11T14:15:00Z,False,7,5,0,0,18,13,5,27,14,13,-9,-9
Martina,162,1,123,2018-11-24T15:00:00Z,True,7,4,0,0,19,13,6,8,7,1,11,12
Martina,162,1,136,2018-12-02T16:15:00Z,False,7,11,0,0,22,16,6,33,16,17,-11,-10
Martina,162,1,148,2018-12-05T19:45:00Z,True,7,14,0,0,22,16,6,12,6,6,10,10
Martina,162,1,155,2018-12-10T20:00:00Z,True,7,17,0,0,23,17,6,20,12,8,3,9
Martina,162,1,165,2018-12-15T12:30:00Z,False,7,12,0,0,24,18,6,41,24,17,-17,-18
Martina,162,1,174,2018-12-23T16:00:00Z,True,7,16,0,0,24,18,6,39,15,24,-15,-6
Martina,162,1,181,2018-12-26T15:00:00Z,False,7,3,0,0,24,18,6,12,7,5,12,-1
Martina,162,1,190,2018-12-29T15:00:00Z,False,7,2,0,0,27,18,9,22,15,7,5,-6
Martina,162,1,204,2019-01-01T12:30:00Z,True,7,10,0,0,27,18,9,28,14,14,-1,4
Martina,162,1,215,2019-01-13T14:15:00Z,True,7,1,0,0,27,18,9,27,18,9,0,9
Martina,162,1,227,2019-01-19T15:00:00Z,False,7,15,0,0,30,21,9,19,8,11,11,1
Martina,162,1,233,2019-01-29T19:45:00Z,False,7,9,0,0,30,21,9,11,5,6,19,4
Martina,162,1,245,2019-02-02T15:00:00Z,True,7,19,0,0,33,21,12,35,20,15,-2,6
Martina,162,1,265,2019-02-06T19:45:00Z,True,7,12,0,0,33,21,12,59,36,23,-26,-2
Martina,162,1,258,2019-02-09T15:00:00Z,False,7,17,0,0,33,21,12,34,17,17,-1,-5
Martina,162,1,271,2019-02-26T19:45:00Z,False,7,4,0,0,33,21,12,25,17,8,8,-5
Martina,162,1,283,2019-03-03T16:15:00Z,True,7,11,0,0,36,21,15,69,38,31,-33,-10
Martina,162,1,298,2019-03-09T15:00:00Z,False,7,14,0,0,37,22,15,31,19,12,6,-4
Martina,162,1,303,2019-03-17T16:30:00Z,True,7,5,0,0,37,22,15,57,32,25,-20,-3
Martina,162,1,319,2019-03-30T17:30:00Z,False,7,18,0,0,40,25,15,42,27,15,-2,-12
Martina,162,1,322,2019-04-07T13:05:00Z,True,7,0,0,0,43,25,18,63,44,19,-20,6
Martina,162,1,333,2019-04-13T14:00:00Z,False,7,8,0,0,46,28,18,17,15,2,29,3
Martina,162,1,344,2019-04-21T12:30:00Z,True,7,13,0,0,46,28,18,64,35,29,-18,-1
Martina,162,1,352,2019-04-27T14:00:00Z,False,7,6,0,0,49,31,18,42,16,26,7,2
Martina,162,1,364,2019-05-03T19:00:00Z,True,7,3,0,0,50,31,19,40,23,17,10,14
Martina,162,1,378,2019-05-12T14:00:00Z,False,7,16,0,0,53,34,19,70,37,33,-17,-18
Walcott,163,2,9,2018-08-11T16:30:00Z,False,7,19,90,2,0,0,0,0,0,0,0,0
Walcott,163,2,15,2018-08-18T14:00:00Z,True,7,15,90,13,1,0,1,1,1,0,0,0
Walcott,163,2,21,2018-08-25T14:00:00Z,False,7,1,84,7,4,3,1,6,3,3,-2,-2
Walcott,163,2,35,2018-09-01T14:00:00Z,True,7,9,56,1,5,3,2,1,1,0,4,3
Walcott,163,2,42,2018-09-16T15:00:00Z,True,7,18,76,2,6,4,2,0,0,0,6,4
Walcott,163,2,50,2018-09-23T15:00:00Z,False,7,0,71,2,6,4,2,9,3,6,-3,-1
Walcott,163,2,64,2018-09-29T14:00:00Z,True,7,8,90,6,6,4,2,5,4,1,1,3
Walcott,163,2,74,2018-10-06T14:00:00Z,False,7,10,90,2,9,7,2,12,6,6,-3,-4
Walcott,163,2,84,2018-10-21T15:00:00Z,True,7,6,81,3,12,7,5,7,1,6,5,1
Walcott,163,2,96,2018-10-28T16:00:00Z,False,7,13,77,2,15,10,5,14,7,7,1,-2
Walcott,163,2,104,2018-11-03T15:00:00Z,True,7,2,84,2,15,10,5,14,10,4,1,6
Walcott,163,2,112,2018-11-11T14:15:00Z,False,7,5,90,3,18,13,5,27,14,13,-9,-9
Walcott,163,2,123,2018-11-24T15:00:00Z,True,7,4,72,6,19,13,6,8,7,1,11,12
Walcott,163,2,136,2018-12-02T16:15:00Z,False,7,11,62,3,22,16,6,33,16,17,-11,-10
Walcott,163,2,148,2018-12-05T19:45:00Z,True,7,14,20,1,22,16,6,12,6,6,10,10
Walcott,163,2,155,2018-12-10T20:00:00Z,True,7,17,65,2,23,17,6,20,12,8,3,9
Walcott,163,2,165,2018-12-15T12:30:00Z,False,7,12,33,1,24,18,6,41,24,17,-17,-18
Walcott,163,2,174,2018-12-23T16:00:00Z,True,7,16,90,8,24,18,6,39,15,24,-15,-6
Walcott,163,2,181,2018-12-26T15:00:00Z,False,7,3,90,2,24,18,6,12,7,5,12,-1
Walcott,163,2,190,2018-12-29T15:00:00Z,False,7,2,90,2,27,18,9,22,15,7,5,-6
Walcott,163,2,204,2019-01-01T12:30:00Z,True,7,10,69,2,27,18,9,28,14,14,-1,4
Walcott,163,2,215,2019-01-13T14:15:00Z,True,7,1,12,1,27,18,9,27,18,9,0,9
Walcott,163,2,227,2019-01-19T15:00:00Z,False,7,15,15,1,30,21,9,19,8,11,11,1
Walcott,163,2,233,2019-01-29T19:45:00Z,False,7,9,0,0,30,21,9,11,5,6,19,4
Walcott,163,2,245,2019-02-02T15:00:00Z,True,7,19,59,1,33,21,12,35,20,15,-2,6
Walcott,163,2,265,2019-02-06T19:45:00Z,True,7,12,79,2,33,21,12,59,36,23,-26,-2
Walcott,163,2,258,2019-02-09T15:00:00Z,False,7,17,27,1,33,21,12,34,17,17,-1,-5
Walcott,163,2,271,2019-02-26T19:45:00Z,False,7,4,81,3,33,21,12,25,17,8,8,-5
Walcott,163,2,283,2019-03-03T16:15:00Z,True,7,11,58,0,36,21,15,69,38,31,-33,-10
Walcott,163,2,298,2019-03-09T15:00:00Z,False,7,14,3,1,37,22,15,31,19,12,6,-4
Walcott,163,2,303,2019-03-17T16:30:00Z,True,7,5,12,1,37,22,15,57,32,25,-20,-3
Walcott,163,2,319,2019-03-30T17:30:00Z,False,7,18,1,1,40,25,15,42,27,15,-2,-12
Walcott,163,2,322,2019-04-07T13:05:00Z,True,7,0,11,1,43,25,18,63,44,19,-20,6
Walcott,163,2,333,2019-04-13T14:00:00Z,False,7,8,6,1,46,28,18,17,15,2,29,3
Walcott,163,2,344,2019-04-21T12:30:00Z,True,7,13,39,6,46,28,18,64,35,29,-18,-1
Walcott,163,2,352,2019-04-27T14:00:00Z,False,7,6,4,1,49,31,18,42,16,26,7,2
Walcott,163,2,364,2019-05-03T19:00:00Z,True,7,3,41,1,50,31,19,40,23,17,10,14
Walcott,163,2,378,2019-05-12T14:00:00Z,False,7,16,90,7,53,34,19,70,37,33,-17,-18
Bolasie,164,2,9,2018-08-11T16:30:00Z,False,7,19,0,0,0,0,0,0,0,0,0,0
Bolasie,164,2,15,2018-08-18T14:00:00Z,True,7,15,0,0,1,0,1,1,1,0,0,0
Bolasie,164,2,21,2018-08-25T14:00:00Z,False,7,1,0,0,4,3,1,6,3,3,-2,-2
Bolasie,164,2,35,2018-09-01T14:00:00Z,True,7,9,0,0,5,3,2,1,1,0,4,3
Bolasie,164,2,42,2018-09-16T15:00:00Z,True,7,18,0,0,6,4,2,0,0,0,6,4
Bolasie,164,2,50,2018-09-23T15:00:00Z,False,7,0,0,0,6,4,2,9,3,6,-3,-1
Bolasie,164,2,64,2018-09-29T14:00:00Z,True,7,8,0,0,6,4,2,5,4,1,1,3
Bolasie,164,2,74,2018-10-06T14:00:00Z,False,7,10,0,0,9,7,2,12,6,6,-3,-4
Bolasie,164,2,84,2018-10-21T15:00:00Z,True,7,6,0,0,12,7,5,7,1,6,5,1
Bolasie,164,2,96,2018-10-28T16:00:00Z,False,7,13,0,0,15,10,5,14,7,7,1,-2
Bolasie,164,2,104,2018-11-03T15:00:00Z,True,7,2,0,0,15,10,5,14,10,4,1,6
Bolasie,164,2,112,2018-11-11T14:15:00Z,False,7,5,0,0,18,13,5,27,14,13,-9,-9
Bolasie,164,2,123,2018-11-24T15:00:00Z,True,7,4,0,0,19,13,6,8,7,1,11,12
Bolasie,164,2,136,2018-12-02T16:15:00Z,False,7,11,0,0,22,16,6,33,16,17,-11,-10
Bolasie,164,2,148,2018-12-05T19:45:00Z,True,7,14,0,0,22,16,6,12,6,6,10,10
Bolasie,164,2,155,2018-12-10T20:00:00Z,True,7,17,0,0,23,17,6,20,12,8,3,9
Bolasie,164,2,165,2018-12-15T12:30:00Z,False,7,12,0,0,24,18,6,41,24,17,-17,-18
Bolasie,164,2,174,2018-12-23T16:00:00Z,True,7,16,0,0,24,18,6,39,15,24,-15,-6
Bolasie,164,2,181,2018-12-26T15:00:00Z,False,7,3,0,0,24,18,6,12,7,5,12,-1
Bolasie,164,2,190,2018-12-29T15:00:00Z,False,7,2,0,0,27,18,9,22,15,7,5,-6
Bolasie,164,2,204,2019-01-01T12:30:00Z,True,7,10,0,0,27,18,9,28,14,14,-1,4
Bolasie,164,2,215,2019-01-13T14:15:00Z,True,7,1,0,0,27,18,9,27,18,9,0,9
Bolasie,164,2,227,2019-01-19T15:00:00Z,False,7,15,0,0,30,21,9,19,8,11,11,1
Bolasie,164,2,233,2019-01-29T19:45:00Z,False,7,9,0,0,30,21,9,11,5,6,19,4
Bolasie,164,2,245,2019-02-02T15:00:00Z,True,7,19,0,0,33,21,12,35,20,15,-2,6
Bolasie,164,2,265,2019-02-06T19:45:00Z,True,7,12,0,0,33,21,12,59,36,23,-26,-2
Bolasie,164,2,258,2019-02-09T15:00:00Z,False,7,17,0,0,33,21,12,34,17,17,-1,-5
Bolasie,164,2,271,2019-02-26T19:45:00Z,False,7,4,0,0,33,21,12,25,17,8,8,-5
Bolasie,164,2,283,2019-03-03T16:15:00Z,True,7,11,0,0,36,21,15,69,38,31,-33,-10
Bolasie,164,2,298,2019-03-09T15:00:00Z,False,7,14,0,0,37,22,15,31,19,12,6,-4
Bolasie,164,2,303,2019-03-17T16:30:00Z,True,7,5,0,0,37,22,15,57,32,25,-20,-3
Bolasie,164,2,319,2019-03-30T17:30:00Z,False,7,18,0,0,40,25,15,42,27,15,-2,-12
Bolasie,164,2,322,2019-04-07T13:05:00Z,True,7,0,0,0,43,25,18,63,44,19,-20,6
Bolasie,164,2,333,2019-04-13T14:00:00Z,False,7,8,0,0,46,28,18,17,15,2,29,3
Bolasie,164,2,344,2019-04-21T12:30:00Z,True,7,13,0,0,46,28,18,64,35,29,-18,-1
Bolasie,164,2,352,2019-04-27T14:00:00Z,False,7,6,0,0,49,31,18,42,16,26,7,2
Bolasie,164,2,364,2019-05-03T19:00:00Z,True,7,3,0,0,50,31,19,40,23,17,10,14
Bolasie,164,2,378,2019-05-12T14:00:00Z,False,7,16,0,0,53,34,19,70,37,33,-17,-18
McCarthy,165,2,9,2018-08-11T16:30:00Z,False,7,19,0,0,0,0,0,0,0,0,0,0
McCarthy,165,2,15,2018-08-18T14:00:00Z,True,7,15,0,0,1,0,1,1,1,0,0,0
McCarthy,165,2,21,2018-08-25T14:00:00Z,False,7,1,0,0,4,3,1,6,3,3,-2,-2
McCarthy,165,2,35,2018-09-01T14:00:00Z,True,7,9,0,0,5,3,2,1,1,0,4,3
McCarthy,165,2,42,2018-09-16T15:00:00Z,True,7,18,0,0,6,4,2,0,0,0,6,4
McCarthy,165,2,50,2018-09-23T15:00:00Z,False,7,0,0,0,6,4,2,9,3,6,-3,-1
McCarthy,165,2,64,2018-09-29T14:00:00Z,True,7,8,0,0,6,4,2,5,4,1,1,3
McCarthy,165,2,74,2018-10-06T14:00:00Z,False,7,10,0,0,9,7,2,12,6,6,-3,-4
McCarthy,165,2,84,2018-10-21T15:00:00Z,True,7,6,0,0,12,7,5,7,1,6,5,1
McCarthy,165,2,96,2018-10-28T16:00:00Z,False,7,13,0,0,15,10,5,14,7,7,1,-2
McCarthy,165,2,104,2018-11-03T15:00:00Z,True,7,2,0,0,15,10,5,14,10,4,1,6
McCarthy,165,2,112,2018-11-11T14:15:00Z,False,7,5,0,0,18,13,5,27,14,13,-9,-9
McCarthy,165,2,123,2018-11-24T15:00:00Z,True,7,4,0,0,19,13,6,8,7,1,11,12
McCarthy,165,2,136,2018-12-02T16:15:00Z,False,7,11,0,0,22,16,6,33,16,17,-11,-10
McCarthy,165,2,148,2018-12-05T19:45:00Z,True,7,14,0,0,22,16,6,12,6,6,10,10
McCarthy,165,2,155,2018-12-10T20:00:00Z,True,7,17,0,0,23,17,6,20,12,8,3,9
McCarthy,165,2,165,2018-12-15T12:30:00Z,False,7,12,0,0,24,18,6,41,24,17,-17,-18
McCarthy,165,2,174,2018-12-23T16:00:00Z,True,7,16,0,0,24,18,6,39,15,24,-15,-6
McCarthy,165,2,181,2018-12-26T15:00:00Z,False,7,3,0,0,24,18,6,12,7,5,12,-1
McCarthy,165,2,190,2018-12-29T15:00:00Z,False,7,2,0,0,27,18,9,22,15,7,5,-6
McCarthy,165,2,204,2019-01-01T12:30:00Z,True,7,10,0,0,27,18,9,28,14,14,-1,4
McCarthy,165,2,215,2019-01-13T14:15:00Z,True,7,1,0,0,27,18,9,27,18,9,0,9
McCarthy,165,2,227,2019-01-19T15:00:00Z,False,7,15,0,0,30,21,9,19,8,11,11,1
McCarthy,165,2,233,2019-01-29T19:45:00Z,False,7,9,0,0,30,21,9,11,5,6,19,4
McCarthy,165,2,245,2019-02-02T15:00:00Z,True,7,19,0,0,33,21,12,35,20,15,-2,6
McCarthy,165,2,265,2019-02-06T19:45:00Z,True,7,12,0,0,33,21,12,59,36,23,-26,-2
McCarthy,165,2,258,2019-02-09T15:00:00Z,False,7,17,0,0,33,21,12,34,17,17,-1,-5
McCarthy,165,2,271,2019-02-26T19:45:00Z,False,7,4,0,0,33,21,12,25,17,8,8,-5
McCarthy,165,2,283,2019-03-03T16:15:00Z,True,7,11,0,0,36,21,15,69,38,31,-33,-10
McCarthy,165,2,298,2019-03-09T15:00:00Z,False,7,14,0,0,37,22,15,31,19,12,6,-4
McCarthy,165,2,303,2019-03-17T16:30:00Z,True,7,5,0,0,37,22,15,57,32,25,-20,-3
McCarthy,165,2,319,2019-03-30T17:30:00Z,False,7,18,0,0,40,25,15,42,27,15,-2,-12
McCarthy,165,2,322,2019-04-07T13:05:00Z,True,7,0,0,0,43,25,18,63,44,19,-20,6
McCarthy,165,2,333,2019-04-13T14:00:00Z,False,7,8,0,0,46,28,18,17,15,2,29,3
McCarthy,165,2,344,2019-04-21T12:30:00Z,True,7,13,14,1,46,28,18,64,35,29,-18,-1
McCarthy,165,2,352,2019-04-27T14:00:00Z,False,7,6,0,0,49,31,18,42,16,26,7,2
McCarthy,165,2,364,2019-05-03T19:00:00Z,True,7,3,0,0,50,31,19,40,23,17,10,14
McCarthy,165,2,378,2019-05-12T14:00:00Z,False,7,16,0,0,53,34,19,70,37,33,-17,-18
Schneiderlin,166,2,9,2018-08-11T16:30:00Z,False,7,19,90,2,0,0,0,0,0,0,0,0
Schneiderlin,166,2,15,2018-08-18T14:00:00Z,True,7,15,23,4,1,0,1,1,1,0,0,0
Schneiderlin,166,2,21,2018-08-25T14:00:00Z,False,7,1,0,0,4,3,1,6,3,3,-2,-2
Schneiderlin,166,2,35,2018-09-01T14:00:00Z,True,7,9,90,1,5,3,2,1,1,0,4,3
Schneiderlin,166,2,42,2018-09-16T15:00:00Z,True,7,18,43,1,6,4,2,0,0,0,6,4
Schneiderlin,166,2,50,2018-09-23T15:00:00Z,False,7,0,0,0,6,4,2,9,3,6,-3,-1
Schneiderlin,166,2,64,2018-09-29T14:00:00Z,True,7,8,1,1,6,4,2,5,4,1,1,3
Schneiderlin,166,2,74,2018-10-06T14:00:00Z,False,7,10,1,1,9,7,2,12,6,6,-3,-4
Schneiderlin,166,2,84,2018-10-21T15:00:00Z,True,7,6,0,0,12,7,5,7,1,6,5,1
Schneiderlin,166,2,96,2018-10-28T16:00:00Z,False,7,13,0,0,15,10,5,14,7,7,1,-2
Schneiderlin,166,2,104,2018-11-03T15:00:00Z,True,7,2,0,0,15,10,5,14,10,4,1,6
Schneiderlin,166,2,112,2018-11-11T14:15:00Z,False,7,5,0,0,18,13,5,27,14,13,-9,-9
Schneiderlin,166,2,123,2018-11-24T15:00:00Z,True,7,4,0,0,19,13,6,8,7,1,11,12
Schneiderlin,166,2,136,2018-12-02T16:15:00Z,False,7,11,0,0,22,16,6,33,16,17,-11,-10
Schneiderlin,166,2,148,2018-12-05T19:45:00Z,True,7,14,0,0,22,16,6,12,6,6,10,10
Schneiderlin,166,2,155,2018-12-10T20:00:00Z,True,7,17,0,0,23,17,6,20,12,8,3,9
Schneiderlin,166,2,165,2018-12-15T12:30:00Z,False,7,12,0,0,24,18,6,41,24,17,-17,-18
Schneiderlin,166,2,174,2018-12-23T16:00:00Z,True,7,16,37,1,24,18,6,39,15,24,-15,-6
Schneiderlin,166,2,181,2018-12-26T15:00:00Z,False,7,3,0,0,24,18,6,12,7,5,12,-1
Schneiderlin,166,2,190,2018-12-29T15:00:00Z,False,7,2,0,0,27,18,9,22,15,7,5,-6
Schneiderlin,166,2,204,2019-01-01T12:30:00Z,True,7,10,0,0,27,18,9,28,14,14,-1,4
Schneiderlin,166,2,215,2019-01-13T14:15:00Z,True,7,1,0,0,27,18,9,27,18,9,0,9
Schneiderlin,166,2,227,2019-01-19T15:00:00Z,False,7,15,0,0,30,21,9,19,8,11,11,1
Schneiderlin,166,2,233,2019-01-29T19:45:00Z,False,7,9,0,0,30,21,9,11,5,6,19,4
Schneiderlin,166,2,245,2019-02-02T15:00:00Z,True,7,19,0,0,33,21,12,35,20,15,-2,6
Schneiderlin,166,2,265,2019-02-06T19:45:00Z,True,7,12,0,0,33,21,12,59,36,23,-26,-2
Schneiderlin,166,2,258,2019-02-09T15:00:00Z,False,7,17,0,0,33,21,12,34,17,17,-1,-5
Schneiderlin,166,2,271,2019-02-26T19:45:00Z,False,7,4,90,3,33,21,12,25,17,8,8,-5
Schneiderlin,166,2,283,2019-03-03T16:15:00Z,True,7,11,75,3,36,21,15,69,38,31,-33,-10
Schneiderlin,166,2,298,2019-03-09T15:00:00Z,False,7,14,0,0,37,22,15,31,19,12,6,-4
Schneiderlin,166,2,303,2019-03-17T16:30:00Z,True,7,5,22,1,37,22,15,57,32,25,-20,-3
Schneiderlin,166,2,319,2019-03-30T17:30:00Z,False,7,18,0,0,40,25,15,42,27,15,-2,-12
Schneiderlin,166,2,322,2019-04-07T13:05:00Z,True,7,0,0,0,43,25,18,63,44,19,-20,6
Schneiderlin,166,2,333,2019-04-13T14:00:00Z,False,7,8,0,0,46,28,18,17,15,2,29,3
Schneiderlin,166,2,344,2019-04-21T12:30:00Z,True,7,13,90,3,46,28,18,64,35,29,-18,-1
Schneiderlin,166,2,352,2019-04-27T14:00:00Z,False,7,6,90,3,49,31,18,42,16,26,7,2
Schneiderlin,166,2,364,2019-05-03T19:00:00Z,True,7,3,90,3,50,31,19,40,23,17,10,14
Schneiderlin,166,2,378,2019-05-12T14:00:00Z,False,7,16,90,1,53,34,19,70,37,33,-17,-18
Gueye,167,2,9,2018-08-11T16:30:00Z,False,7,19,90,2,0,0,0,0,0,0,0,0
Gueye,167,2,15,2018-08-18T14:00:00Z,True,7,15,90,2,1,0,1,1,1,0,0,0
Gueye,167,2,21,2018-08-25T14:00:00Z,False,7,1,90,1,4,3,1,6,3,3,-2,-2
Gueye,167,2,35,2018-09-01T14:00:00Z,True,7,9,0,0,5,3,2,1,1,0,4,3
Gueye,167,2,42,2018-09-16T15:00:00Z,True,7,18,90,2,6,4,2,0,0,0,6,4
Gueye,167,2,50,2018-09-23T15:00:00Z,False,7,0,90,2,6,4,2,9,3,6,-3,-1
Gueye,167,2,64,2018-09-29T14:00:00Z,True,7,8,90,3,6,4,2,5,4,1,1,3
Gueye,167,2,74,2018-10-06T14:00:00Z,False,7,10,90,2,9,7,2,12,6,6,-3,-4
Gueye,167,2,84,2018-10-21T15:00:00Z,True,7,6,90,2,12,7,5,7,1,6,5,1
Gueye,167,2,96,2018-10-28T16:00:00Z,False,7,13,77,1,15,10,5,14,7,7,1,-2
Gueye,167,2,104,2018-11-03T15:00:00Z,True,7,2,90,2,15,10,5,14,10,4,1,6
Gueye,167,2,112,2018-11-11T14:15:00Z,False,7,5,90,3,18,13,5,27,14,13,-9,-9
Gueye,167,2,123,2018-11-24T15:00:00Z,True,7,4,90,3,19,13,6,8,7,1,11,12
Gueye,167,2,136,2018-12-02T16:15:00Z,False,7,11,90,2,22,16,6,33,16,17,-11,-10
Gueye,167,2,148,2018-12-05T19:45:00Z,True,7,14,90,2,22,16,6,12,6,6,10,10
Gueye,167,2,155,2018-12-10T20:00:00Z,True,7,17,70,2,23,17,6,20,12,8,3,9
Gueye,167,2,165,2018-12-15T12:30:00Z,False,7,12,0,0,24,18,6,41,24,17,-17,-18
Gueye,167,2,174,2018-12-23T16:00:00Z,True,7,16,0,0,24,18,6,39,15,24,-15,-6
Gueye,167,2,181,2018-12-26T15:00:00Z,False,7,3,15,0,24,18,6,12,7,5,12,-1
Gueye,167,2,190,2018-12-29T15:00:00Z,False,7,2,90,2,27,18,9,22,15,7,5,-6
Gueye,167,2,204,2019-01-01T12:30:00Z,True,7,10,90,2,27,18,9,28,14,14,-1,4
Gueye,167,2,215,2019-01-13T14:15:00Z,True,7,1,90,3,27,18,9,27,18,9,0,9
Gueye,167,2,227,2019-01-19T15:00:00Z,False,7,15,90,1,30,21,9,19,8,11,11,1
Gueye,167,2,233,2019-01-29T19:45:00Z,False,7,9,0,0,30,21,9,11,5,6,19,4
Gueye,167,2,245,2019-02-02T15:00:00Z,True,7,19,0,0,33,21,12,35,20,15,-2,6
Gueye,167,2,265,2019-02-06T19:45:00Z,True,7,12,90,2,33,21,12,59,36,23,-26,-2
Gueye,167,2,258,2019-02-09T15:00:00Z,False,7,17,90,2,33,21,12,34,17,17,-1,-5
Gueye,167,2,271,2019-02-26T19:45:00Z,False,7,4,90,6,33,21,12,25,17,8,8,-5
Gueye,167,2,283,2019-03-03T16:15:00Z,True,7,11,90,3,36,21,15,69,38,31,-33,-10
Gueye,167,2,298,2019-03-09T15:00:00Z,False,7,14,90,2,37,22,15,31,19,12,6,-4
Gueye,167,2,303,2019-03-17T16:30:00Z,True,7,5,90,3,37,22,15,57,32,25,-20,-3
Gueye,167,2,319,2019-03-30T17:30:00Z,False,7,18,90,3,40,25,15,42,27,15,-2,-12
Gueye,167,2,322,2019-04-07T13:05:00Z,True,7,0,90,3,43,25,18,63,44,19,-20,6
Gueye,167,2,333,2019-04-13T14:00:00Z,False,7,8,90,2,46,28,18,17,15,2,29,3
Gueye,167,2,344,2019-04-21T12:30:00Z,True,7,13,75,5,46,28,18,64,35,29,-18,-1
Gueye,167,2,352,2019-04-27T14:00:00Z,False,7,6,90,3,49,31,18,42,16,26,7,2
Gueye,167,2,364,2019-05-03T19:00:00Z,True,7,3,90,3,50,31,19,40,23,17,10,14
Gueye,167,2,378,2019-05-12T14:00:00Z,False,7,16,64,2,53,34,19,70,37,33,-17,-18
Davies,168,2,9,2018-08-11T16:30:00Z,False,7,19,0,0,0,0,0,0,0,0,0,0
Davies,168,2,15,2018-08-18T14:00:00Z,True,7,15,66,2,1,0,1,1,1,0,0,0
Davies,168,2,21,2018-08-25T14:00:00Z,False,7,1,90,2,4,3,1,6,3,3,-2,-2
Davies,168,2,35,2018-09-01T14:00:00Z,True,7,9,90,1,5,3,2,1,1,0,4,3
Davies,168,2,42,2018-09-16T15:00:00Z,True,7,18,0,0,6,4,2,0,0,0,6,4
Davies,168,2,50,2018-09-23T15:00:00Z,False,7,0,90,2,6,4,2,9,3,6,-3,-1
Davies,168,2,64,2018-09-29T14:00:00Z,True,7,8,90,3,6,4,2,5,4,1,1,3
Davies,168,2,74,2018-10-06T14:00:00Z,False,7,10,70,1,9,7,2,12,6,6,-3,-4
Davies,168,2,84,2018-10-21T15:00:00Z,True,7,6,0,0,12,7,5,7,1,6,5,1
Davies,168,2,96,2018-10-28T16:00:00Z,False,7,13,0,0,15,10,5,14,7,7,1,-2
Davies,168,2,104,2018-11-03T15:00:00Z,True,7,2,0,0,15,10,5,14,10,4,1,6
Davies,168,2,112,2018-11-11T14:15:00Z,False,7,5,0,0,18,13,5,27,14,13,-9,-9
Davies,168,2,123,2018-11-24T15:00:00Z,True,7,4,0,0,19,13,6,8,7,1,11,12
Davies,168,2,136,2018-12-02T16:15:00Z,False,7,11,0,0,22,16,6,33,16,17,-11,-10
Davies,168,2,148,2018-12-05T19:45:00Z,True,7,14,0,0,22,16,6,12,6,6,10,10
Davies,168,2,155,2018-12-10T20:00:00Z,True,7,17,0,0,23,17,6,20,12,8,3,9
Davies,168,2,165,2018-12-15T12:30:00Z,False,7,12,9,1,24,18,6,41,24,17,-17,-18
Davies,168,2,174,2018-12-23T16:00:00Z,True,7,16,90,2,24,18,6,39,15,24,-15,-6
Davies,168,2,181,2018-12-26T15:00:00Z,False,7,3,10,1,24,18,6,12,7,5,12,-1
Davies,168,2,190,2018-12-29T15:00:00Z,False,7,2,0,0,27,18,9,22,15,7,5,-6
Davies,168,2,204,2019-01-01T12:30:00Z,True,7,10,0,0,27,18,9,28,14,14,-1,4
Davies,168,2,215,2019-01-13T14:15:00Z,True,7,1,0,0,27,18,9,27,18,9,0,9
Davies,168,2,227,2019-01-19T15:00:00Z,False,7,15,0,0,30,21,9,19,8,11,11,1
Davies,168,2,233,2019-01-29T19:45:00Z,False,7,9,90,3,30,21,9,11,5,6,19,4
Davies,168,2,245,2019-02-02T15:00:00Z,True,7,19,90,1,33,21,12,35,20,15,-2,6
Davies,168,2,265,2019-02-06T19:45:00Z,True,7,12,90,2,33,21,12,59,36,23,-26,-2
Davies,168,2,258,2019-02-09T15:00:00Z,False,7,17,90,2,33,21,12,34,17,17,-1,-5
Davies,168,2,271,2019-02-26T19:45:00Z,False,7,4,0,0,33,21,12,25,17,8,8,-5
Davies,168,2,283,2019-03-03T16:15:00Z,True,7,11,0,0,36,21,15,69,38,31,-33,-10
Davies,168,2,298,2019-03-09T15:00:00Z,False,7,14,0,0,37,22,15,31,19,12,6,-4
Davies,168,2,303,2019-03-17T16:30:00Z,True,7,5,4,1,37,22,15,57,32,25,-20,-3
Davies,168,2,319,2019-03-30T17:30:00Z,False,7,18,5,1,40,25,15,42,27,15,-2,-12
Davies,168,2,322,2019-04-07T13:05:00Z,True,7,0,1,1,43,25,18,63,44,19,-20,6
Davies,168,2,333,2019-04-13T14:00:00Z,False,7,8,0,0,46,28,18,17,15,2,29,3
Davies,168,2,344,2019-04-21T12:30:00Z,True,7,13,0,0,46,28,18,64,35,29,-18,-1
Davies,168,2,352,2019-04-27T14:00:00Z,False,7,6,0,0,49,31,18,42,16,26,7,2
Davies,168,2,364,2019-05-03T19:00:00Z,True,7,3,0,0,50,31,19,40,23,17,10,14
Davies,168,2,378,2019-05-12T14:00:00Z,False,7,16,0,0,53,34,19,70,37,33,-17,-18
Lookman,169,2,9,2018-08-11T16:30:00Z,False,7,19,0,0,0,0,0,0,0,0,0,0
Lookman,169,2,15,2018-08-18T14:00:00Z,True,7,15,0,0,1,0,1,1,1,0,0,0
Lookman,169,2,21,2018-08-25T14:00:00Z,False,7,1,0,0,4,3,1,6,3,3,-2,-2
Lookman,169,2,35,2018-09-01T14:00:00Z,True,7,9,33,1,5,3,2,1,1,0,4,3
Lookman,169,2,42,2018-09-16T15:00:00Z,True,7,18,13,1,6,4,2,0,0,0,6,4
Lookman,169,2,50,2018-09-23T15:00:00Z,False,7,0,0,0,6,4,2,9,3,6,-3,-1
Lookman,169,2,64,2018-09-29T14:00:00Z,True,7,8,0,0,6,4,2,5,4,1,1,3
Lookman,169,2,74,2018-10-06T14:00:00Z,False,7,10,0,0,9,7,2,12,6,6,-3,-4
Lookman,169,2,84,2018-10-21T15:00:00Z,True,7,6,8,4,12,7,5,7,1,6,5,1
Lookman,169,2,96,2018-10-28T16:00:00Z,False,7,13,28,1,15,10,5,14,7,7,1,-2
Lookman,169,2,104,2018-11-03T15:00:00Z,True,7,2,22,1,15,10,5,14,10,4,1,6
Lookman,169,2,112,2018-11-11T14:15:00Z,False,7,5,26,1,18,13,5,27,14,13,-9,-9
Lookman,169,2,123,2018-11-24T15:00:00Z,True,7,4,17,1,19,13,6,8,7,1,11,12
Lookman,169,2,136,2018-12-02T16:15:00Z,False,7,11,27,1,22,16,6,33,16,17,-11,-10
Lookman,169,2,148,2018-12-05T19:45:00Z,True,7,14,77,2,22,16,6,12,6,6,10,10
Lookman,169,2,155,2018-12-10T20:00:00Z,True,7,17,24,1,23,17,6,20,12,8,3,9
Lookman,169,2,165,2018-12-15T12:30:00Z,False,7,12,33,1,24,18,6,41,24,17,-17,-18
Lookman,169,2,174,2018-12-23T16:00:00Z,True,7,16,0,0,24,18,6,39,15,24,-15,-6
Lookman,169,2,181,2018-12-26T15:00:00Z,False,7,3,0,0,24,18,6,12,7,5,12,-1
Lookman,169,2,190,2018-12-29T15:00:00Z,False,7,2,0,0,27,18,9,22,15,7,5,-6
Lookman,169,2,204,2019-01-01T12:30:00Z,True,7,10,0,0,27,18,9,28,14,14,-1,4
Lookman,169,2,215,2019-01-13T14:15:00Z,True,7,1,90,6,27,18,9,27,18,9,0,9
Lookman,169,2,227,2019-01-19T15:00:00Z,False,7,15,90,2,30,21,9,19,8,11,11,1
Lookman,169,2,233,2019-01-29T19:45:00Z,False,7,9,0,0,30,21,9,11,5,6,19,4
Lookman,169,2,245,2019-02-02T15:00:00Z,True,7,19,30,1,33,21,12,35,20,15,-2,6
Lookman,169,2,265,2019-02-06T19:45:00Z,True,7,12,0,0,33,21,12,59,36,23,-26,-2
Lookman,169,2,258,2019-02-09T15:00:00Z,False,7,17,0,0,33,21,12,34,17,17,-1,-5
Lookman,169,2,271,2019-02-26T19:45:00Z,False,7,4,8,1,33,21,12,25,17,8,8,-5
Lookman,169,2,283,2019-03-03T16:15:00Z,True,7,11,0,0,36,21,15,69,38,31,-33,-10
Lookman,169,2,298,2019-03-09T15:00:00Z,False,7,14,8,1,37,22,15,31,19,12,6,-4
Lookman,169,2,303,2019-03-17T16:30:00Z,True,7,5,0,0,37,22,15,57,32,25,-20,-3
Lookman,169,2,319,2019-03-30T17:30:00Z,False,7,18,0,0,40,25,15,42,27,15,-2,-12
Lookman,169,2,322,2019-04-07T13:05:00Z,True,7,0,2,1,43,25,18,63,44,19,-20,6
Lookman,169,2,333,2019-04-13T14:00:00Z,False,7,8,16,1,46,28,18,17,15,2,29,3
Lookman,169,2,344,2019-04-21T12:30:00Z,True,7,13,0,0,46,28,18,64,35,29,-18,-1
Lookman,169,2,352,2019-04-27T14:00:00Z,False,7,6,6,1,49,31,18,42,16,26,7,2
Lookman,169,2,364,2019-05-03T19:00:00Z,True,7,3,17,1,50,31,19,40,23,17,10,14
Lookman,169,2,378,2019-05-12T14:00:00Z,False,7,16,25,4,53,34,19,70,37,33,-17,-18
Klaassen,170,2,9,2018-08-11T16:30:00Z,False,7,19,0,0,0,0,0,0,0,0,0,0
Klaassen,170,2,15,2018-08-18T14:00:00Z,True,7,15,0,0,1,0,1,1,1,0,0,0
Klaassen,170,2,21,2018-08-25T14:00:00Z,False,7,1,0,0,4,3,1,6,3,3,-2,-2
Klaassen,170,2,35,2018-09-01T14:00:00Z,True,7,9,0,0,5,3,2,1,1,0,4,3
Klaassen,170,2,42,2018-09-16T15:00:00Z,True,7,18,0,0,6,4,2,0,0,0,6,4
Klaassen,170,2,50,2018-09-23T15:00:00Z,False,7,0,0,0,6,4,2,9,3,6,-3,-1
Klaassen,170,2,64,2018-09-29T14:00:00Z,True,7,8,0,0,6,4,2,5,4,1,1,3
Klaassen,170,2,74,2018-10-06T14:00:00Z,False,7,10,0,0,9,7,2,12,6,6,-3,-4
Klaassen,170,2,84,2018-10-21T15:00:00Z,True,7,6,0,0,12,7,5,7,1,6,5,1
Klaassen,170,2,96,2018-10-28T16:00:00Z,False,7,13,0,0,15,10,5,14,7,7,1,-2
Klaassen,170,2,104,2018-11-03T15:00:00Z,True,7,2,0,0,15,10,5,14,10,4,1,6
Klaassen,170,2,112,2018-11-11T14:15:00Z,False,7,5,0,0,18,13,5,27,14,13,-9,-9
Klaassen,170,2,123,2018-11-24T15:00:00Z,True,7,4,0,0,19,13,6,8,7,1,11,12
Klaassen,170,2,136,2018-12-02T16:15:00Z,False,7,11,0,0,22,16,6,33,16,17,-11,-10
Klaassen,170,2,148,2018-12-05T19:45:00Z,True,7,14,0,0,22,16,6,12,6,6,10,10
Klaassen,170,2,155,2018-12-10T20:00:00Z,True,7,17,0,0,23,17,6,20,12,8,3,9
Klaassen,170,2,165,2018-12-15T12:30:00Z,False,7,12,0,0,24,18,6,41,24,17,-17,-18
Klaassen,170,2,174,2018-12-23T16:00:00Z,True,7,16,0,0,24,18,6,39,15,24,-15,-6
Klaassen,170,2,181,2018-12-26T15:00:00Z,False,7,3,0,0,24,18,6,12,7,5,12,-1
Klaassen,170,2,190,2018-12-29T15:00:00Z,False,7,2,0,0,27,18,9,22,15,7,5,-6
Klaassen,170,2,204,2019-01-01T12:30:00Z,True,7,10,0,0,27,18,9,28,14,14,-1,4
Klaassen,170,2,215,2019-01-13T14:15:00Z,True,7,1,0,0,27,18,9,27,18,9,0,9
Klaassen,170,2,227,2019-01-19T15:00:00Z,False,7,15,0,0,30,21,9,19,8,11,11,1
Klaassen,170,2,233,2019-01-29T19:45:00Z,False,7,9,0,0,30,21,9,11,5,6,19,4
Klaassen,170,2,245,2019-02-02T15:00:00Z,True,7,19,0,0,33,21,12,35,20,15,-2,6
Klaassen,170,2,265,2019-02-06T19:45:00Z,True,7,12,0,0,33,21,12,59,36,23,-26,-2
Klaassen,170,2,258,2019-02-09T15:00:00Z,False,7,17,0,0,33,21,12,34,17,17,-1,-5
Klaassen,170,2,271,2019-02-26T19:45:00Z,False,7,4,0,0,33,21,12,25,17,8,8,-5
Klaassen,170,2,283,2019-03-03T16:15:00Z,True,7,11,0,0,36,21,15,69,38,31,-33,-10
Klaassen,170,2,298,2019-03-09T15:00:00Z,False,7,14,0,0,37,22,15,31,19,12,6,-4
Klaassen,170,2,303,2019-03-17T16:30:00Z,True,7,5,0,0,37,22,15,57,32,25,-20,-3
Klaassen,170,2,319,2019-03-30T17:30:00Z,False,7,18,0,0,40,25,15,42,27,15,-2,-12
Klaassen,170,2,322,2019-04-07T13:05:00Z,True,7,0,0,0,43,25,18,63,44,19,-20,6
Klaassen,170,2,333,2019-04-13T14:00:00Z,False,7,8,0,0,46,28,18,17,15,2,29,3
Klaassen,170,2,344,2019-04-21T12:30:00Z,True,7,13,0,0,46,28,18,64,35,29,-18,-1
Klaassen,170,2,352,2019-04-27T14:00:00Z,False,7,6,0,0,49,31,18,42,16,26,7,2
Klaassen,170,2,364,2019-05-03T19:00:00Z,True,7,3,0,0,50,31,19,40,23,17,10,14
Klaassen,170,2,378,2019-05-12T14:00:00Z,False,7,16,0,0,53,34,19,70,37,33,-17,-18
Sigurdsson,171,2,9,2018-08-11T16:30:00Z,False,7,19,43,1,0,0,0,0,0,0,0,0
Sigurdsson,171,2,15,2018-08-18T14:00:00Z,True,7,15,90,2,1,0,1,1,1,0,0,0
Sigurdsson,171,2,21,2018-08-25T14:00:00Z,False,7,1,90,4,4,3,1,6,3,3,-2,-2
Sigurdsson,171,2,35,2018-09-01T14:00:00Z,True,7,9,75,2,5,3,2,1,1,0,4,3
Sigurdsson,171,2,42,2018-09-16T15:00:00Z,True,7,18,90,7,6,4,2,0,0,0,6,4
Sigurdsson,171,2,50,2018-09-23T15:00:00Z,False,7,0,90,2,6,4,2,9,3,6,-3,-1
Sigurdsson,171,2,64,2018-09-29T14:00:00Z,True,7,8,90,14,6,4,2,5,4,1,1,3
Sigurdsson,171,2,74,2018-10-06T14:00:00Z,False,7,10,90,10,9,7,2,12,6,6,-3,-4
Sigurdsson,171,2,84,2018-10-21T15:00:00Z,True,7,6,90,3,12,7,5,7,1,6,5,1
Sigurdsson,171,2,96,2018-10-28T16:00:00Z,False,7,13,90,8,15,10,5,14,7,7,1,-2
Sigurdsson,171,2,104,2018-11-03T15:00:00Z,True,7,2,89,5,15,10,5,14,10,4,1,6
Sigurdsson,171,2,112,2018-11-11T14:15:00Z,False,7,5,75,3,18,13,5,27,14,13,-9,-9
Sigurdsson,171,2,123,2018-11-24T15:00:00Z,True,7,4,90,11,19,13,6,8,7,1,11,12
Sigurdsson,171,2,136,2018-12-02T16:15:00Z,False,7,11,90,2,22,16,6,33,16,17,-11,-10
Sigurdsson,171,2,148,2018-12-05T19:45:00Z,True,7,14,69,2,22,16,6,12,6,6,10,10
Sigurdsson,171,2,155,2018-12-10T20:00:00Z,True,7,17,90,0,23,17,6,20,12,8,3,9
Sigurdsson,171,2,165,2018-12-15T12:30:00Z,False,7,12,80,2,24,18,6,41,24,17,-17,-18
Sigurdsson,171,2,174,2018-12-23T16:00:00Z,True,7,16,82,7,24,18,6,39,15,24,-15,-6
Sigurdsson,171,2,181,2018-12-26T15:00:00Z,False,7,3,90,11,24,18,6,12,7,5,12,-1
Sigurdsson,171,2,190,2018-12-29T15:00:00Z,False,7,2,25,1,27,18,9,22,15,7,5,-6
Sigurdsson,171,2,204,2019-01-01T12:30:00Z,True,7,10,90,2,27,18,9,28,14,14,-1,4
Sigurdsson,171,2,215,2019-01-13T14:15:00Z,True,7,1,90,3,27,18,9,27,18,9,0,9
Sigurdsson,171,2,227,2019-01-19T15:00:00Z,False,7,15,90,9,30,21,9,19,8,11,11,1
Sigurdsson,171,2,233,2019-01-29T19:45:00Z,False,7,9,90,3,30,21,9,11,5,6,19,4
Sigurdsson,171,2,245,2019-02-02T15:00:00Z,True,7,19,90,2,33,21,12,35,20,15,-2,6
Sigurdsson,171,2,265,2019-02-06T19:45:00Z,True,7,12,27,1,33,21,12,59,36,23,-26,-2
Sigurdsson,171,2,258,2019-02-09T15:00:00Z,False,7,17,73,2,33,21,12,34,17,17,-1,-5
Sigurdsson,171,2,271,2019-02-26T19:45:00Z,False,7,4,87,16,33,21,12,25,17,8,8,-5
Sigurdsson,171,2,283,2019-03-03T16:15:00Z,True,7,11,90,3,36,21,15,69,38,31,-33,-10
Sigurdsson,171,2,298,2019-03-09T15:00:00Z,False,7,14,90,2,37,22,15,31,19,12,6,-4
Sigurdsson,171,2,303,2019-03-17T16:30:00Z,True,7,5,85,6,37,22,15,57,32,25,-20,-3
Sigurdsson,171,2,319,2019-03-30T17:30:00Z,False,7,18,84,6,40,25,15,42,27,15,-2,-12
Sigurdsson,171,2,322,2019-04-07T13:05:00Z,True,7,0,90,3,43,25,18,63,44,19,-20,6
Sigurdsson,171,2,333,2019-04-13T14:00:00Z,False,7,8,73,2,46,28,18,17,15,2,29,3
Sigurdsson,171,2,344,2019-04-21T12:30:00Z,True,7,13,90,14,46,28,18,64,35,29,-18,-1
Sigurdsson,171,2,352,2019-04-27T14:00:00Z,False,7,6,85,3,49,31,18,42,16,26,7,2
Sigurdsson,171,2,364,2019-05-03T19:00:00Z,True,7,3,90,3,50,31,19,40,23,17,10,14
Sigurdsson,171,2,378,2019-05-12T14:00:00Z,False,7,16,90,5,53,34,19,70,37,33,-17,-18
Vlasic,172,2,9,2018-08-11T16:30:00Z,False,7,19,0,0,0,0,0,0,0,0,0,0
Vlasic,172,2,15,2018-08-18T14:00:00Z,True,7,15,0,0,1,0,1,1,1,0,0,0
Vlasic,172,2,21,2018-08-25T14:00:00Z,False,7,1,0,0,4,3,1,6,3,3,-2,-2
Vlasic,172,2,35,2018-09-01T14:00:00Z,True,7,9,0,0,5,3,2,1,1,0,4,3
Vlasic,172,2,42,2018-09-16T15:00:00Z,True,7,18,0,0,6,4,2,0,0,0,6,4
Vlasic,172,2,50,2018-09-23T15:00:00Z,False,7,0,0,0,6,4,2,9,3,6,-3,-1
Vlasic,172,2,64,2018-09-29T14:00:00Z,True,7,8,0,0,6,4,2,5,4,1,1,3
Vlasic,172,2,74,2018-10-06T14:00:00Z,False,7,10,0,0,9,7,2,12,6,6,-3,-4
Vlasic,172,2,84,2018-10-21T15:00:00Z,True,7,6,0,0,12,7,5,7,1,6,5,1
Vlasic,172,2,96,2018-10-28T16:00:00Z,False,7,13,0,0,15,10,5,14,7,7,1,-2
Vlasic,172,2,104,2018-11-03T15:00:00Z,True,7,2,0,0,15,10,5,14,10,4,1,6
Vlasic,172,2,112,2018-11-11T14:15:00Z,False,7,5,0,0,18,13,5,27,14,13,-9,-9
Vlasic,172,2,123,2018-11-24T15:00:00Z,True,7,4,0,0,19,13,6,8,7,1,11,12
Vlasic,172,2,136,2018-12-02T16:15:00Z,False,7,11,0,0,22,16,6,33,16,17,-11,-10
Vlasic,172,2,148,2018-12-05T19:45:00Z,True,7,14,0,0,22,16,6,12,6,6,10,10
Vlasic,172,2,155,2018-12-10T20:00:00Z,True,7,17,0,0,23,17,6,20,12,8,3,9
Vlasic,172,2,165,2018-12-15T12:30:00Z,False,7,12,0,0,24,18,6,41,24,17,-17,-18
Vlasic,172,2,174,2018-12-23T16:00:00Z,True,7,16,0,0,24,18,6,39,15,24,-15,-6
Vlasic,172,2,181,2018-12-26T15:00:00Z,False,7,3,0,0,24,18,6,12,7,5,12,-1
Vlasic,172,2,190,2018-12-29T15:00:00Z,False,7,2,0,0,27,18,9,22,15,7,5,-6
Vlasic,172,2,204,2019-01-01T12:30:00Z,True,7,10,0,0,27,18,9,28,14,14,-1,4
Vlasic,172,2,215,2019-01-13T14:15:00Z,True,7,1,0,0,27,18,9,27,18,9,0,9
Vlasic,172,2,227,2019-01-19T15:00:00Z,False,7,15,0,0,30,21,9,19,8,11,11,1
Vlasic,172,2,233,2019-01-29T19:45:00Z,False,7,9,0,0,30,21,9,11,5,6,19,4
Vlasic,172,2,245,2019-02-02T15:00:00Z,True,7,19,0,0,33,21,12,35,20,15,-2,6
Vlasic,172,2,265,2019-02-06T19:45:00Z,True,7,12,0,0,33,21,12,59,36,23,-26,-2
Vlasic,172,2,258,2019-02-09T15:00:00Z,False,7,17,0,0,33,21,12,34,17,17,-1,-5
Vlasic,172,2,271,2019-02-26T19:45:00Z,False,7,4,0,0,33,21,12,25,17,8,8,-5
Vlasic,172,2,283,2019-03-03T16:15:00Z,True,7,11,0,0,36,21,15,69,38,31,-33,-10
Vlasic,172,2,298,2019-03-09T15:00:00Z,False,7,14,0,0,37,22,15,31,19,12,6,-4
Vlasic,172,2,303,2019-03-17T16:30:00Z,True,7,5,0,0,37,22,15,57,32,25,-20,-3
Vlasic,172,2,319,2019-03-30T17:30:00Z,False,7,18,0,0,40,25,15,42,27,15,-2,-12
Vlasic,172,2,322,2019-04-07T13:05:00Z,True,7,0,0,0,43,25,18,63,44,19,-20,6
Vlasic,172,2,333,2019-04-13T14:00:00Z,False,7,8,0,0,46,28,18,17,15,2,29,3
Vlasic,172,2,344,2019-04-21T12:30:00Z,True,7,13,0,0,46,28,18,64,35,29,-18,-1
Vlasic,172,2,352,2019-04-27T14:00:00Z,False,7,6,0,0,49,31,18,42,16,26,7,2
Vlasic,172,2,364,2019-05-03T19:00:00Z,True,7,3,0,0,50,31,19,40,23,17,10,14
Vlasic,172,2,378,2019-05-12T14:00:00Z,False,7,16,0,0,53,34,19,70,37,33,-17,-18
Baningime,173,2,9,2018-08-11T16:30:00Z,False,7,19,0,0,0,0,0,0,0,0,0,0
Baningime,173,2,15,2018-08-18T14:00:00Z,True,7,15,0,0,1,0,1,1,1,0,0,0
Baningime,173,2,21,2018-08-25T14:00:00Z,False,7,1,0,0,4,3,1,6,3,3,-2,-2
Baningime,173,2,35,2018-09-01T14:00:00Z,True,7,9,0,0,5,3,2,1,1,0,4,3
Baningime,173,2,42,2018-09-16T15:00:00Z,True,7,18,0,0,6,4,2,0,0,0,6,4
Baningime,173,2,50,2018-09-23T15:00:00Z,False,7,0,0,0,6,4,2,9,3,6,-3,-1
Baningime,173,2,64,2018-09-29T14:00:00Z,True,7,8,0,0,6,4,2,5,4,1,1,3
Baningime,173,2,74,2018-10-06T14:00:00Z,False,7,10,0,0,9,7,2,12,6,6,-3,-4
Baningime,173,2,84,2018-10-21T15:00:00Z,True,7,6,0,0,12,7,5,7,1,6,5,1
Baningime,173,2,96,2018-10-28T16:00:00Z,False,7,13,0,0,15,10,5,14,7,7,1,-2
Baningime,173,2,104,2018-11-03T15:00:00Z,True,7,2,0,0,15,10,5,14,10,4,1,6
Baningime,173,2,112,2018-11-11T14:15:00Z,False,7,5,0,0,18,13,5,27,14,13,-9,-9
Baningime,173,2,123,2018-11-24T15:00:00Z,True,7,4,0,0,19,13,6,8,7,1,11,12
Baningime,173,2,136,2018-12-02T16:15:00Z,False,7,11,0,0,22,16,6,33,16,17,-11,-10
Baningime,173,2,148,2018-12-05T19:45:00Z,True,7,14,0,0,22,16,6,12,6,6,10,10
Baningime,173,2,155,2018-12-10T20:00:00Z,True,7,17,0,0,23,17,6,20,12,8,3,9
Baningime,173,2,165,2018-12-15T12:30:00Z,False,7,12,0,0,24,18,6,41,24,17,-17,-18
Baningime,173,2,174,2018-12-23T16:00:00Z,True,7,16,0,0,24,18,6,39,15,24,-15,-6
Baningime,173,2,181,2018-12-26T15:00:00Z,False,7,3,0,0,24,18,6,12,7,5,12,-1
Baningime,173,2,190,2018-12-29T15:00:00Z,False,7,2,0,0,27,18,9,22,15,7,5,-6
Baningime,173,2,204,2019-01-01T12:30:00Z,True,7,10,0,0,27,18,9,28,14,14,-1,4
Baningime,173,2,215,2019-01-13T14:15:00Z,True,7,1,0,0,27,18,9,27,18,9,0,9
Baningime,173,2,227,2019-01-19T15:00:00Z,False,7,15,0,0,30,21,9,19,8,11,11,1
Baningime,173,2,233,2019-01-29T19:45:00Z,False,7,9,0,0,30,21,9,11,5,6,19,4
Baningime,173,2,245,2019-02-02T15:00:00Z,True,7,19,0,0,33,21,12,35,20,15,-2,6
Baningime,173,2,265,2019-02-06T19:45:00Z,True,7,12,0,0,33,21,12,59,36,23,-26,-2
Baningime,173,2,258,2019-02-09T15:00:00Z,False,7,17,0,0,33,21,12,34,17,17,-1,-5
Baningime,173,2,271,2019-02-26T19:45:00Z,False,7,4,0,0,33,21,12,25,17,8,8,-5
Baningime,173,2,283,2019-03-03T16:15:00Z,True,7,11,0,0,36,21,15,69,38,31,-33,-10
Baningime,173,2,298,2019-03-09T15:00:00Z,False,7,14,0,0,37,22,15,31,19,12,6,-4
Baningime,173,2,303,2019-03-17T16:30:00Z,True,7,5,0,0,37,22,15,57,32,25,-20,-3
Baningime,173,2,319,2019-03-30T17:30:00Z,False,7,18,0,0,40,25,15,42,27,15,-2,-12
Baningime,173,2,322,2019-04-07T13:05:00Z,True,7,0,0,0,43,25,18,63,44,19,-20,6
Baningime,173,2,333,2019-04-13T14:00:00Z,False,7,8,0,0,46,28,18,17,15,2,29,3
Baningime,173,2,344,2019-04-21T12:30:00Z,True,7,13,0,0,46,28,18,64,35,29,-18,-1
Baningime,173,2,352,2019-04-27T14:00:00Z,False,7,6,0,0,49,31,18,42,16,26,7,2
Baningime,173,2,364,2019-05-03T19:00:00Z,True,7,3,0,0,50,31,19,40,23,17,10,14
Baningime,173,2,378,2019-05-12T14:00:00Z,False,7,16,0,0,53,34,19,70,37,33,-17,-18
Calvert-Lewin,174,3,9,2018-08-11T16:30:00Z,False,7,19,0,0,0,0,0,0,0,0,0,0
Calvert-Lewin,174,3,15,2018-08-18T14:00:00Z,True,7,15,15,1,1,0,1,1,1,0,0,0
Calvert-Lewin,174,3,21,2018-08-25T14:00:00Z,False,7,1,6,1,4,3,1,6,3,3,-2,-2
Calvert-Lewin,174,3,35,2018-09-01T14:00:00Z,True,7,9,90,7,5,3,2,1,1,0,4,3
Calvert-Lewin,174,3,42,2018-09-16T15:00:00Z,True,7,18,90,1,6,4,2,0,0,0,6,4
Calvert-Lewin,174,3,50,2018-09-23T15:00:00Z,False,7,0,71,2,6,4,2,9,3,6,-3,-1
Calvert-Lewin,174,3,64,2018-09-29T14:00:00Z,True,7,8,54,1,6,4,2,5,4,1,1,3
Calvert-Lewin,174,3,74,2018-10-06T14:00:00Z,False,7,10,1,1,9,7,2,12,6,6,-3,-4
Calvert-Lewin,174,3,84,2018-10-21T15:00:00Z,True,7,6,8,6,12,7,5,7,1,6,5,1
Calvert-Lewin,174,3,96,2018-10-28T16:00:00Z,False,7,13,12,1,15,10,5,14,7,7,1,-2
Calvert-Lewin,174,3,104,2018-11-03T15:00:00Z,True,7,2,5,1,15,10,5,14,10,4,1,6
Calvert-Lewin,174,3,112,2018-11-11T14:15:00Z,False,7,5,1,1,18,13,5,27,14,13,-9,-9
Calvert-Lewin,174,3,123,2018-11-24T15:00:00Z,True,7,4,0,0,19,13,6,8,7,1,11,12
Calvert-Lewin,174,3,136,2018-12-02T16:15:00Z,False,7,11,1,1,22,16,6,33,16,17,-11,-10
Calvert-Lewin,174,3,148,2018-12-05T19:45:00Z,True,7,14,12,1,22,16,6,12,6,6,10,10
Calvert-Lewin,174,3,155,2018-12-10T20:00:00Z,True,7,17,24,1,23,17,6,20,12,8,3,9
Calvert-Lewin,174,3,165,2018-12-15T12:30:00Z,False,7,12,90,5,24,18,6,41,24,17,-17,-18
Calvert-Lewin,174,3,174,2018-12-23T16:00:00Z,True,7,16,90,5,24,18,6,39,15,24,-15,-6
Calvert-Lewin,174,3,181,2018-12-26T15:00:00Z,False,7,3,66,5,24,18,6,12,7,5,12,-1
Calvert-Lewin,174,3,190,2018-12-29T15:00:00Z,False,7,2,18,1,27,18,9,22,15,7,5,-6
Calvert-Lewin,174,3,204,2019-01-01T12:30:00Z,True,7,10,90,2,27,18,9,28,14,14,-1,4
Calvert-Lewin,174,3,215,2019-01-13T14:15:00Z,True,7,1,3,5,27,18,9,27,18,9,0,9
Calvert-Lewin,174,3,227,2019-01-19T15:00:00Z,False,7,15,33,1,30,21,9,19,8,11,11,1
Calvert-Lewin,174,3,233,2019-01-29T19:45:00Z,False,7,9,4,0,30,21,9,11,5,6,19,4
Calvert-Lewin,174,3,245,2019-02-02T15:00:00Z,True,7,19,17,1,33,21,12,35,20,15,-2,6
Calvert-Lewin,174,3,265,2019-02-06T19:45:00Z,True,7,12,90,2,33,21,12,59,36,23,-26,-2
Calvert-Lewin,174,3,258,2019-02-09T15:00:00Z,False,7,17,16,1,33,21,12,34,17,17,-1,-5
Calvert-Lewin,174,3,271,2019-02-26T19:45:00Z,False,7,4,90,7,33,21,12,25,17,8,8,-5
Calvert-Lewin,174,3,283,2019-03-03T16:15:00Z,True,7,11,73,2,36,21,15,69,38,31,-33,-10
Calvert-Lewin,174,3,298,2019-03-09T15:00:00Z,False,7,14,90,6,37,22,15,31,19,12,6,-4
Calvert-Lewin,174,3,303,2019-03-17T16:30:00Z,True,7,5,90,5,37,22,15,57,32,25,-20,-3
Calvert-Lewin,174,3,319,2019-03-30T17:30:00Z,False,7,18,87,2,40,25,15,42,27,15,-2,-12
Calvert-Lewin,174,3,322,2019-04-07T13:05:00Z,True,7,0,90,5,43,25,18,63,44,19,-20,6
Calvert-Lewin,174,3,333,2019-04-13T14:00:00Z,False,7,8,90,2,46,28,18,17,15,2,29,3
Calvert-Lewin,174,3,344,2019-04-21T12:30:00Z,True,7,13,90,5,46,28,18,64,35,29,-18,-1
Calvert-Lewin,174,3,352,2019-04-27T14:00:00Z,False,7,6,72,2,49,31,18,42,16,26,7,2
Calvert-Lewin,174,3,364,2019-05-03T19:00:00Z,True,7,3,90,2,50,31,19,40,23,17,10,14
Calvert-Lewin,174,3,378,2019-05-12T14:00:00Z,False,7,16,0,0,53,34,19,70,37,33,-17,-18
Niasse,175,3,9,2018-08-11T16:30:00Z,False,7,19,9,1,0,0,0,0,0,0,0,0
Niasse,175,3,15,2018-08-18T14:00:00Z,True,7,15,4,1,1,0,1,1,1,0,0,0
Niasse,175,3,21,2018-08-25T14:00:00Z,False,7,1,0,0,4,3,1,6,3,3,-2,-2
Niasse,175,3,35,2018-09-01T14:00:00Z,True,7,9,14,1,5,3,2,1,1,0,4,3
Niasse,175,3,42,2018-09-16T15:00:00Z,True,7,18,21,1,6,4,2,0,0,0,6,4
Niasse,175,3,50,2018-09-23T15:00:00Z,False,7,0,0,0,6,4,2,9,3,6,-3,-1
Niasse,175,3,64,2018-09-29T14:00:00Z,True,7,8,0,0,6,4,2,5,4,1,1,3
Niasse,175,3,74,2018-10-06T14:00:00Z,False,7,10,0,0,9,7,2,12,6,6,-3,-4
Niasse,175,3,84,2018-10-21T15:00:00Z,True,7,6,0,0,12,7,5,7,1,6,5,1
Niasse,175,3,96,2018-10-28T16:00:00Z,False,7,13,0,0,15,10,5,14,7,7,1,-2
Niasse,175,3,104,2018-11-03T15:00:00Z,True,7,2,0,0,15,10,5,14,10,4,1,6
Niasse,175,3,112,2018-11-11T14:15:00Z,False,7,5,0,0,18,13,5,27,14,13,-9,-9
Niasse,175,3,123,2018-11-24T15:00:00Z,True,7,4,0,0,19,13,6,8,7,1,11,12
Niasse,175,3,136,2018-12-02T16:15:00Z,False,7,11,0,0,22,16,6,33,16,17,-11,-10
Niasse,175,3,148,2018-12-05T19:45:00Z,True,7,14,0,0,22,16,6,12,6,6,10,10
Niasse,175,3,155,2018-12-10T20:00:00Z,True,7,17,0,0,23,17,6,20,12,8,3,9
Niasse,175,3,165,2018-12-15T12:30:00Z,False,7,12,0,0,24,18,6,41,24,17,-17,-18
Niasse,175,3,174,2018-12-23T16:00:00Z,True,7,16,0,0,24,18,6,39,15,24,-15,-6
Niasse,175,3,181,2018-12-26T15:00:00Z,False,7,3,0,0,24,18,6,12,7,5,12,-1
Niasse,175,3,190,2018-12-29T15:00:00Z,False,7,2,10,1,27,18,9,22,15,7,5,-6
Niasse,175,3,204,2019-01-01T12:30:00Z,True,7,10,0,0,27,18,9,28,14,14,-1,4
Niasse,175,3,215,2019-01-13T14:15:00Z,True,7,1,0,0,27,18,9,27,18,9,0,9
Niasse,175,3,226,2019-01-19T15:00:00Z,False,4,14,63,2,19,14,5,18,7,11,1,-2
Niasse,175,3,230,2019-01-29T19:45:00Z,False,4,0,72,2,19,14,5,44,29,15,-25,-24
Niasse,175,3,242,2019-02-02T17:30:00Z,True,4,1,82,2,19,14,5,33,24,9,-14,5
Niasse,175,3,256,2019-02-09T15:00:00Z,False,4,15,82,2,22,17,5,24,12,12,-2,-7
Niasse,175,3,263,2019-02-22T19:45:00Z,True,4,17,70,2,25,17,8,37,20,17,-12,0
Niasse,175,3,271,2019-02-26T19:45:00Z,True,4,7,0,0,25,17,8,33,21,12,-8,5
Niasse,175,3,289,2019-03-02T15:00:00Z,False,4,19,75,2,25,17,8,40,21,19,-15,-13
Niasse,175,3,291,2019-03-09T15:00:00Z,True,4,18,90,2,25,17,8,39,24,15,-14,2
Niasse,175,3,313,2019-03-31T13:05:00Z,True,4,5,84,2,28,20,8,57,32,25,-29,-5
Niasse,175,3,324,2019-04-03T18:45:00Z,False,4,12,90,2,28,20,8,77,45,32,-49,-37
Niasse,175,3,331,2019-04-13T14:00:00Z,False,4,3,12,1,28,20,8,36,20,16,-8,-12
Niasse,175,3,301,2019-04-16T18:45:00Z,False,4,2,84,2,28,20,8,33,22,11,-5,-14
Niasse,175,3,342,2019-04-21T15:00:00Z,True,4,11,66,2,31,20,11,85,47,38,-54,-18
Niasse,175,3,353,2019-04-27T14:00:00Z,False,4,8,60,2,31,20,11,23,18,5,8,-7
Niasse,175,3,362,2019-05-04T16:30:00Z,True,4,6,0,0,31,20,11,43,17,26,-12,-6
Niasse,175,3,376,2019-05-12T14:00:00Z,False,4,13,0,0,31,20,11,66,36,30,-35,-25
Tosun,176,3,9,2018-08-11T16:30:00Z,False,7,19,80,5,0,0,0,0,0,0,0,0
Tosun,176,3,15,2018-08-18T14:00:00Z,True,7,15,74,2,1,0,1,1,1,0,0,0
Tosun,176,3,21,2018-08-25T14:00:00Z,False,7,1,83,4,4,3,1,6,3,3,-2,-2
Tosun,176,3,35,2018-09-01T14:00:00Z,True,7,9,90,2,5,3,2,1,1,0,4,3
Tosun,176,3,42,2018-09-16T15:00:00Z,True,7,18,68,2,6,4,2,0,0,0,6,4
Tosun,176,3,50,2018-09-23T15:00:00Z,False,7,0,18,1,6,4,2,9,3,6,-3,-1
Tosun,176,3,64,2018-09-29T14:00:00Z,True,7,8,35,5,6,4,2,5,4,1,1,3
Tosun,176,3,74,2018-10-06T14:00:00Z,False,7,10,19,1,9,7,2,12,6,6,-3,-4
Tosun,176,3,84,2018-10-21T15:00:00Z,True,7,6,23,5,12,7,5,7,1,6,5,1
Tosun,176,3,96,2018-10-28T16:00:00Z,False,7,13,12,1,15,10,5,14,7,7,1,-2
Tosun,176,3,104,2018-11-03T15:00:00Z,True,7,2,0,0,15,10,5,14,10,4,1,6
Tosun,176,3,112,2018-11-11T14:15:00Z,False,7,5,0,0,18,13,5,27,14,13,-9,-9
Tosun,176,3,123,2018-11-24T15:00:00Z,True,7,4,13,1,19,13,6,8,7,1,11,12
Tosun,176,3,136,2018-12-02T16:15:00Z,False,7,11,0,0,22,16,6,33,16,17,-11,-10
Tosun,176,3,148,2018-12-05T19:45:00Z,True,7,14,68,2,22,16,6,12,6,6,10,10
Tosun,176,3,155,2018-12-10T20:00:00Z,True,7,17,19,1,23,17,6,20,12,8,3,9
Tosun,176,3,165,2018-12-15T12:30:00Z,False,7,12,0,0,24,18,6,41,24,17,-17,-18
Tosun,176,3,174,2018-12-23T16:00:00Z,True,7,16,7,1,24,18,6,39,15,24,-15,-6
Tosun,176,3,181,2018-12-26T15:00:00Z,False,7,3,0,0,24,18,6,12,7,5,12,-1
Tosun,176,3,190,2018-12-29T15:00:00Z,False,7,2,0,0,27,18,9,22,15,7,5,-6
Tosun,176,3,204,2019-01-01T12:30:00Z,True,7,10,20,0,27,18,9,28,14,14,-1,4
Tosun,176,3,215,2019-01-13T14:15:00Z,True,7,1,0,0,27,18,9,27,18,9,0,9
Tosun,176,3,227,2019-01-19T15:00:00Z,False,7,15,25,1,30,21,9,19,8,11,11,1
Tosun,176,3,233,2019-01-29T19:45:00Z,False,7,9,69,1,30,21,9,11,5,6,19,4
Tosun,176,3,245,2019-02-02T15:00:00Z,True,7,19,90,5,33,21,12,35,20,15,-2,6
Tosun,176,3,265,2019-02-06T19:45:00Z,True,7,12,10,1,33,21,12,59,36,23,-26,-2
Tosun,176,3,258,2019-02-09T15:00:00Z,False,7,17,90,2,33,21,12,34,17,17,-1,-5
Tosun,176,3,271,2019-02-26T19:45:00Z,False,7,4,0,0,33,21,12,25,17,8,8,-5
Tosun,176,3,283,2019-03-03T16:15:00Z,True,7,11,16,1,36,21,15,69,38,31,-33,-10
Tosun,176,3,298,2019-03-09T15:00:00Z,False,7,14,0,0,37,22,15,31,19,12,6,-4
Tosun,176,3,303,2019-03-17T16:30:00Z,True,7,5,0,0,37,22,15,57,32,25,-20,-3
Tosun,176,3,319,2019-03-30T17:30:00Z,False,7,18,2,1,40,25,15,42,27,15,-2,-12
Tosun,176,3,322,2019-04-07T13:05:00Z,True,7,0,0,0,43,25,18,63,44,19,-20,6
Tosun,176,3,333,2019-04-13T14:00:00Z,False,7,8,6,1,46,28,18,17,15,2,29,3
Tosun,176,3,344,2019-04-21T12:30:00Z,True,7,13,0,0,46,28,18,64,35,29,-18,-1
Tosun,176,3,352,2019-04-27T14:00:00Z,False,7,6,17,1,49,31,18,42,16,26,7,2
Tosun,176,3,364,2019-05-03T19:00:00Z,True,7,3,0,0,50,31,19,40,23,17,10,14
Tosun,176,3,378,2019-05-12T14:00:00Z,False,7,16,90,9,53,34,19,70,37,33,-17,-18
Bettinelli,177,0,2,2018-08-11T14:00:00Z,True,8,6,0,0,0,0,0,0,0,0,0,0
Bettinelli,177,0,18,2018-08-18T14:00:00Z,False,8,16,0,0,0,0,0,3,0,3,-3,0
Bettinelli,177,0,22,2018-08-26T15:00:00Z,True,8,3,90,0,0,0,0,1,0,1,-1,-1
Bettinelli,177,0,30,2018-09-01T14:00:00Z,False,8,2,90,7,3,3,0,3,3,0,0,-3
Bettinelli,177,0,44,2018-09-15T14:00:00Z,False,8,12,90,3,4,3,1,10,6,4,-6,-5
Bettinelli,177,0,55,2018-09-22T11:30:00Z,True,8,17,90,3,4,3,1,12,9,3,-8,0
Bettinelli,177,0,64,2018-09-29T14:00:00Z,False,8,7,90,2,5,4,1,6,4,2,-1,-3
Bettinelli,177,0,73,2018-10-07T11:00:00Z,True,8,0,90,0,5,4,1,15,9,6,-10,-2
Bettinelli,177,0,82,2018-10-20T14:00:00Z,False,8,4,90,0,5,4,1,2,1,1,3,0
Bettinelli,177,0,93,2018-10-27T14:00:00Z,True,8,1,0,0,5,4,1,17,11,6,-12,-2
Bettinelli,177,0,105,2018-11-05T20:00:00Z,False,8,9,0,0,5,4,1,3,1,2,2,0
Bettinelli,177,0,116,2018-11-11T12:00:00Z,False,8,11,0,0,5,4,1,27,13,14,-22,-12
Bettinelli,177,0,124,2018-11-24T15:00:00Z,True,8,15,0,0,5,4,1,8,4,4,-3,0
Bettinelli,177,0,132,2018-12-02T12:00:00Z,False,8,5,0,0,8,7,1,28,15,13,-20,-14
Bettinelli,177,0,143,2018-12-05T19:45:00Z,True,8,10,0,0,8,7,1,21,11,10,-13,-3
Bettinelli,177,0,157,2018-12-08T15:00:00Z,False,8,13,0,0,9,8,1,23,12,11,-14,-11
Bettinelli,177,0,162,2018-12-15T17:30:00Z,True,8,18,0,0,9,8,1,21,13,8,-12,0
Bettinelli,177,0,177,2018-12-22T15:00:00Z,False,8,14,0,0,9,8,1,16,6,10,-7,-5
Bettinelli,177,0,183,2018-12-26T12:30:00Z,True,8,19,0,0,10,8,2,25,14,11,-15,-3
Bettinelli,177,0,193,2018-12-29T15:00:00Z,True,8,9,0,0,11,9,2,10,5,5,1,4
Bettinelli,177,0,200,2019-01-01T15:00:00Z,False,8,0,0,0,14,12,2,38,23,15,-24,-21
Bettinelli,177,0,211,2019-01-12T15:00:00Z,False,8,3,0,0,14,12,2,18,10,8,-4,-8
Bettinelli,177,0,222,2019-01-20T16:00:00Z,True,8,16,0,0,14,12,2,48,18,30,-34,-18
Bettinelli,177,0,232,2019-01-29T19:45:00Z,True,8,2,0,0,14,12,2,26,18,8,-12,4
Bettinelli,177,0,244,2019-02-02T15:00:00Z,False,8,6,0,0,17,15,2,23,9,14,-6,-7
Bettinelli,177,0,252,2019-02-09T12:30:00Z,True,8,13,0,0,17,15,2,48,25,23,-31,-8
Bettinelli,177,0,269,2019-02-22T19:45:00Z,False,8,18,0,0,17,15,2,33,18,15,-16,-16
Bettinelli,177,0,279,2019-02-27T19:45:00Z,False,8,15,0,0,17,15,2,24,12,12,-7,-10
Bettinelli,177,0,284,2019-03-03T14:05:00Z,True,8,5,0,0,17,15,2,53,31,22,-36,-7
Bettinelli,177,0,295,2019-03-09T15:00:00Z,False,8,10,0,0,17,15,2,35,17,18,-18,-15
Bettinelli,177,0,304,2019-03-17T14:15:00Z,True,8,11,0,0,17,15,2,73,41,32,-56,-17
Bettinelli,177,0,315,2019-03-30T12:30:00Z,True,8,12,0,0,17,15,2,74,45,29,-57,-14
Bettinelli,177,0,328,2019-04-02T18:45:00Z,False,8,17,0,0,17,15,2,43,23,20,-26,-21
Bettinelli,177,0,333,2019-04-13T14:00:00Z,True,8,7,0,0,17,15,2,46,28,18,-29,-3
Bettinelli,177,0,341,2019-04-20T14:00:00Z,False,8,1,0,0,20,18,2,41,26,15,-21,-24
Bettinelli,177,0,353,2019-04-27T14:00:00Z,True,8,4,0,0,23,18,5,31,20,11,-8,7
Bettinelli,177,0,369,2019-05-04T14:00:00Z,False,8,19,0,0,26,21,5,54,31,23,-28,-26
Bettinelli,177,0,373,2019-05-12T14:00:00Z,True,8,14,0,0,26,21,5,42,25,17,-16,4
Button,178,0,8,2018-08-11T14:00:00Z,False,2,17,0,0,0,0,0,0,0,0,0,0
Button,178,0,10,2018-08-19T15:00:00Z,True,2,13,0,0,0,0,0,3,3,0,-3,0
Button,178,0,24,2018-08-25T16:30:00Z,False,2,11,0,0,3,3,0,6,3,3,-3,-3
Button,178,0,30,2018-09-01T14:00:00Z,True,2,8,0,0,3,3,0,3,3,0,0,3
Button,178,0,46,2018-09-17T19:00:00Z,False,2,15,0,0,4,4,0,4,1,3,0,-1
Button,178,0,51,2018-09-22T16:30:00Z,True,2,16,0,0,5,4,1,9,3,6,-4,-2
Button,178,0,66,2018-09-29T14:00:00Z,False,2,12,0,0,5,4,1,16,9,7,-11,-8
Button,178,0,70,2018-10-05T19:00:00Z,True,2,18,0,0,5,4,1,7,4,3,-2,1
Button,178,0,87,2018-10-20T14:00:00Z,False,2,14,0,0,8,7,1,2,0,2,6,1
Button,178,0,90,2018-10-27T14:00:00Z,True,2,19,0,0,11,7,4,15,8,7,-4,0
Button,178,0,104,2018-11-03T15:00:00Z,False,2,7,0,0,14,10,4,15,10,5,-1,-6
Button,178,0,111,2018-11-10T12:30:00Z,False,2,4,0,0,14,10,4,5,4,1,9,0
Button,178,0,121,2018-11-24T15:00:00Z,True,2,10,0,0,14,10,4,17,8,9,-3,1
Button,178,0,134,2018-12-01T15:00:00Z,False,2,9,0,0,15,11,4,10,5,5,5,-1
Button,178,0,141,2018-12-04T19:45:00Z,True,2,6,0,0,18,11,7,12,5,7,6,4
Button,178,0,152,2018-12-08T15:00:00Z,False,2,3,0,0,21,14,7,9,4,5,12,3
Button,178,0,160,2018-12-16T13:30:00Z,True,2,5,0,0,21,14,7,34,21,13,-13,1
Button,178,0,171,2018-12-22T15:00:00Z,False,2,1,0,0,21,14,7,23,14,9,-2,-7
Button,178,0,180,2018-12-26T17:15:00Z,True,2,0,0,0,21,14,7,37,23,14,-16,0
Button,178,0,190,2018-12-29T15:00:00Z,True,2,7,90,9,22,15,7,27,18,9,-5,6
Button,178,0,208,2019-01-02T19:45:00Z,False,2,18,90,2,25,18,7,27,13,14,-2,-6
Button,178,0,210,2019-01-12T15:00:00Z,True,2,11,90,2,26,18,8,54,28,26,-28,-8
Button,178,0,225,2019-01-19T15:00:00Z,False,2,13,90,2,26,18,8,41,21,20,-15,-13
Button,178,0,232,2019-01-29T19:45:00Z,False,2,8,0,0,26,18,8,14,12,2,12,-4
Button,178,0,240,2019-02-02T15:00:00Z,True,2,17,0,0,26,18,8,33,17,16,-7,2
Button,178,0,250,2019-02-09T17:30:00Z,True,2,3,0,0,27,19,8,24,14,10,3,9
Button,178,0,274,2019-02-26T19:45:00Z,False,2,10,0,0,27,19,8,32,14,18,-5,-6
Button,178,0,281,2019-03-02T15:00:00Z,True,2,9,0,0,27,19,8,14,8,6,13,13
Button,178,0,293,2019-03-09T12:30:00Z,False,2,6,0,0,30,22,8,33,13,20,-3,-5
Button,178,0,311,2019-03-30T15:00:00Z,True,2,15,0,0,33,22,11,30,18,12,3,10
Button,178,0,264,2019-04-03T18:45:00Z,False,2,5,0,0,33,22,11,60,32,28,-27,-21
Button,178,0,330,2019-04-13T14:00:00Z,True,2,1,0,0,33,22,11,38,26,12,-5,10
Button,178,0,301,2019-04-16T18:45:00Z,True,2,4,0,0,33,22,11,28,20,8,5,14
Button,178,0,349,2019-04-20T14:00:00Z,False,2,19,0,0,33,22,11,47,27,20,-14,-16
Button,178,0,327,2019-04-23T18:45:00Z,False,2,16,0,0,34,22,12,67,34,33,-33,-22
Button,178,0,350,2019-04-27T16:30:00Z,True,2,14,0,0,34,22,12,41,25,16,-7,6
Button,178,0,360,2019-05-05T15:30:00Z,False,2,0,0,0,35,23,12,66,44,22,-31,-32
Button,178,0,370,2019-05-12T14:00:00Z,True,2,12,0,0,36,23,13,95,54,41,-59,-18
Ream,179,1,2,2018-08-11T14:00:00Z,True,8,6,0,0,0,0,0,0,0,0,0,0
Ream,179,1,18,2018-08-18T14:00:00Z,False,8,16,0,0,0,0,0,3,0,3,-3,0
Ream,179,1,22,2018-08-26T15:00:00Z,True,8,3,0,0,0,0,0,1,0,1,-1,-1
Ream,179,1,30,2018-09-01T14:00:00Z,False,8,2,0,0,3,3,0,3,3,0,0,-3
Ream,179,1,44,2018-09-15T14:00:00Z,False,8,12,0,0,4,3,1,10,6,4,-6,-5
Ream,179,1,55,2018-09-22T11:30:00Z,True,8,17,0,0,4,3,1,12,9,3,-8,0
Ream,179,1,64,2018-09-29T14:00:00Z,False,8,7,90,1,5,4,1,6,4,2,-1,-3
Ream,179,1,73,2018-10-07T11:00:00Z,True,8,0,53,0,5,4,1,15,9,6,-10,-2
Ream,179,1,82,2018-10-20T14:00:00Z,False,8,4,90,0,5,4,1,2,1,1,3,0
Ream,179,1,93,2018-10-27T14:00:00Z,True,8,1,90,1,5,4,1,17,11,6,-12,-2
Ream,179,1,105,2018-11-05T20:00:00Z,False,8,9,0,0,5,4,1,3,1,2,2,0
Ream,179,1,116,2018-11-11T12:00:00Z,False,8,11,0,0,5,4,1,27,13,14,-22,-12
Ream,179,1,124,2018-11-24T15:00:00Z,True,8,15,0,0,5,4,1,8,4,4,-3,0
Ream,179,1,132,2018-12-02T12:00:00Z,False,8,5,0,0,8,7,1,28,15,13,-20,-14
Ream,179,1,143,2018-12-05T19:45:00Z,True,8,10,6,1,8,7,1,21,11,10,-13,-3
Ream,179,1,157,2018-12-08T15:00:00Z,False,8,13,90,0,9,8,1,23,12,11,-14,-11
Ream,179,1,162,2018-12-15T17:30:00Z,True,8,18,45,0,9,8,1,21,13,8,-12,0
Ream,179,1,177,2018-12-22T15:00:00Z,False,8,14,90,8,9,8,1,16,6,10,-7,-5
Ream,179,1,183,2018-12-26T12:30:00Z,True,8,19,90,2,10,8,2,25,14,11,-15,-3
Ream,179,1,193,2018-12-29T15:00:00Z,True,8,9,90,7,11,9,2,10,5,5,1,4
Ream,179,1,200,2019-01-01T15:00:00Z,False,8,0,90,0,14,12,2,38,23,15,-24,-21
Ream,179,1,211,2019-01-12T15:00:00Z,False,8,3,90,1,14,12,2,18,10,8,-4,-8
Ream,179,1,222,2019-01-20T16:00:00Z,True,8,16,90,1,14,12,2,48,18,30,-34,-18
Ream,179,1,232,2019-01-29T19:45:00Z,True,8,2,26,0,14,12,2,26,18,8,-12,4
Ream,179,1,244,2019-02-02T15:00:00Z,False,8,6,45,1,17,15,2,23,9,14,-6,-7
Ream,179,1,252,2019-02-09T12:30:00Z,True,8,13,90,1,17,15,2,48,25,23,-31,-8
Ream,179,1,269,2019-02-22T19:45:00Z,False,8,18,90,1,17,15,2,33,18,15,-16,-16
Ream,179,1,279,2019-02-27T19:45:00Z,False,8,15,90,1,17,15,2,24,12,12,-7,-10
Ream,179,1,284,2019-03-03T14:05:00Z,True,8,5,90,1,17,15,2,53,31,22,-36,-7
Ream,179,1,295,2019-03-09T15:00:00Z,False,8,10,90,1,17,15,2,35,17,18,-18,-15
Ream,179,1,304,2019-03-17T14:15:00Z,True,8,11,90,1,17,15,2,73,41,32,-56,-17
Ream,179,1,315,2019-03-30T12:30:00Z,True,8,12,0,0,17,15,2,74,45,29,-57,-14
Ream,179,1,328,2019-04-02T18:45:00Z,False,8,17,71,1,17,15,2,43,23,20,-26,-21
Ream,179,1,333,2019-04-13T14:00:00Z,True,8,7,90,5,17,15,2,46,28,18,-29,-3
Ream,179,1,341,2019-04-20T14:00:00Z,False,8,1,90,7,20,18,2,41,26,15,-21,-24
Ream,179,1,353,2019-04-27T14:00:00Z,True,8,4,90,6,23,18,5,31,20,11,-8,7
Ream,179,1,369,2019-05-04T14:00:00Z,False,8,19,90,2,26,21,5,54,31,23,-28,-26
Ream,179,1,373,2019-05-12T14:00:00Z,True,8,14,0,0,26,21,5,42,25,17,-16,4
Odoi,180,1,2,2018-08-11T14:00:00Z,True,8,6,0,0,0,0,0,0,0,0,0,0
Odoi,180,1,18,2018-08-18T14:00:00Z,False,8,16,0,0,0,0,0,3,0,3,-3,0
Odoi,180,1,22,2018-08-26T15:00:00Z,True,8,3,90,1,0,0,0,1,0,1,-1,-1
Odoi,180,1,30,2018-09-01T14:00:00Z,False,8,2,90,1,3,3,0,3,3,0,0,-3
Odoi,180,1,44,2018-09-15T14:00:00Z,False,8,12,90,1,4,3,1,10,6,4,-6,-5
Odoi,180,1,55,2018-09-22T11:30:00Z,True,8,17,45,1,4,3,1,12,9,3,-8,0
Odoi,180,1,64,2018-09-29T14:00:00Z,False,8,7,90,0,5,4,1,6,4,2,-1,-3
Odoi,180,1,73,2018-10-07T11:00:00Z,True,8,0,90,0,5,4,1,15,9,6,-10,-2
Odoi,180,1,82,2018-10-20T14:00:00Z,False,8,4,90,0,5,4,1,2,1,1,3,0
Odoi,180,1,93,2018-10-27T14:00:00Z,True,8,1,90,1,5,4,1,17,11,6,-12,-2
Odoi,180,1,105,2018-11-05T20:00:00Z,False,8,9,90,2,5,4,1,3,1,2,2,0
Odoi,180,1,116,2018-11-11T12:00:00Z,False,8,11,90,1,5,4,1,27,13,14,-22,-12
Odoi,180,1,124,2018-11-24T15:00:00Z,True,8,15,90,1,5,4,1,8,4,4,-3,0
Odoi,180,1,132,2018-12-02T12:00:00Z,False,8,5,90,0,8,7,1,28,15,13,-20,-14
Odoi,180,1,143,2018-12-05T19:45:00Z,True,8,10,90,2,8,7,1,21,11,10,-13,-3
Odoi,180,1,157,2018-12-08T15:00:00Z,False,8,13,90,0,9,8,1,23,12,11,-14,-11
Odoi,180,1,162,2018-12-15T17:30:00Z,True,8,18,90,1,9,8,1,21,13,8,-12,0
Odoi,180,1,177,2018-12-22T15:00:00Z,False,8,14,90,6,9,8,1,16,6,10,-7,-5
Odoi,180,1,183,2018-12-26T12:30:00Z,True,8,19,90,2,10,8,2,25,14,11,-15,-3
Odoi,180,1,193,2018-12-29T15:00:00Z,True,8,9,90,6,11,9,2,10,5,5,1,4
Odoi,180,1,200,2019-01-01T15:00:00Z,False,8,0,90,0,14,12,2,38,23,15,-24,-21
Odoi,180,1,211,2019-01-12T15:00:00Z,False,8,3,90,3,14,12,2,18,10,8,-4,-8
Odoi,180,1,222,2019-01-20T16:00:00Z,True,8,16,90,1,14,12,2,48,18,30,-34,-18
Odoi,180,1,232,2019-01-29T19:45:00Z,True,8,2,90,1,14,12,2,26,18,8,-12,4
Odoi,180,1,244,2019-02-02T15:00:00Z,False,8,6,90,0,17,15,2,23,9,14,-6,-7
Odoi,180,1,252,2019-02-09T12:30:00Z,True,8,13,90,1,17,15,2,48,25,23,-31,-8
Odoi,180,1,269,2019-02-22T19:45:00Z,False,8,18,90,1,17,15,2,33,18,15,-16,-16
Odoi,180,1,279,2019-02-27T19:45:00Z,False,8,15,90,1,17,15,2,24,12,12,-7,-10
Odoi,180,1,284,2019-03-03T14:05:00Z,True,8,5,90,1,17,15,2,53,31,22,-36,-7
Odoi,180,1,295,2019-03-09T15:00:00Z,False,8,10,90,1,17,15,2,35,17,18,-18,-15
Odoi,180,1,304,2019-03-17T14:15:00Z,True,8,11,0,0,17,15,2,73,41,32,-56,-17
Odoi,180,1,315,2019-03-30T12:30:00Z,True,8,12,0,0,17,15,2,74,45,29,-57,-14
Odoi,180,1,328,2019-04-02T18:45:00Z,False,8,17,0,0,17,15,2,43,23,20,-26,-21
Odoi,180,1,333,2019-04-13T14:00:00Z,True,8,7,1,1,17,15,2,46,28,18,-29,-3
Odoi,180,1,341,2019-04-20T14:00:00Z,False,8,1,90,6,20,18,2,41,26,15,-21,-24
Odoi,180,1,353,2019-04-27T14:00:00Z,True,8,4,27,1,23,18,5,31,20,11,-8,7
Odoi,180,1,369,2019-05-04T14:00:00Z,False,8,19,0,0,26,21,5,54,31,23,-28,-26
Odoi,180,1,373,2019-05-12T14:00:00Z,True,8,14,0,0,26,21,5,42,25,17,-16,4
Cairney,181,2,2,2018-08-11T14:00:00Z,True,8,6,90,2,0,0,0,0,0,0,0,0
Cairney,181,2,18,2018-08-18T14:00:00Z,False,8,16,72,2,0,0,0,3,0,3,-3,0
Cairney,181,2,22,2018-08-26T15:00:00Z,True,8,3,77,5,0,0,0,1,0,1,-1,-1
Cairney,181,2,30,2018-09-01T14:00:00Z,False,8,2,0,0,3,3,0,3,3,0,0,-3
Cairney,181,2,44,2018-09-15T14:00:00Z,False,8,12,0,0,4,3,1,10,6,4,-6,-5
Cairney,181,2,55,2018-09-22T11:30:00Z,True,8,17,0,0,4,3,1,12,9,3,-8,0
Cairney,181,2,64,2018-09-29T14:00:00Z,False,8,7,26,1,5,4,1,6,4,2,-1,-3
Cairney,181,2,73,2018-10-07T11:00:00Z,True,8,0,0,0,5,4,1,15,9,6,-10,-2
Cairney,181,2,82,2018-10-20T14:00:00Z,False,8,4,0,0,5,4,1,2,1,1,3,0
Cairney,181,2,93,2018-10-27T14:00:00Z,True,8,1,30,1,5,4,1,17,11,6,-12,-2
Cairney,181,2,105,2018-11-05T20:00:00Z,False,8,9,90,2,5,4,1,3,1,2,2,0
Cairney,181,2,116,2018-11-11T12:00:00Z,False,8,11,62,2,5,4,1,27,13,14,-22,-12
Cairney,181,2,124,2018-11-24T15:00:00Z,True,8,15,90,2,5,4,1,8,4,4,-3,0
Cairney,181,2,132,2018-12-02T12:00:00Z,False,8,5,75,2,8,7,1,28,15,13,-20,-14
Cairney,181,2,143,2018-12-05T19:45:00Z,True,8,10,45,1,8,7,1,21,11,10,-13,-3
Cairney,181,2,157,2018-12-08T15:00:00Z,False,8,13,45,1,9,8,1,23,12,11,-14,-11
Cairney,181,2,162,2018-12-15T17:30:00Z,True,8,18,90,2,9,8,1,21,13,8,-12,0
Cairney,181,2,177,2018-12-22T15:00:00Z,False,8,14,81,3,9,8,1,16,6,10,-7,-5
Cairney,181,2,183,2018-12-26T12:30:00Z,True,8,19,17,1,10,8,2,25,14,11,-15,-3
Cairney,181,2,193,2018-12-29T15:00:00Z,True,8,9,90,3,11,9,2,10,5,5,1,4
Cairney,181,2,200,2019-01-01T15:00:00Z,False,8,0,90,2,14,12,2,38,23,15,-24,-21
Cairney,181,2,211,2019-01-12T15:00:00Z,False,8,3,29,1,14,12,2,18,10,8,-4,-8
Cairney,181,2,222,2019-01-20T16:00:00Z,True,8,16,0,0,14,12,2,48,18,30,-34,-18
Cairney,181,2,232,2019-01-29T19:45:00Z,True,8,2,63,3,14,12,2,26,18,8,-12,4
Cairney,181,2,244,2019-02-02T15:00:00Z,False,8,6,90,2,17,15,2,23,9,14,-6,-7
Cairney,181,2,252,2019-02-09T12:30:00Z,True,8,13,13,1,17,15,2,48,25,23,-31,-8
Cairney,181,2,269,2019-02-22T19:45:00Z,False,8,18,90,2,17,15,2,33,18,15,-16,-16
Cairney,181,2,279,2019-02-27T19:45:00Z,False,8,15,68,2,17,15,2,24,12,12,-7,-10
Cairney,181,2,284,2019-03-03T14:05:00Z,True,8,5,79,2,17,15,2,53,31,22,-36,-7
Cairney,181,2,295,2019-03-09T15:00:00Z,False,8,10,90,2,17,15,2,35,17,18,-18,-15
Cairney,181,2,304,2019-03-17T14:15:00Z,True,8,11,81,2,17,15,2,73,41,32,-56,-17
Cairney,181,2,315,2019-03-30T12:30:00Z,True,8,12,69,2,17,15,2,74,45,29,-57,-14
Cairney,181,2,328,2019-04-02T18:45:00Z,False,8,17,86,2,17,15,2,43,23,20,-26,-21
Cairney,181,2,333,2019-04-13T14:00:00Z,True,8,7,90,11,17,15,2,46,28,18,-29,-3
Cairney,181,2,341,2019-04-20T14:00:00Z,False,8,1,0,0,20,18,2,41,26,15,-21,-24
Cairney,181,2,353,2019-04-27T14:00:00Z,True,8,4,90,3,23,18,5,31,20,11,-8,7
Cairney,181,2,369,2019-05-04T14:00:00Z,False,8,19,90,2,26,21,5,54,31,23,-28,-26
Cairney,181,2,373,2019-05-12T14:00:00Z,True,8,14,90,2,26,21,5,42,25,17,-16,4
McDonald,182,2,2,2018-08-11T14:00:00Z,True,8,6,90,1,0,0,0,0,0,0,0,0
McDonald,182,2,18,2018-08-18T14:00:00Z,False,8,16,0,0,0,0,0,3,0,3,-3,0
McDonald,182,2,22,2018-08-26T15:00:00Z,True,8,3,90,2,0,0,0,1,0,1,-1,-1
McDonald,182,2,30,2018-09-01T14:00:00Z,False,8,2,90,2,3,3,0,3,3,0,0,-3
McDonald,182,2,44,2018-09-15T14:00:00Z,False,8,12,90,2,4,3,1,10,6,4,-6,-5
McDonald,182,2,55,2018-09-22T11:30:00Z,True,8,17,45,1,4,3,1,12,9,3,-8,0
McDonald,182,2,64,2018-09-29T14:00:00Z,False,8,7,0,0,5,4,1,6,4,2,-1,-3
McDonald,182,2,73,2018-10-07T11:00:00Z,True,8,0,28,1,5,4,1,15,9,6,-10,-2
McDonald,182,2,82,2018-10-20T14:00:00Z,False,8,4,90,1,5,4,1,2,1,1,3,0
McDonald,182,2,93,2018-10-27T14:00:00Z,True,8,1,72,-1,5,4,1,17,11,6,-12,-2
McDonald,182,2,105,2018-11-05T20:00:00Z,False,8,9,19,1,5,4,1,3,1,2,2,0
McDonald,182,2,116,2018-11-11T12:00:00Z,False,8,11,0,0,5,4,1,27,13,14,-22,-12
McDonald,182,2,124,2018-11-24T15:00:00Z,True,8,15,0,0,5,4,1,8,4,4,-3,0
McDonald,182,2,132,2018-12-02T12:00:00Z,False,8,5,0,0,8,7,1,28,15,13,-20,-14
McDonald,182,2,143,2018-12-05T19:45:00Z,True,8,10,0,0,8,7,1,21,11,10,-13,-3
McDonald,182,2,157,2018-12-08T15:00:00Z,False,8,13,0,0,9,8,1,23,12,11,-14,-11
McDonald,182,2,162,2018-12-15T17:30:00Z,True,8,18,0,0,9,8,1,21,13,8,-12,0
McDonald,182,2,177,2018-12-22T15:00:00Z,False,8,14,0,0,9,8,1,16,6,10,-7,-5
McDonald,182,2,183,2018-12-26T12:30:00Z,True,8,19,8,1,10,8,2,25,14,11,-15,-3
McDonald,182,2,193,2018-12-29T15:00:00Z,True,8,9,0,0,11,9,2,10,5,5,1,4
McDonald,182,2,200,2019-01-01T15:00:00Z,False,8,0,0,0,14,12,2,38,23,15,-24,-21
McDonald,182,2,211,2019-01-12T15:00:00Z,False,8,3,0,0,14,12,2,18,10,8,-4,-8
McDonald,182,2,222,2019-01-20T16:00:00Z,True,8,16,0,0,14,12,2,48,18,30,-34,-18
McDonald,182,2,232,2019-01-29T19:45:00Z,True,8,2,0,0,14,12,2,26,18,8,-12,4
McDonald,182,2,244,2019-02-02T15:00:00Z,False,8,6,0,0,17,15,2,23,9,14,-6,-7
McDonald,182,2,252,2019-02-09T12:30:00Z,True,8,13,0,0,17,15,2,48,25,23,-31,-8
McDonald,182,2,269,2019-02-22T19:45:00Z,False,8,18,0,0,17,15,2,33,18,15,-16,-16
McDonald,182,2,279,2019-02-27T19:45:00Z,False,8,15,68,1,17,15,2,24,12,12,-7,-10
McDonald,182,2,284,2019-03-03T14:05:00Z,True,8,5,61,1,17,15,2,53,31,22,-36,-7
McDonald,182,2,295,2019-03-09T15:00:00Z,False,8,10,81,2,17,15,2,35,17,18,-18,-15
McDonald,182,2,304,2019-03-17T14:15:00Z,True,8,11,0,0,17,15,2,73,41,32,-56,-17
McDonald,182,2,315,2019-03-30T12:30:00Z,True,8,12,2,1,17,15,2,74,45,29,-57,-14
McDonald,182,2,328,2019-04-02T18:45:00Z,False,8,17,3,1,17,15,2,43,23,20,-26,-21
McDonald,182,2,333,2019-04-13T14:00:00Z,True,8,7,0,0,17,15,2,46,28,18,-29,-3
McDonald,182,2,341,2019-04-20T14:00:00Z,False,8,1,0,0,20,18,2,41,26,15,-21,-24
McDonald,182,2,353,2019-04-27T14:00:00Z,True,8,4,0,0,23,18,5,31,20,11,-8,7
McDonald,182,2,369,2019-05-04T14:00:00Z,False,8,19,0,0,26,21,5,54,31,23,-28,-26
McDonald,182,2,373,2019-05-12T14:00:00Z,True,8,14,0,0,26,21,5,42,25,17,-16,4
Sessegnon,183,2,2,2018-08-11T14:00:00Z,True,8,6,90,2,0,0,0,0,0,0,0,0
Sessegnon,183,2,18,2018-08-18T14:00:00Z,False,8,16,90,5,0,0,0,3,0,3,-3,0
Sessegnon,183,2,22,2018-08-26T15:00:00Z,True,8,3,1,1,0,0,0,1,0,1,-1,-1
Sessegnon,183,2,30,2018-09-01T14:00:00Z,False,8,2,16,1,3,3,0,3,3,0,0,-3
Sessegnon,183,2,44,2018-09-15T14:00:00Z,False,8,12,90,2,4,3,1,10,6,4,-6,-5
Sessegnon,183,2,55,2018-09-22T11:30:00Z,True,8,17,90,2,4,3,1,12,9,3,-8,0
Sessegnon,183,2,64,2018-09-29T14:00:00Z,False,8,7,90,2,5,4,1,6,4,2,-1,-3
Sessegnon,183,2,73,2018-10-07T11:00:00Z,True,8,0,90,2,5,4,1,15,9,6,-10,-2
Sessegnon,183,2,82,2018-10-20T14:00:00Z,False,8,4,90,8,5,4,1,2,1,1,3,0
Sessegnon,183,2,93,2018-10-27T14:00:00Z,True,8,1,90,2,5,4,1,17,11,6,-12,-2
Sessegnon,183,2,105,2018-11-05T20:00:00Z,False,8,9,90,2,5,4,1,3,1,2,2,0
Sessegnon,183,2,116,2018-11-11T12:00:00Z,False,8,11,90,2,5,4,1,27,13,14,-22,-12
Sessegnon,183,2,124,2018-11-24T15:00:00Z,True,8,15,90,9,5,4,1,8,4,4,-3,0
Sessegnon,183,2,132,2018-12-02T12:00:00Z,False,8,5,45,1,8,7,1,28,15,13,-20,-14
Sessegnon,183,2,143,2018-12-05T19:45:00Z,True,8,10,90,2,8,7,1,21,11,10,-13,-3
Sessegnon,183,2,157,2018-12-08T15:00:00Z,False,8,13,90,2,9,8,1,23,12,11,-14,-11
Sessegnon,183,2,162,2018-12-15T17:30:00Z,True,8,18,0,0,9,8,1,21,13,8,-12,0
Sessegnon,183,2,177,2018-12-22T15:00:00Z,False,8,14,0,0,9,8,1,16,6,10,-7,-5
Sessegnon,183,2,183,2018-12-26T12:30:00Z,True,8,19,23,7,10,8,2,25,14,11,-15,-3
Sessegnon,183,2,193,2018-12-29T15:00:00Z,True,8,9,13,4,11,9,2,10,5,5,1,4
Sessegnon,183,2,200,2019-01-01T15:00:00Z,False,8,0,90,5,14,12,2,38,23,15,-24,-21
Sessegnon,183,2,211,2019-01-12T15:00:00Z,False,8,3,45,1,14,12,2,18,10,8,-4,-8
Sessegnon,183,2,222,2019-01-20T16:00:00Z,True,8,16,35,1,14,12,2,48,18,30,-34,-18
Sessegnon,183,2,232,2019-01-29T19:45:00Z,True,8,2,13,1,14,12,2,26,18,8,-12,4
Sessegnon,183,2,244,2019-02-02T15:00:00Z,False,8,6,0,0,17,15,2,23,9,14,-6,-7
Sessegnon,183,2,252,2019-02-09T12:30:00Z,True,8,13,9,1,17,15,2,48,25,23,-31,-8
Sessegnon,183,2,269,2019-02-22T19:45:00Z,False,8,18,45,4,17,15,2,33,18,15,-16,-16
Sessegnon,183,2,279,2019-02-27T19:45:00Z,False,8,15,21,1,17,15,2,24,12,12,-7,-10
Sessegnon,183,2,284,2019-03-03T14:05:00Z,True,8,5,90,2,17,15,2,53,31,22,-36,-7
Sessegnon,183,2,295,2019-03-09T15:00:00Z,False,8,10,45,1,17,15,2,35,17,18,-18,-15
Sessegnon,183,2,304,2019-03-17T14:15:00Z,True,8,11,25,1,17,15,2,73,41,32,-56,-17
Sessegnon,183,2,315,2019-03-30T12:30:00Z,True,8,12,90,2,17,15,2,74,45,29,-57,-14
Sessegnon,183,2,328,2019-04-02T18:45:00Z,False,8,17,90,5,17,15,2,43,23,20,-26,-21
Sessegnon,183,2,333,2019-04-13T14:00:00Z,True,8,7,90,3,17,15,2,46,28,18,-29,-3
Sessegnon,183,2,341,2019-04-20T14:00:00Z,False,8,1,90,3,20,18,2,41,26,15,-21,-24
Sessegnon,183,2,353,2019-04-27T14:00:00Z,True,8,4,84,3,23,18,5,31,20,11,-8,7
Sessegnon,183,2,369,2019-05-04T14:00:00Z,False,8,19,81,2,26,21,5,54,31,23,-28,-26
Sessegnon,183,2,373,2019-05-12T14:00:00Z,True,8,14,80,2,26,21,5,42,25,17,-16,4
Johansen,184,2,2,2018-08-11T14:00:00Z,True,8,6,8,1,0,0,0,0,0,0,0,0
Johansen,184,2,18,2018-08-18T14:00:00Z,False,8,16,17,1,0,0,0,3,0,3,-3,0
Johansen,184,2,22,2018-08-26T15:00:00Z,True,8,3,0,0,0,0,0,1,0,1,-1,-1
Johansen,184,2,30,2018-09-01T14:00:00Z,False,8,2,16,0,3,3,0,3,3,0,0,-3
Johansen,184,2,44,2018-09-15T14:00:00Z,False,8,12,90,2,4,3,1,10,6,4,-6,-5
Johansen,184,2,55,2018-09-22T11:30:00Z,True,8,17,63,2,4,3,1,12,9,3,-8,0
Johansen,184,2,64,2018-09-29T14:00:00Z,False,8,7,0,0,5,4,1,6,4,2,-1,-3
Johansen,184,2,73,2018-10-07T11:00:00Z,True,8,0,7,1,5,4,1,15,9,6,-10,-2
Johansen,184,2,82,2018-10-20T14:00:00Z,False,8,4,81,1,5,4,1,2,1,1,3,0
Johansen,184,2,93,2018-10-27T14:00:00Z,True,8,1,0,0,5,4,1,17,11,6,-12,-2
Johansen,184,2,105,2018-11-05T20:00:00Z,False,8,9,25,1,5,4,1,3,1,2,2,0
Johansen,184,2,116,2018-11-11T12:00:00Z,False,8,11,6,1,5,4,1,27,13,14,-22,-12
Johansen,184,2,124,2018-11-24T15:00:00Z,True,8,15,22,0,5,4,1,8,4,4,-3,0
Johansen,184,2,132,2018-12-02T12:00:00Z,False,8,5,45,1,8,7,1,28,15,13,-20,-14
Johansen,184,2,143,2018-12-05T19:45:00Z,True,8,10,0,0,8,7,1,21,11,10,-13,-3
Johansen,184,2,157,2018-12-08T15:00:00Z,False,8,13,0,0,9,8,1,23,12,11,-14,-11
Johansen,184,2,162,2018-12-15T17:30:00Z,True,8,18,29,0,9,8,1,21,13,8,-12,0
Johansen,184,2,177,2018-12-22T15:00:00Z,False,8,14,0,0,9,8,1,16,6,10,-7,-5
Johansen,184,2,183,2018-12-26T12:30:00Z,True,8,19,0,0,10,8,2,25,14,11,-15,-3
Johansen,184,2,193,2018-12-29T15:00:00Z,True,8,9,0,0,11,9,2,10,5,5,1,4
Johansen,184,2,200,2019-01-01T15:00:00Z,False,8,0,0,0,14,12,2,38,23,15,-24,-21
Johansen,184,2,211,2019-01-12T15:00:00Z,False,8,3,0,0,14,12,2,18,10,8,-4,-8
Johansen,184,2,222,2019-01-20T16:00:00Z,True,8,16,0,0,14,12,2,48,18,30,-34,-18
Johansen,184,2,232,2019-01-29T19:45:00Z,True,8,2,0,0,14,12,2,26,18,8,-12,4
Johansen,184,2,244,2019-02-02T15:00:00Z,False,8,6,0,0,17,15,2,23,9,14,-6,-7
Johansen,184,2,252,2019-02-09T12:30:00Z,True,8,13,0,0,17,15,2,48,25,23,-31,-8
Johansen,184,2,269,2019-02-22T19:45:00Z,False,8,18,0,0,17,15,2,33,18,15,-16,-16
Johansen,184,2,279,2019-02-27T19:45:00Z,False,8,15,0,0,17,15,2,24,12,12,-7,-10
Johansen,184,2,284,2019-03-03T14:05:00Z,True,8,5,0,0,17,15,2,53,31,22,-36,-7
Johansen,184,2,295,2019-03-09T15:00:00Z,False,8,10,0,0,17,15,2,35,17,18,-18,-15
Johansen,184,2,304,2019-03-17T14:15:00Z,True,8,11,0,0,17,15,2,73,41,32,-56,-17
Johansen,184,2,315,2019-03-30T12:30:00Z,True,8,12,0,0,17,15,2,74,45,29,-57,-14
Johansen,184,2,328,2019-04-02T18:45:00Z,False,8,17,0,0,17,15,2,43,23,20,-26,-21
Johansen,184,2,333,2019-04-13T14:00:00Z,True,8,7,0,0,17,15,2,46,28,18,-29,-3
Johansen,184,2,341,2019-04-20T14:00:00Z,False,8,1,0,0,20,18,2,41,26,15,-21,-24
Johansen,184,2,353,2019-04-27T14:00:00Z,True,8,4,0,0,23,18,5,31,20,11,-8,7
Johansen,184,2,369,2019-05-04T14:00:00Z,False,8,19,0,0,26,21,5,54,31,23,-28,-26
Johansen,184,2,373,2019-05-12T14:00:00Z,True,8,14,0,0,26,21,5,42,25,17,-16,4
Ayite,185,2,2,2018-08-11T14:00:00Z,True,8,6,0,0,0,0,0,0,0,0,0,0
Ayite,185,2,18,2018-08-18T14:00:00Z,False,8,16,0,0,0,0,0,3,0,3,-3,0
Ayite,185,2,22,2018-08-26T15:00:00Z,True,8,3,0,0,0,0,0,1,0,1,-1,-1
Ayite,185,2,30,2018-09-01T14:00:00Z,False,8,2,0,0,3,3,0,3,3,0,0,-3
Ayite,185,2,44,2018-09-15T14:00:00Z,False,8,12,21,1,4,3,1,10,6,4,-6,-5
Ayite,185,2,55,2018-09-22T11:30:00Z,True,8,17,45,1,4,3,1,12,9,3,-8,0
Ayite,185,2,64,2018-09-29T14:00:00Z,False,8,7,6,1,5,4,1,6,4,2,-1,-3
Ayite,185,2,73,2018-10-07T11:00:00Z,True,8,0,0,0,5,4,1,15,9,6,-10,-2
Ayite,185,2,82,2018-10-20T14:00:00Z,False,8,4,32,1,5,4,1,2,1,1,3,0
Ayite,185,2,93,2018-10-27T14:00:00Z,True,8,1,0,0,5,4,1,17,11,6,-12,-2
Ayite,185,2,105,2018-11-05T20:00:00Z,False,8,9,0,0,5,4,1,3,1,2,2,0
Ayite,185,2,116,2018-11-11T12:00:00Z,False,8,11,0,0,5,4,1,27,13,14,-22,-12
Ayite,185,2,124,2018-11-24T15:00:00Z,True,8,15,4,1,5,4,1,8,4,4,-3,0
Ayite,185,2,132,2018-12-02T12:00:00Z,False,8,5,45,1,8,7,1,28,15,13,-20,-14
Ayite,185,2,143,2018-12-05T19:45:00Z,True,8,10,0,0,8,7,1,21,11,10,-13,-3
Ayite,185,2,157,2018-12-08T15:00:00Z,False,8,13,0,0,9,8,1,23,12,11,-14,-11
Ayite,185,2,162,2018-12-15T17:30:00Z,True,8,18,0,0,9,8,1,21,13,8,-12,0
Ayite,185,2,177,2018-12-22T15:00:00Z,False,8,14,8,1,9,8,1,16,6,10,-7,-5
Ayite,185,2,183,2018-12-26T12:30:00Z,True,8,19,0,0,10,8,2,25,14,11,-15,-3
Ayite,185,2,193,2018-12-29T15:00:00Z,True,8,9,0,0,11,9,2,10,5,5,1,4
Ayite,185,2,200,2019-01-01T15:00:00Z,False,8,0,0,0,14,12,2,38,23,15,-24,-21
Ayite,185,2,211,2019-01-12T15:00:00Z,False,8,3,0,0,14,12,2,18,10,8,-4,-8
Ayite,185,2,222,2019-01-20T16:00:00Z,True,8,16,0,0,14,12,2,48,18,30,-34,-18
Ayite,185,2,232,2019-01-29T19:45:00Z,True,8,2,0,0,14,12,2,26,18,8,-12,4
Ayite,185,2,244,2019-02-02T15:00:00Z,False,8,6,2,1,17,15,2,23,9,14,-6,-7
Ayite,185,2,252,2019-02-09T12:30:00Z,True,8,13,0,0,17,15,2,48,25,23,-31,-8
Ayite,185,2,269,2019-02-22T19:45:00Z,False,8,18,0,0,17,15,2,33,18,15,-16,-16
Ayite,185,2,279,2019-02-27T19:45:00Z,False,8,15,0,0,17,15,2,24,12,12,-7,-10
Ayite,185,2,284,2019-03-03T14:05:00Z,True,8,5,19,1,17,15,2,53,31,22,-36,-7
Ayite,185,2,295,2019-03-09T15:00:00Z,False,8,10,45,6,17,15,2,35,17,18,-18,-15
Ayite,185,2,304,2019-03-17T14:15:00Z,True,8,11,90,2,17,15,2,73,41,32,-56,-17
Ayite,185,2,315,2019-03-30T12:30:00Z,True,8,12,63,2,17,15,2,74,45,29,-57,-14
Ayite,185,2,328,2019-04-02T18:45:00Z,False,8,17,0,0,17,15,2,43,23,20,-26,-21
Ayite,185,2,333,2019-04-13T14:00:00Z,True,8,7,0,0,17,15,2,46,28,18,-29,-3
Ayite,185,2,341,2019-04-20T14:00:00Z,False,8,1,4,1,20,18,2,41,26,15,-21,-24
Ayite,185,2,353,2019-04-27T14:00:00Z,True,8,4,1,1,23,18,5,31,20,11,-8,7
Ayite,185,2,369,2019-05-04T14:00:00Z,False,8,19,8,1,26,21,5,54,31,23,-28,-26
Ayite,185,2,373,2019-05-12T14:00:00Z,True,8,14,73,2,26,21,5,42,25,17,-16,4
Kebano,186,2,2,2018-08-11T14:00:00Z,True,8,6,0,0,0,0,0,0,0,0,0,0
Kebano,186,2,18,2018-08-18T14:00:00Z,False,8,16,0,0,0,0,0,3,0,3,-3,0
Kebano,186,2,22,2018-08-26T15:00:00Z,True,8,3,0,0,0,0,0,1,0,1,-1,-1
Kebano,186,2,30,2018-09-01T14:00:00Z,False,8,2,0,0,3,3,0,3,3,0,0,-3
Kebano,186,2,44,2018-09-15T14:00:00Z,False,8,12,0,0,4,3,1,10,6,4,-6,-5
Kebano,186,2,55,2018-09-22T11:30:00Z,True,8,17,0,0,4,3,1,12,9,3,-8,0
Kebano,186,2,64,2018-09-29T14:00:00Z,False,8,7,0,0,5,4,1,6,4,2,-1,-3
Kebano,186,2,73,2018-10-07T11:00:00Z,True,8,0,0,0,5,4,1,15,9,6,-10,-2
Kebano,186,2,82,2018-10-20T14:00:00Z,False,8,4,0,0,5,4,1,2,1,1,3,0
Kebano,186,2,93,2018-10-27T14:00:00Z,True,8,1,0,0,5,4,1,17,11,6,-12,-2
Kebano,186,2,105,2018-11-05T20:00:00Z,False,8,9,0,0,5,4,1,3,1,2,2,0
Kebano,186,2,116,2018-11-11T12:00:00Z,False,8,11,0,0,5,4,1,27,13,14,-22,-12
Kebano,186,2,124,2018-11-24T15:00:00Z,True,8,15,0,0,5,4,1,8,4,4,-3,0
Kebano,186,2,132,2018-12-02T12:00:00Z,False,8,5,14,1,8,7,1,28,15,13,-20,-14
Kebano,186,2,143,2018-12-05T19:45:00Z,True,8,10,0,0,8,7,1,21,11,10,-13,-3
Kebano,186,2,157,2018-12-08T15:00:00Z,False,8,13,0,0,9,8,1,23,12,11,-14,-11
Kebano,186,2,162,2018-12-15T17:30:00Z,True,8,18,13,1,9,8,1,21,13,8,-12,0
Kebano,186,2,177,2018-12-22T15:00:00Z,False,8,14,0,0,9,8,1,16,6,10,-7,-5
Kebano,186,2,183,2018-12-26T12:30:00Z,True,8,19,0,0,10,8,2,25,14,11,-15,-3
Kebano,186,2,193,2018-12-29T15:00:00Z,True,8,9,0,0,11,9,2,10,5,5,1,4
Kebano,186,2,200,2019-01-01T15:00:00Z,False,8,0,0,0,14,12,2,38,23,15,-24,-21
Kebano,186,2,211,2019-01-12T15:00:00Z,False,8,3,13,1,14,12,2,18,10,8,-4,-8
Kebano,186,2,222,2019-01-20T16:00:00Z,True,8,16,18,1,14,12,2,48,18,30,-34,-18
Kebano,186,2,232,2019-01-29T19:45:00Z,True,8,2,0,0,14,12,2,26,18,8,-12,4
Kebano,186,2,244,2019-02-02T15:00:00Z,False,8,6,0,0,17,15,2,23,9,14,-6,-7
Kebano,186,2,252,2019-02-09T12:30:00Z,True,8,13,0,0,17,15,2,48,25,23,-31,-8
Kebano,186,2,269,2019-02-22T19:45:00Z,False,8,18,0,0,17,15,2,33,18,15,-16,-16
Kebano,186,2,279,2019-02-27T19:45:00Z,False,8,15,0,0,17,15,2,24,12,12,-7,-10
Kebano,186,2,284,2019-03-03T14:05:00Z,True,8,5,0,0,17,15,2,53,31,22,-36,-7
Kebano,186,2,295,2019-03-09T15:00:00Z,False,8,10,0,0,17,15,2,35,17,18,-18,-15
Kebano,186,2,304,2019-03-17T14:15:00Z,True,8,11,8,1,17,15,2,73,41,32,-56,-17
Kebano,186,2,315,2019-03-30T12:30:00Z,True,8,12,26,1,17,15,2,74,45,29,-57,-14
Kebano,186,2,328,2019-04-02T18:45:00Z,False,8,17,0,0,17,15,2,43,23,20,-26,-21
Kebano,186,2,333,2019-04-13T14:00:00Z,True,8,7,0,0,17,15,2,46,28,18,-29,-3
Kebano,186,2,341,2019-04-20T14:00:00Z,False,8,1,0,0,20,18,2,41,26,15,-21,-24
Kebano,186,2,353,2019-04-27T14:00:00Z,True,8,4,0,0,23,18,5,31,20,11,-8,7
Kebano,186,2,369,2019-05-04T14:00:00Z,False,8,19,0,0,26,21,5,54,31,23,-28,-26
Kebano,186,2,373,2019-05-12T14:00:00Z,True,8,14,9,1,26,21,5,42,25,17,-16,4
Fonte,187,2,2,2018-08-11T14:00:00Z,True,8,6,0,0,0,0,0,0,0,0,0,0
Fonte,187,2,18,2018-08-18T14:00:00Z,False,8,16,0,0,0,0,0,3,0,3,-3,0
Fonte,187,2,22,2018-08-26T15:00:00Z,True,8,3,0,0,0,0,0,1,0,1,-1,-1
Fonte,187,2,30,2018-09-01T14:00:00Z,False,8,2,0,0,3,3,0,3,3,0,0,-3
Fonte,187,2,44,2018-09-15T14:00:00Z,False,8,12,0,0,4,3,1,10,6,4,-6,-5
Fonte,187,2,55,2018-09-22T11:30:00Z,True,8,17,0,0,4,3,1,12,9,3,-8,0
Fonte,187,2,64,2018-09-29T14:00:00Z,False,8,7,0,0,5,4,1,6,4,2,-1,-3
Fonte,187,2,73,2018-10-07T11:00:00Z,True,8,0,0,0,5,4,1,15,9,6,-10,-2
Fonte,187,2,82,2018-10-20T14:00:00Z,False,8,4,0,0,5,4,1,2,1,1,3,0
Fonte,187,2,93,2018-10-27T14:00:00Z,True,8,1,0,0,5,4,1,17,11,6,-12,-2
Fonte,187,2,105,2018-11-05T20:00:00Z,False,8,9,0,0,5,4,1,3,1,2,2,0
Fonte,187,2,116,2018-11-11T12:00:00Z,False,8,11,0,0,5,4,1,27,13,14,-22,-12
Fonte,187,2,124,2018-11-24T15:00:00Z,True,8,15,0,0,5,4,1,8,4,4,-3,0
Fonte,187,2,132,2018-12-02T12:00:00Z,False,8,5,0,0,8,7,1,28,15,13,-20,-14
Fonte,187,2,143,2018-12-05T19:45:00Z,True,8,10,0,0,8,7,1,21,11,10,-13,-3
Fonte,187,2,157,2018-12-08T15:00:00Z,False,8,13,0,0,9,8,1,23,12,11,-14,-11
Fonte,187,2,162,2018-12-15T17:30:00Z,True,8,18,0,0,9,8,1,21,13,8,-12,0
Fonte,187,2,177,2018-12-22T15:00:00Z,False,8,14,0,0,9,8,1,16,6,10,-7,-5
Fonte,187,2,183,2018-12-26T12:30:00Z,True,8,19,0,0,10,8,2,25,14,11,-15,-3
Fonte,187,2,193,2018-12-29T15:00:00Z,True,8,9,0,0,11,9,2,10,5,5,1,4
Fonte,187,2,200,2019-01-01T15:00:00Z,False,8,0,0,0,14,12,2,38,23,15,-24,-21
Fonte,187,2,211,2019-01-12T15:00:00Z,False,8,3,0,0,14,12,2,18,10,8,-4,-8
Fonte,187,2,222,2019-01-20T16:00:00Z,True,8,16,0,0,14,12,2,48,18,30,-34,-18
Fonte,187,2,232,2019-01-29T19:45:00Z,True,8,2,0,0,14,12,2,26,18,8,-12,4
Fonte,187,2,244,2019-02-02T15:00:00Z,False,8,6,0,0,17,15,2,23,9,14,-6,-7
Fonte,187,2,252,2019-02-09T12:30:00Z,True,8,13,0,0,17,15,2,48,25,23,-31,-8
Fonte,187,2,269,2019-02-22T19:45:00Z,False,8,18,0,0,17,15,2,33,18,15,-16,-16
Fonte,187,2,279,2019-02-27T19:45:00Z,False,8,15,0,0,17,15,2,24,12,12,-7,-10
Fonte,187,2,284,2019-03-03T14:05:00Z,True,8,5,0,0,17,15,2,53,31,22,-36,-7
Fonte,187,2,295,2019-03-09T15:00:00Z,False,8,10,0,0,17,15,2,35,17,18,-18,-15
Fonte,187,2,304,2019-03-17T14:15:00Z,True,8,11,0,0,17,15,2,73,41,32,-56,-17
Fonte,187,2,315,2019-03-30T12:30:00Z,True,8,12,0,0,17,15,2,74,45,29,-57,-14
Fonte,187,2,328,2019-04-02T18:45:00Z,False,8,17,0,0,17,15,2,43,23,20,-26,-21
Fonte,187,2,333,2019-04-13T14:00:00Z,True,8,7,0,0,17,15,2,46,28,18,-29,-3
Fonte,187,2,341,2019-04-20T14:00:00Z,False,8,1,0,0,20,18,2,41,26,15,-21,-24
Fonte,187,2,353,2019-04-27T14:00:00Z,True,8,4,0,0,23,18,5,31,20,11,-8,7
Fonte,187,2,369,2019-05-04T14:00:00Z,False,8,19,0,0,26,21,5,54,31,23,-28,-26
Fonte,187,2,373,2019-05-12T14:00:00Z,True,8,14,0,0,26,21,5,42,25,17,-16,4
Kamara,188,3,2,2018-08-11T14:00:00Z,True,8,6,29,1,0,0,0,0,0,0,0,0
Kamara,188,3,18,2018-08-18T14:00:00Z,False,8,16,87,2,0,0,0,3,0,3,-3,0
Kamara,188,3,22,2018-08-26T15:00:00Z,True,8,3,0,0,0,0,0,1,0,1,-1,-1
Kamara,188,3,30,2018-09-01T14:00:00Z,False,8,2,0,0,3,3,0,3,3,0,0,-3
Kamara,188,3,44,2018-09-15T14:00:00Z,False,8,12,0,0,4,3,1,10,6,4,-6,-5
Kamara,188,3,55,2018-09-22T11:30:00Z,True,8,17,0,0,4,3,1,12,9,3,-8,0
Kamara,188,3,64,2018-09-29T14:00:00Z,False,8,7,0,0,5,4,1,6,4,2,-1,-3
Kamara,188,3,73,2018-10-07T11:00:00Z,True,8,0,36,1,5,4,1,15,9,6,-10,-2
Kamara,188,3,82,2018-10-20T14:00:00Z,False,8,4,0,0,5,4,1,2,1,1,3,0
Kamara,188,3,93,2018-10-27T14:00:00Z,True,8,1,90,1,5,4,1,17,11,6,-12,-2
Kamara,188,3,105,2018-11-05T20:00:00Z,False,8,9,0,0,5,4,1,3,1,2,2,0
Kamara,188,3,116,2018-11-11T12:00:00Z,False,8,11,0,0,5,4,1,27,13,14,-22,-12
Kamara,188,3,124,2018-11-24T15:00:00Z,True,8,15,16,1,5,4,1,8,4,4,-3,0
Kamara,188,3,132,2018-12-02T12:00:00Z,False,8,5,45,1,8,7,1,28,15,13,-20,-14
Kamara,188,3,143,2018-12-05T19:45:00Z,True,8,10,90,8,8,7,1,21,11,10,-13,-3
Kamara,188,3,157,2018-12-08T15:00:00Z,False,8,13,45,5,9,8,1,23,12,11,-14,-11
Kamara,188,3,162,2018-12-15T17:30:00Z,True,8,18,90,2,9,8,1,21,13,8,-12,0
Kamara,188,3,177,2018-12-22T15:00:00Z,False,8,14,14,0,9,8,1,16,6,10,-7,-5
Kamara,188,3,183,2018-12-26T12:30:00Z,True,8,19,72,2,10,8,2,25,14,11,-15,-3
Kamara,188,3,193,2018-12-29T15:00:00Z,True,8,9,45,-1,11,9,2,10,5,5,1,4
Kamara,188,3,200,2019-01-01T15:00:00Z,False,8,0,29,5,14,12,2,38,23,15,-24,-21
Kamara,188,3,211,2019-01-12T15:00:00Z,False,8,3,0,0,14,12,2,18,10,8,-4,-8
Kamara,188,3,222,2019-01-20T16:00:00Z,True,8,16,0,0,14,12,2,48,18,30,-34,-18
Kamara,188,3,232,2019-01-29T19:45:00Z,True,8,2,0,0,14,12,2,26,18,8,-12,4
Kamara,188,3,244,2019-02-02T15:00:00Z,False,8,6,0,0,17,15,2,23,9,14,-6,-7
Kamara,188,3,252,2019-02-09T12:30:00Z,True,8,13,0,0,17,15,2,48,25,23,-31,-8
Kamara,188,3,269,2019-02-22T19:45:00Z,False,8,18,0,0,17,15,2,33,18,15,-16,-16
Kamara,188,3,279,2019-02-27T19:45:00Z,False,8,15,0,0,17,15,2,24,12,12,-7,-10
Kamara,188,3,284,2019-03-03T14:05:00Z,True,8,5,0,0,17,15,2,53,31,22,-36,-7
Kamara,188,3,295,2019-03-09T15:00:00Z,False,8,10,0,0,17,15,2,35,17,18,-18,-15
Kamara,188,3,304,2019-03-17T14:15:00Z,True,8,11,0,0,17,15,2,73,41,32,-56,-17
Kamara,188,3,315,2019-03-30T12:30:00Z,True,8,12,0,0,17,15,2,74,45,29,-57,-14
Kamara,188,3,328,2019-04-02T18:45:00Z,False,8,17,0,0,17,15,2,43,23,20,-26,-21
Kamara,188,3,333,2019-04-13T14:00:00Z,True,8,7,0,0,17,15,2,46,28,18,-29,-3
Kamara,188,3,341,2019-04-20T14:00:00Z,False,8,1,0,0,20,18,2,41,26,15,-21,-24
Kamara,188,3,353,2019-04-27T14:00:00Z,True,8,4,0,0,23,18,5,31,20,11,-8,7
Kamara,188,3,369,2019-05-04T14:00:00Z,False,8,19,0,0,26,21,5,54,31,23,-28,-26
Kamara,188,3,373,2019-05-12T14:00:00Z,True,8,14,0,0,26,21,5,42,25,17,-16,4
Hamer,189,0,3,2018-08-11T14:00:00Z,True,9,5,90,1,0,0,0,0,0,0,0,0
Hamer,189,0,17,2018-08-19T12:30:00Z,False,9,12,90,2,0,0,0,3,0,3,-3,0
Hamer,189,0,23,2018-08-25T14:00:00Z,True,9,4,12,1,0,0,0,1,1,0,-1,0
Hamer,189,0,35,2018-09-01T14:00:00Z,False,9,7,0,0,1,1,0,5,3,2,-4,-3
Hamer,189,0,43,2018-09-15T14:00:00Z,True,9,6,0,0,2,1,1,3,0,3,-1,-2
Hamer,189,0,56,2018-09-22T14:00:00Z,False,9,10,0,0,2,1,1,6,3,3,-4,-2
Hamer,189,0,65,2018-09-29T14:00:00Z,True,9,16,0,0,2,1,1,12,3,9,-10,-8
Hamer,189,0,71,2018-10-06T14:00:00Z,False,9,3,0,0,2,1,1,7,3,4,-5,-2
Hamer,189,0,85,2018-10-20T16:30:00Z,True,9,11,0,0,3,1,2,20,10,10,-17,-9
Hamer,189,0,99,2018-10-27T14:00:00Z,False,9,17,0,0,3,1,2,16,9,7,-13,-7
Hamer,189,0,105,2018-11-05T20:00:00Z,True,9,8,0,0,3,1,2,5,4,1,-2,0
Hamer,189,0,114,2018-11-10T15:00:00Z,True,9,18,0,0,6,4,2,11,7,4,-5,0
Hamer,189,0,129,2018-11-25T16:00:00Z,False,9,19,0,0,7,5,2,16,8,8,-9,-6
Hamer,189,0,134,2018-12-01T15:00:00Z,True,9,2,0,0,10,5,5,15,11,4,-5,1
Hamer,189,0,140,2018-12-04T19:45:00Z,False,9,1,0,0,10,5,5,20,11,9,-10,-6
Hamer,189,0,150,2018-12-08T15:00:00Z,False,9,0,0,0,10,5,5,31,17,14,-21,-12
Hamer,189,0,163,2018-12-15T15:00:00Z,True,9,14,0,0,10,5,5,13,6,7,-3,-2
Hamer,189,0,175,2018-12-22T15:00:00Z,True,9,15,0,0,10,5,5,12,8,4,-2,1
Hamer,189,0,186,2018-12-26T15:00:00Z,False,9,13,0,0,10,5,5,29,15,14,-19,-10
Hamer,189,0,193,2018-12-29T15:00:00Z,False,9,8,0,0,10,5,5,11,9,2,-1,-4
Hamer,189,0,205,2019-01-02T19:45:00Z,True,9,3,0,0,10,5,5,15,10,5,-5,0
Hamer,189,0,212,2019-01-12T15:00:00Z,False,9,4,0,0,10,5,5,18,13,5,-8,-8
Hamer,189,0,223,2019-01-20T13:30:00Z,True,9,12,0,0,11,5,6,53,33,20,-42,-15
Hamer,189,0,233,2019-01-29T19:45:00Z,True,9,7,0,0,11,5,6,30,21,9,-19,-4
Hamer,189,0,243,2019-02-02T15:00:00Z,False,9,5,0,0,11,5,6,47,25,22,-36,-19
Hamer,189,0,253,2019-02-09T15:00:00Z,True,9,0,90,1,11,5,6,47,32,15,-36,-10
Hamer,189,0,268,2019-02-23T15:00:00Z,False,9,14,0,0,11,5,6,25,13,12,-14,-7
Hamer,189,0,273,2019-02-26T19:45:00Z,True,9,19,0,0,11,5,6,40,21,19,-29,-14
Hamer,189,0,281,2019-03-02T15:00:00Z,False,9,2,0,0,14,8,6,27,19,8,-13,-13
Hamer,189,0,294,2019-03-09T15:00:00Z,True,9,1,0,0,14,8,6,34,25,9,-20,-1
Hamer,189,0,308,2019-03-16T15:00:00Z,False,9,18,0,0,14,8,6,39,24,15,-25,-18
Hamer,189,0,314,2019-03-30T15:00:00Z,False,9,6,90,2,14,8,6,33,13,20,-19,-7
Hamer,189,0,323,2019-04-06T14:00:00Z,True,9,10,90,2,14,8,6,44,23,21,-30,-13
Hamer,189,0,338,2019-04-13T11:30:00Z,False,9,16,90,0,14,8,6,64,31,33,-50,-25
Hamer,189,0,345,2019-04-20T14:00:00Z,True,9,17,0,0,14,8,6,46,26,20,-32,-12
Hamer,189,0,355,2019-04-26T19:00:00Z,False,9,11,0,0,14,8,6,88,47,41,-74,-41
Hamer,189,0,365,2019-05-05T13:00:00Z,True,9,13,0,0,14,8,6,65,36,29,-51,-21
Hamer,189,0,377,2019-05-12T14:00:00Z,False,9,15,0,0,15,9,6,38,22,16,-23,-16
Lossl,190,0,3,2018-08-11T14:00:00Z,True,9,5,0,0,0,0,0,0,0,0,0,0
Lossl,190,0,17,2018-08-19T12:30:00Z,False,9,12,0,0,0,0,0,3,0,3,-3,0
Lossl,190,0,23,2018-08-25T14:00:00Z,True,9,4,77,9,0,0,0,1,1,0,-1,0
Lossl,190,0,35,2018-09-01T14:00:00Z,False,9,7,90,2,1,1,0,5,3,2,-4,-3
Lossl,190,0,43,2018-09-15T14:00:00Z,True,9,6,90,2,2,1,1,3,0,3,-1,-2
Lossl,190,0,56,2018-09-22T14:00:00Z,False,9,10,90,2,2,1,1,6,3,3,-4,-2
Lossl,190,0,65,2018-09-29T14:00:00Z,True,9,16,90,2,2,1,1,12,3,9,-10,-8
Lossl,190,0,71,2018-10-06T14:00:00Z,False,9,3,90,2,2,1,1,7,3,4,-5,-2
Lossl,190,0,85,2018-10-20T16:30:00Z,True,9,11,90,2,3,1,2,20,10,10,-17,-9
Lossl,190,0,99,2018-10-27T14:00:00Z,False,9,17,90,2,3,1,2,16,9,7,-13,-7
Lossl,190,0,105,2018-11-05T20:00:00Z,True,9,8,90,6,3,1,2,5,4,1,-2,0
Lossl,190,0,114,2018-11-10T15:00:00Z,True,9,18,90,2,6,4,2,11,7,4,-5,0
Lossl,190,0,129,2018-11-25T16:00:00Z,False,9,19,90,6,7,5,2,16,8,8,-9,-6
Lossl,190,0,134,2018-12-01T15:00:00Z,True,9,2,90,2,10,5,5,15,11,4,-5,1
Lossl,190,0,140,2018-12-04T19:45:00Z,False,9,1,90,1,10,5,5,20,11,9,-10,-6
Lossl,190,0,150,2018-12-08T15:00:00Z,False,9,0,90,2,10,5,5,31,17,14,-21,-12
Lossl,190,0,163,2018-12-15T15:00:00Z,True,9,14,90,3,10,5,5,13,6,7,-3,-2
Lossl,190,0,175,2018-12-22T15:00:00Z,True,9,15,90,2,10,5,5,12,8,4,-2,1
Lossl,190,0,186,2018-12-26T15:00:00Z,False,9,13,90,3,10,5,5,29,15,14,-19,-10
Lossl,190,0,193,2018-12-29T15:00:00Z,False,9,8,90,11,10,5,5,11,9,2,-1,-4
Lossl,190,0,205,2019-01-02T19:45:00Z,True,9,3,90,3,10,5,5,15,10,5,-5,0
Lossl,190,0,212,2019-01-12T15:00:00Z,False,9,4,90,6,10,5,5,18,13,5,-8,-8
Lossl,190,0,223,2019-01-20T13:30:00Z,True,9,12,90,1,11,5,6,53,33,20,-42,-15
Lossl,190,0,233,2019-01-29T19:45:00Z,True,9,7,90,3,11,5,6,30,21,9,-19,-4
Lossl,190,0,243,2019-02-02T15:00:00Z,False,9,5,90,0,11,5,6,47,25,22,-36,-19
Lossl,190,0,253,2019-02-09T15:00:00Z,True,9,0,0,0,11,5,6,47,32,15,-36,-10
Lossl,190,0,268,2019-02-23T15:00:00Z,False,9,14,90,5,11,5,6,25,13,12,-14,-7
Lossl,190,0,273,2019-02-26T19:45:00Z,True,9,19,90,6,11,5,6,40,21,19,-29,-14
Lossl,190,0,281,2019-03-02T15:00:00Z,False,9,2,90,2,14,8,6,27,19,8,-13,-13
Lossl,190,0,294,2019-03-09T15:00:00Z,True,9,1,90,1,14,8,6,34,25,9,-20,-1
Lossl,190,0,308,2019-03-16T15:00:00Z,False,9,18,90,0,14,8,6,39,24,15,-25,-18
Lossl,190,0,314,2019-03-30T15:00:00Z,False,9,6,0,0,14,8,6,33,13,20,-19,-7
Lossl,190,0,323,2019-04-06T14:00:00Z,True,9,10,0,0,14,8,6,44,23,21,-30,-13
Lossl,190,0,338,2019-04-13T11:30:00Z,False,9,16,0,0,14,8,6,64,31,33,-50,-25
Lossl,190,0,345,2019-04-20T14:00:00Z,True,9,17,90,2,14,8,6,46,26,20,-32,-12
Lossl,190,0,355,2019-04-26T19:00:00Z,False,9,11,90,0,14,8,6,88,47,41,-74,-41
Lossl,190,0,365,2019-05-05T13:00:00Z,True,9,13,90,9,14,8,6,65,36,29,-51,-21
Lossl,190,0,377,2019-05-12T14:00:00Z,False,9,15,0,0,15,9,6,38,22,16,-23,-16
Schindler,191,1,3,2018-08-11T14:00:00Z,True,9,5,90,0,0,0,0,0,0,0,0,0
Schindler,191,1,17,2018-08-19T12:30:00Z,False,9,12,90,-2,0,0,0,3,0,3,-3,0
Schindler,191,1,23,2018-08-25T14:00:00Z,True,9,4,90,9,0,0,0,1,1,0,-1,0
Schindler,191,1,35,2018-09-01T14:00:00Z,False,9,7,90,2,1,1,0,5,3,2,-4,-3
Schindler,191,1,43,2018-09-15T14:00:00Z,True,9,6,90,2,2,1,1,3,0,3,-1,-2
Schindler,191,1,56,2018-09-22T14:00:00Z,False,9,10,90,1,2,1,1,6,3,3,-4,-2
Schindler,191,1,65,2018-09-29T14:00:00Z,True,9,16,70,1,2,1,1,12,3,9,-10,-8
Schindler,191,1,71,2018-10-06T14:00:00Z,False,9,3,90,8,2,1,1,7,3,4,-5,-2
Schindler,191,1,85,2018-10-20T16:30:00Z,True,9,11,90,2,3,1,2,20,10,10,-17,-9
Schindler,191,1,99,2018-10-27T14:00:00Z,False,9,17,90,1,3,1,2,16,9,7,-13,-7
Schindler,191,1,105,2018-11-05T20:00:00Z,True,9,8,90,11,3,1,2,5,4,1,-2,0
Schindler,191,1,114,2018-11-10T15:00:00Z,True,9,18,90,2,6,4,2,11,7,4,-5,0
Schindler,191,1,129,2018-11-25T16:00:00Z,False,9,19,90,8,7,5,2,16,8,8,-9,-6
Schindler,191,1,134,2018-12-01T15:00:00Z,True,9,2,90,1,10,5,5,15,11,4,-5,1
Schindler,191,1,140,2018-12-04T19:45:00Z,False,9,1,90,1,10,5,5,20,11,9,-10,-6
Schindler,191,1,150,2018-12-08T15:00:00Z,False,9,0,90,2,10,5,5,31,17,14,-21,-12
Schindler,191,1,163,2018-12-15T15:00:00Z,True,9,14,90,2,10,5,5,13,6,7,-3,-2
Schindler,191,1,175,2018-12-22T15:00:00Z,True,9,15,90,1,10,5,5,12,8,4,-2,1
Schindler,191,1,186,2018-12-26T15:00:00Z,False,9,13,90,1,10,5,5,29,15,14,-19,-10
Schindler,191,1,193,2018-12-29T15:00:00Z,False,9,8,90,2,10,5,5,11,9,2,-1,-4
Schindler,191,1,205,2019-01-02T19:45:00Z,True,9,3,40,-3,10,5,5,15,10,5,-5,0
Schindler,191,1,212,2019-01-12T15:00:00Z,False,9,4,90,5,10,5,5,18,13,5,-8,-8
Schindler,191,1,223,2019-01-20T13:30:00Z,True,9,12,90,1,11,5,6,53,33,20,-42,-15
Schindler,191,1,233,2019-01-29T19:45:00Z,True,9,7,90,2,11,5,6,30,21,9,-19,-4
Schindler,191,1,243,2019-02-02T15:00:00Z,False,9,5,90,0,11,5,6,47,25,22,-36,-19
Schindler,191,1,253,2019-02-09T15:00:00Z,True,9,0,90,0,11,5,6,47,32,15,-36,-10
Schindler,191,1,268,2019-02-23T15:00:00Z,False,9,14,90,1,11,5,6,25,13,12,-14,-7
Schindler,191,1,273,2019-02-26T19:45:00Z,True,9,19,90,6,11,5,6,40,21,19,-29,-14
Schindler,191,1,281,2019-03-02T15:00:00Z,False,9,2,90,2,14,8,6,27,19,8,-13,-13
Schindler,191,1,294,2019-03-09T15:00:00Z,True,9,1,90,1,14,8,6,34,25,9,-20,-1
Schindler,191,1,308,2019-03-16T15:00:00Z,False,9,18,0,0,14,8,6,39,24,15,-25,-18
Schindler,191,1,314,2019-03-30T15:00:00Z,False,9,6,90,1,14,8,6,33,13,20,-19,-7
Schindler,191,1,323,2019-04-06T14:00:00Z,True,9,10,90,0,14,8,6,44,23,21,-30,-13
Schindler,191,1,338,2019-04-13T11:30:00Z,False,9,16,90,0,14,8,6,64,31,33,-50,-25
Schindler,191,1,345,2019-04-20T14:00:00Z,True,9,17,90,1,14,8,6,46,26,20,-32,-12
Schindler,191,1,355,2019-04-26T19:00:00Z,False,9,11,90,0,14,8,6,88,47,41,-74,-41
Schindler,191,1,365,2019-05-05T13:00:00Z,True,9,13,90,2,14,8,6,65,36,29,-51,-21
Schindler,191,1,377,2019-05-12T14:00:00Z,False,9,15,90,2,15,9,6,38,22,16,-23,-16
Lowe,192,1,3,2018-08-11T14:00:00Z,True,9,5,70,1,0,0,0,0,0,0,0,0
Lowe,192,1,17,2018-08-19T12:30:00Z,False,9,12,90,-1,0,0,0,3,0,3,-3,0
Lowe,192,1,23,2018-08-25T14:00:00Z,True,9,4,0,0,0,0,0,1,1,0,-1,0
Lowe,192,1,35,2018-09-01T14:00:00Z,False,9,7,90,6,1,1,0,5,3,2,-4,-3
Lowe,192,1,43,2018-09-15T14:00:00Z,True,9,6,90,2,2,1,1,3,0,3,-1,-2
Lowe,192,1,56,2018-09-22T14:00:00Z,False,9,10,90,1,2,1,1,6,3,3,-4,-2
Lowe,192,1,65,2018-09-29T14:00:00Z,True,9,16,90,1,2,1,1,12,3,9,-10,-8
Lowe,192,1,71,2018-10-06T14:00:00Z,False,9,3,85,7,2,1,1,7,3,4,-5,-2
Lowe,192,1,85,2018-10-20T16:30:00Z,True,9,11,90,2,3,1,2,20,10,10,-17,-9
Lowe,192,1,99,2018-10-27T14:00:00Z,False,9,17,90,1,3,1,2,16,9,7,-13,-7
Lowe,192,1,105,2018-11-05T20:00:00Z,True,9,8,90,9,3,1,2,5,4,1,-2,0
Lowe,192,1,114,2018-11-10T15:00:00Z,True,9,18,44,1,6,4,2,11,7,4,-5,0
Lowe,192,1,129,2018-11-25T16:00:00Z,False,9,19,0,0,7,5,2,16,8,8,-9,-6
Lowe,192,1,134,2018-12-01T15:00:00Z,True,9,2,0,0,10,5,5,15,11,4,-5,1
Lowe,192,1,140,2018-12-04T19:45:00Z,False,9,1,0,0,10,5,5,20,11,9,-10,-6
Lowe,192,1,150,2018-12-08T15:00:00Z,False,9,0,90,2,10,5,5,31,17,14,-21,-12
Lowe,192,1,163,2018-12-15T15:00:00Z,True,9,14,59,1,10,5,5,13,6,7,-3,-2
Lowe,192,1,175,2018-12-22T15:00:00Z,True,9,15,45,-1,10,5,5,12,8,4,-2,1
Lowe,192,1,186,2018-12-26T15:00:00Z,False,9,13,33,0,10,5,5,29,15,14,-19,-10
Lowe,192,1,193,2018-12-29T15:00:00Z,False,9,8,90,2,10,5,5,11,9,2,-1,-4
Lowe,192,1,205,2019-01-02T19:45:00Z,True,9,3,19,1,10,5,5,15,10,5,-5,0
Lowe,192,1,212,2019-01-12T15:00:00Z,False,9,4,0,0,10,5,5,18,13,5,-8,-8
Lowe,192,1,223,2019-01-20T13:30:00Z,True,9,12,90,1,11,5,6,53,33,20,-42,-15
Lowe,192,1,233,2019-01-29T19:45:00Z,True,9,7,9,1,11,5,6,30,21,9,-19,-4
Lowe,192,1,243,2019-02-02T15:00:00Z,False,9,5,90,0,11,5,6,47,25,22,-36,-19
Lowe,192,1,253,2019-02-09T15:00:00Z,True,9,0,0,0,11,5,6,47,32,15,-36,-10
Lowe,192,1,268,2019-02-23T15:00:00Z,False,9,14,90,1,11,5,6,25,13,12,-14,-7
Lowe,192,1,273,2019-02-26T19:45:00Z,True,9,19,0,0,11,5,6,40,21,19,-29,-14
Lowe,192,1,281,2019-03-02T15:00:00Z,False,9,2,0,0,14,8,6,27,19,8,-13,-13
Lowe,192,1,294,2019-03-09T15:00:00Z,True,9,1,45,1,14,8,6,34,25,9,-20,-1
Lowe,192,1,308,2019-03-16T15:00:00Z,False,9,18,90,3,14,8,6,39,24,15,-25,-18
Lowe,192,1,314,2019-03-30T15:00:00Z,False,9,6,79,2,14,8,6,33,13,20,-19,-7
Lowe,192,1,323,2019-04-06T14:00:00Z,True,9,10,90,0,14,8,6,44,23,21,-30,-13
Lowe,192,1,338,2019-04-13T11:30:00Z,False,9,16,90,-1,14,8,6,64,31,33,-50,-25
Lowe,192,1,345,2019-04-20T14:00:00Z,True,9,17,9,4,14,8,6,46,26,20,-32,-12
Lowe,192,1,355,2019-04-26T19:00:00Z,False,9,11,25,0,14,8,6,88,47,41,-74,-41
Lowe,192,1,365,2019-05-05T13:00:00Z,True,9,13,90,2,14,8,6,65,36,29,-51,-21
Lowe,192,1,377,2019-05-12T14:00:00Z,False,9,15,0,0,15,9,6,38,22,16,-23,-16
Smith,193,1,3,2018-08-11T14:00:00Z,True,9,5,0,0,0,0,0,0,0,0,0,0
Smith,193,1,17,2018-08-19T12:30:00Z,False,9,12,90,-1,0,0,0,3,0,3,-3,0
Smith,193,1,23,2018-08-25T14:00:00Z,True,9,4,0,0,0,0,0,1,1,0,-1,0
Smith,193,1,35,2018-09-01T14:00:00Z,False,9,7,0,0,1,1,0,5,3,2,-4,-3
Smith,193,1,43,2018-09-15T14:00:00Z,True,9,6,0,0,2,1,1,3,0,3,-1,-2
Smith,193,1,56,2018-09-22T14:00:00Z,False,9,10,0,0,2,1,1,6,3,3,-4,-2
Smith,193,1,65,2018-09-29T14:00:00Z,True,9,16,0,0,2,1,1,12,3,9,-10,-8
Smith,193,1,71,2018-10-06T14:00:00Z,False,9,3,0,0,2,1,1,7,3,4,-5,-2
Smith,193,1,85,2018-10-20T16:30:00Z,True,9,11,0,0,3,1,2,20,10,10,-17,-9
Smith,193,1,99,2018-10-27T14:00:00Z,False,9,17,0,0,3,1,2,16,9,7,-13,-7
Smith,193,1,105,2018-11-05T20:00:00Z,True,9,8,0,0,3,1,2,5,4,1,-2,0
Smith,193,1,114,2018-11-10T15:00:00Z,True,9,18,0,0,6,4,2,11,7,4,-5,0
Smith,193,1,129,2018-11-25T16:00:00Z,False,9,19,90,5,7,5,2,16,8,8,-9,-6
Smith,193,1,134,2018-12-01T15:00:00Z,True,9,2,27,1,10,5,5,15,11,4,-5,1
Smith,193,1,140,2018-12-04T19:45:00Z,False,9,1,0,0,10,5,5,20,11,9,-10,-6
Smith,193,1,150,2018-12-08T15:00:00Z,False,9,0,59,0,10,5,5,31,17,14,-21,-12
Smith,193,1,163,2018-12-15T15:00:00Z,True,9,14,0,0,10,5,5,13,6,7,-3,-2
Smith,193,1,175,2018-12-22T15:00:00Z,True,9,15,0,0,10,5,5,12,8,4,-2,1
Smith,193,1,186,2018-12-26T15:00:00Z,False,9,13,0,0,10,5,5,29,15,14,-19,-10
Smith,193,1,193,2018-12-29T15:00:00Z,False,9,8,0,0,10,5,5,11,9,2,-1,-4
Smith,193,1,205,2019-01-02T19:45:00Z,True,9,3,0,0,10,5,5,15,10,5,-5,0
Smith,193,1,212,2019-01-12T15:00:00Z,False,9,4,0,0,10,5,5,18,13,5,-8,-8
Smith,193,1,223,2019-01-20T13:30:00Z,True,9,12,90,1,11,5,6,53,33,20,-42,-15
Smith,193,1,233,2019-01-29T19:45:00Z,True,9,7,0,0,11,5,6,30,21,9,-19,-4
Smith,193,1,243,2019-02-02T15:00:00Z,False,9,5,90,0,11,5,6,47,25,22,-36,-19
Smith,193,1,253,2019-02-09T15:00:00Z,True,9,0,90,1,11,5,6,47,32,15,-36,-10
Smith,193,1,268,2019-02-23T15:00:00Z,False,9,14,20,-3,11,5,6,25,13,12,-14,-7
Smith,193,1,273,2019-02-26T19:45:00Z,True,9,19,0,0,11,5,6,40,21,19,-29,-14
Smith,193,1,281,2019-03-02T15:00:00Z,False,9,2,0,0,14,8,6,27,19,8,-13,-13
Smith,193,1,294,2019-03-09T15:00:00Z,True,9,1,0,0,14,8,6,34,25,9,-20,-1
Smith,193,1,308,2019-03-16T15:00:00Z,False,9,18,90,0,14,8,6,39,24,15,-25,-18
Smith,193,1,314,2019-03-30T15:00:00Z,False,9,6,90,1,14,8,6,33,13,20,-19,-7
Smith,193,1,323,2019-04-06T14:00:00Z,True,9,10,90,0,14,8,6,44,23,21,-30,-13
Smith,193,1,338,2019-04-13T11:30:00Z,False,9,16,0,0,14,8,6,64,31,33,-50,-25
Smith,193,1,345,2019-04-20T14:00:00Z,True,9,17,90,1,14,8,6,46,26,20,-32,-12
Smith,193,1,355,2019-04-26T19:00:00Z,False,9,11,90,0,14,8,6,88,47,41,-74,-41
Smith,193,1,365,2019-05-05T13:00:00Z,True,9,13,45,1,14,8,6,65,36,29,-51,-21
Smith,193,1,377,2019-05-12T14:00:00Z,False,9,15,90,2,15,9,6,38,22,16,-23,-16
Zanka,194,1,3,2018-08-11T14:00:00Z,True,9,5,90,1,0,0,0,0,0,0,0,0
Zanka,194,1,17,2018-08-19T12:30:00Z,False,9,12,0,0,0,0,0,3,0,3,-3,0
Zanka,194,1,23,2018-08-25T14:00:00Z,True,9,4,90,6,0,0,0,1,1,0,-1,0
Zanka,194,1,35,2018-09-01T14:00:00Z,False,9,7,90,1,1,1,0,5,3,2,-4,-3
Zanka,194,1,43,2018-09-15T14:00:00Z,True,9,6,77,1,2,1,1,3,0,3,-1,-2
Zanka,194,1,56,2018-09-22T14:00:00Z,False,9,10,90,7,2,1,1,6,3,3,-4,-2
Zanka,194,1,65,2018-09-29T14:00:00Z,True,9,16,90,0,2,1,1,12,3,9,-10,-8
Zanka,194,1,71,2018-10-06T14:00:00Z,False,9,3,90,1,2,1,1,7,3,4,-5,-2
Zanka,194,1,85,2018-10-20T16:30:00Z,True,9,11,90,2,3,1,2,20,10,10,-17,-9
Zanka,194,1,99,2018-10-27T14:00:00Z,False,9,17,90,1,3,1,2,16,9,7,-13,-7
Zanka,194,1,105,2018-11-05T20:00:00Z,True,9,8,90,8,3,1,2,5,4,1,-2,0
Zanka,194,1,114,2018-11-10T15:00:00Z,True,9,18,90,1,6,4,2,11,7,4,-5,0
Zanka,194,1,129,2018-11-25T16:00:00Z,False,9,19,0,0,7,5,2,16,8,8,-9,-6
Zanka,194,1,134,2018-12-01T15:00:00Z,True,9,2,90,7,10,5,5,15,11,4,-5,1
Zanka,194,1,140,2018-12-04T19:45:00Z,False,9,1,90,5,10,5,5,20,11,9,-10,-6
Zanka,194,1,150,2018-12-08T15:00:00Z,False,9,0,90,2,10,5,5,31,17,14,-21,-12
Zanka,194,1,163,2018-12-15T15:00:00Z,True,9,14,90,2,10,5,5,13,6,7,-3,-2
Zanka,194,1,175,2018-12-22T15:00:00Z,True,9,15,90,0,10,5,5,12,8,4,-2,1
Zanka,194,1,186,2018-12-26T15:00:00Z,False,9,13,90,8,10,5,5,29,15,14,-19,-10
Zanka,194,1,193,2018-12-29T15:00:00Z,False,9,8,90,2,10,5,5,11,9,2,-1,-4
Zanka,194,1,205,2019-01-02T19:45:00Z,True,9,3,90,1,10,5,5,15,10,5,-5,0
Zanka,194,1,212,2019-01-12T15:00:00Z,False,9,4,90,6,10,5,5,18,13,5,-8,-8
Zanka,194,1,223,2019-01-20T13:30:00Z,True,9,12,0,0,11,5,6,53,33,20,-42,-15
Zanka,194,1,233,2019-01-29T19:45:00Z,True,9,7,90,2,11,5,6,30,21,9,-19,-4
Zanka,194,1,243,2019-02-02T15:00:00Z,False,9,5,0,0,11,5,6,47,25,22,-36,-19
Zanka,194,1,253,2019-02-09T15:00:00Z,True,9,0,90,1,11,5,6,47,32,15,-36,-10
Zanka,194,1,268,2019-02-23T15:00:00Z,False,9,14,90,1,11,5,6,25,13,12,-14,-7
Zanka,194,1,273,2019-02-26T19:45:00Z,True,9,19,0,0,11,5,6,40,21,19,-29,-14
Zanka,194,1,281,2019-03-02T15:00:00Z,False,9,2,0,0,14,8,6,27,19,8,-13,-13
Zanka,194,1,294,2019-03-09T15:00:00Z,True,9,1,90,1,14,8,6,34,25,9,-20,-1
Zanka,194,1,308,2019-03-16T15:00:00Z,False,9,18,0,0,14,8,6,39,24,15,-25,-18
Zanka,194,1,314,2019-03-30T15:00:00Z,False,9,6,0,0,14,8,6,33,13,20,-19,-7
Zanka,194,1,323,2019-04-06T14:00:00Z,True,9,10,0,0,14,8,6,44,23,21,-30,-13
Zanka,194,1,338,2019-04-13T11:30:00Z,False,9,16,0,0,14,8,6,64,31,33,-50,-25
Zanka,194,1,345,2019-04-20T14:00:00Z,True,9,17,0,0,14,8,6,46,26,20,-32,-12
Zanka,194,1,355,2019-04-26T19:00:00Z,False,9,11,0,0,14,8,6,88,47,41,-74,-41
Zanka,194,1,365,2019-05-05T13:00:00Z,True,9,13,0,0,14,8,6,65,36,29,-51,-21
Zanka,194,1,377,2019-05-12T14:00:00Z,False,9,15,0,0,15,9,6,38,22,16,-23,-16
Malone,195,1,3,2018-08-11T14:00:00Z,True,9,5,0,0,0,0,0,0,0,0,0,0
Malone,195,1,17,2018-08-19T12:30:00Z,False,9,12,0,0,0,0,0,3,0,3,-3,0
Malone,195,1,23,2018-08-25T14:00:00Z,True,9,4,0,0,0,0,0,1,1,0,-1,0
Malone,195,1,35,2018-09-01T14:00:00Z,False,9,7,0,0,1,1,0,5,3,2,-4,-3
Malone,195,1,43,2018-09-15T14:00:00Z,True,9,6,0,0,2,1,1,3,0,3,-1,-2
Malone,195,1,56,2018-09-22T14:00:00Z,False,9,10,0,0,2,1,1,6,3,3,-4,-2
Malone,195,1,65,2018-09-29T14:00:00Z,True,9,16,0,0,2,1,1,12,3,9,-10,-8
Malone,195,1,71,2018-10-06T14:00:00Z,False,9,3,0,0,2,1,1,7,3,4,-5,-2
Malone,195,1,85,2018-10-20T16:30:00Z,True,9,11,0,0,3,1,2,20,10,10,-17,-9
Malone,195,1,99,2018-10-27T14:00:00Z,False,9,17,0,0,3,1,2,16,9,7,-13,-7
Malone,195,1,105,2018-11-05T20:00:00Z,True,9,8,0,0,3,1,2,5,4,1,-2,0
Malone,195,1,114,2018-11-10T15:00:00Z,True,9,18,0,0,6,4,2,11,7,4,-5,0
Malone,195,1,129,2018-11-25T16:00:00Z,False,9,19,0,0,7,5,2,16,8,8,-9,-6
Malone,195,1,134,2018-12-01T15:00:00Z,True,9,2,0,0,10,5,5,15,11,4,-5,1
Malone,195,1,140,2018-12-04T19:45:00Z,False,9,1,0,0,10,5,5,20,11,9,-10,-6
Malone,195,1,150,2018-12-08T15:00:00Z,False,9,0,0,0,10,5,5,31,17,14,-21,-12
Malone,195,1,163,2018-12-15T15:00:00Z,True,9,14,0,0,10,5,5,13,6,7,-3,-2
Malone,195,1,175,2018-12-22T15:00:00Z,True,9,15,0,0,10,5,5,12,8,4,-2,1
Malone,195,1,186,2018-12-26T15:00:00Z,False,9,13,0,0,10,5,5,29,15,14,-19,-10
Malone,195,1,193,2018-12-29T15:00:00Z,False,9,8,0,0,10,5,5,11,9,2,-1,-4
Malone,195,1,205,2019-01-02T19:45:00Z,True,9,3,0,0,10,5,5,15,10,5,-5,0
Malone,195,1,212,2019-01-12T15:00:00Z,False,9,4,0,0,10,5,5,18,13,5,-8,-8
Malone,195,1,223,2019-01-20T13:30:00Z,True,9,12,0,0,11,5,6,53,33,20,-42,-15
Malone,195,1,233,2019-01-29T19:45:00Z,True,9,7,0,0,11,5,6,30,21,9,-19,-4
Malone,195,1,243,2019-02-02T15:00:00Z,False,9,5,0,0,11,5,6,47,25,22,-36,-19
Malone,195,1,253,2019-02-09T15:00:00Z,True,9,0,0,0,11,5,6,47,32,15,-36,-10
Malone,195,1,268,2019-02-23T15:00:00Z,False,9,14,0,0,11,5,6,25,13,12,-14,-7
Malone,195,1,273,2019-02-26T19:45:00Z,True,9,19,0,0,11,5,6,40,21,19,-29,-14
Malone,195,1,281,2019-03-02T15:00:00Z,False,9,2,0,0,14,8,6,27,19,8,-13,-13
Malone,195,1,294,2019-03-09T15:00:00Z,True,9,1,0,0,14,8,6,34,25,9,-20,-1
Malone,195,1,308,2019-03-16T15:00:00Z,False,9,18,0,0,14,8,6,39,24,15,-25,-18
Malone,195,1,314,2019-03-30T15:00:00Z,False,9,6,0,0,14,8,6,33,13,20,-19,-7
Malone,195,1,323,2019-04-06T14:00:00Z,True,9,10,0,0,14,8,6,44,23,21,-30,-13
Malone,195,1,338,2019-04-13T11:30:00Z,False,9,16,0,0,14,8,6,64,31,33,-50,-25
Malone,195,1,345,2019-04-20T14:00:00Z,True,9,17,0,0,14,8,6,46,26,20,-32,-12
Malone,195,1,355,2019-04-26T19:00:00Z,False,9,11,0,0,14,8,6,88,47,41,-74,-41
Malone,195,1,365,2019-05-05T13:00:00Z,True,9,13,0,0,14,8,6,65,36,29,-51,-21
Malone,195,1,377,2019-05-12T14:00:00Z,False,9,15,0,0,15,9,6,38,22,16,-23,-16
Hadergjonaj,196,1,3,2018-08-11T14:00:00Z,True,9,5,90,1,0,0,0,0,0,0,0,0
Hadergjonaj,196,1,17,2018-08-19T12:30:00Z,False,9,12,90,-1,0,0,0,3,0,3,-3,0
Hadergjonaj,196,1,23,2018-08-25T14:00:00Z,True,9,4,90,6,0,0,0,1,1,0,-1,0
Hadergjonaj,196,1,35,2018-09-01T14:00:00Z,False,9,7,75,1,1,1,0,5,3,2,-4,-3
Hadergjonaj,196,1,43,2018-09-15T14:00:00Z,True,9,6,90,2,2,1,1,3,0,3,-1,-2
Hadergjonaj,196,1,56,2018-09-22T14:00:00Z,False,9,10,0,0,2,1,1,6,3,3,-4,-2
Hadergjonaj,196,1,65,2018-09-29T14:00:00Z,True,9,16,61,2,2,1,1,12,3,9,-10,-8
Hadergjonaj,196,1,71,2018-10-06T14:00:00Z,False,9,3,4,1,2,1,1,7,3,4,-5,-2
Hadergjonaj,196,1,85,2018-10-20T16:30:00Z,True,9,11,68,2,3,1,2,20,10,10,-17,-9
Hadergjonaj,196,1,99,2018-10-27T14:00:00Z,False,9,17,0,0,3,1,2,16,9,7,-13,-7
Hadergjonaj,196,1,105,2018-11-05T20:00:00Z,True,9,8,90,6,3,1,2,5,4,1,-2,0
Hadergjonaj,196,1,114,2018-11-10T15:00:00Z,True,9,18,90,2,6,4,2,11,7,4,-5,0
Hadergjonaj,196,1,129,2018-11-25T16:00:00Z,False,9,19,90,6,7,5,2,16,8,8,-9,-6
Hadergjonaj,196,1,134,2018-12-01T15:00:00Z,True,9,2,90,1,10,5,5,15,11,4,-5,1
Hadergjonaj,196,1,140,2018-12-04T19:45:00Z,False,9,1,90,1,10,5,5,20,11,9,-10,-6
Hadergjonaj,196,1,150,2018-12-08T15:00:00Z,False,9,0,30,1,10,5,5,31,17,14,-21,-12
Hadergjonaj,196,1,163,2018-12-15T15:00:00Z,True,9,14,90,2,10,5,5,13,6,7,-3,-2
Hadergjonaj,196,1,175,2018-12-22T15:00:00Z,True,9,15,90,1,10,5,5,12,8,4,-2,1
Hadergjonaj,196,1,186,2018-12-26T15:00:00Z,False,9,13,90,1,10,5,5,29,15,14,-19,-10
Hadergjonaj,196,1,193,2018-12-29T15:00:00Z,False,9,8,90,2,10,5,5,11,9,2,-1,-4
Hadergjonaj,196,1,205,2019-01-02T19:45:00Z,True,9,3,70,2,10,5,5,15,10,5,-5,0
Hadergjonaj,196,1,212,2019-01-12T15:00:00Z,False,9,4,90,7,10,5,5,18,13,5,-8,-8
Hadergjonaj,196,1,223,2019-01-20T13:30:00Z,True,9,12,0,0,11,5,6,53,33,20,-42,-15
Hadergjonaj,196,1,233,2019-01-29T19:45:00Z,True,9,7,90,2,11,5,6,30,21,9,-19,-4
Hadergjonaj,196,1,243,2019-02-02T15:00:00Z,False,9,5,0,0,11,5,6,47,25,22,-36,-19
Hadergjonaj,196,1,253,2019-02-09T15:00:00Z,True,9,0,0,0,11,5,6,47,32,15,-36,-10
Hadergjonaj,196,1,268,2019-02-23T15:00:00Z,False,9,14,66,1,11,5,6,25,13,12,-14,-7
Hadergjonaj,196,1,273,2019-02-26T19:45:00Z,True,9,19,0,0,11,5,6,40,21,19,-29,-14
Hadergjonaj,196,1,281,2019-03-02T15:00:00Z,False,9,2,23,1,14,8,6,27,19,8,-13,-13
Hadergjonaj,196,1,294,2019-03-09T15:00:00Z,True,9,1,0,0,14,8,6,34,25,9,-20,-1
Hadergjonaj,196,1,308,2019-03-16T15:00:00Z,False,9,18,0,0,14,8,6,39,24,15,-25,-18
Hadergjonaj,196,1,314,2019-03-30T15:00:00Z,False,9,6,0,0,14,8,6,33,13,20,-19,-7
Hadergjonaj,196,1,323,2019-04-06T14:00:00Z,True,9,10,0,0,14,8,6,44,23,21,-30,-13
Hadergjonaj,196,1,338,2019-04-13T11:30:00Z,False,9,16,90,0,14,8,6,64,31,33,-50,-25
Hadergjonaj,196,1,345,2019-04-20T14:00:00Z,True,9,17,0,0,14,8,6,46,26,20,-32,-12
Hadergjonaj,196,1,355,2019-04-26T19:00:00Z,False,9,11,0,0,14,8,6,88,47,41,-74,-41
Hadergjonaj,196,1,365,2019-05-05T13:00:00Z,True,9,13,0,0,14,8,6,65,36,29,-51,-21
Hadergjonaj,196,1,377,2019-05-12T14:00:00Z,False,9,15,0,0,15,9,6,38,22,16,-23,-16
Kongolo,197,1,3,2018-08-11T14:00:00Z,True,9,5,90,0,0,0,0,0,0,0,0,0
Kongolo,197,1,17,2018-08-19T12:30:00Z,False,9,12,90,-3,0,0,0,3,0,3,-3,0
Kongolo,197,1,23,2018-08-25T14:00:00Z,True,9,4,90,6,0,0,0,1,1,0,-1,0
Kongolo,197,1,35,2018-09-01T14:00:00Z,False,9,7,90,2,1,1,0,5,3,2,-4,-3
Kongolo,197,1,43,2018-09-15T14:00:00Z,True,9,6,90,2,2,1,1,3,0,3,-1,-2
Kongolo,197,1,56,2018-09-22T14:00:00Z,False,9,10,71,0,2,1,1,6,3,3,-4,-2
Kongolo,197,1,65,2018-09-29T14:00:00Z,True,9,16,28,1,2,1,1,12,3,9,-10,-8
Kongolo,197,1,71,2018-10-06T14:00:00Z,False,9,3,0,0,2,1,1,7,3,4,-5,-2
Kongolo,197,1,85,2018-10-20T16:30:00Z,True,9,11,0,0,3,1,2,20,10,10,-17,-9
Kongolo,197,1,99,2018-10-27T14:00:00Z,False,9,17,0,0,3,1,2,16,9,7,-13,-7
Kongolo,197,1,105,2018-11-05T20:00:00Z,True,9,8,89,6,3,1,2,5,4,1,-2,0
Kongolo,197,1,114,2018-11-10T15:00:00Z,True,9,18,90,2,6,4,2,11,7,4,-5,0
Kongolo,197,1,129,2018-11-25T16:00:00Z,False,9,19,90,6,7,5,2,16,8,8,-9,-6
Kongolo,197,1,134,2018-12-01T15:00:00Z,True,9,2,90,1,10,5,5,15,11,4,-5,1
Kongolo,197,1,140,2018-12-04T19:45:00Z,False,9,1,74,7,10,5,5,20,11,9,-10,-6
Kongolo,197,1,150,2018-12-08T15:00:00Z,False,9,0,90,2,10,5,5,31,17,14,-21,-12
Kongolo,197,1,163,2018-12-15T15:00:00Z,True,9,14,59,1,10,5,5,13,6,7,-3,-2
Kongolo,197,1,175,2018-12-22T15:00:00Z,True,9,15,90,1,10,5,5,12,8,4,-2,1
Kongolo,197,1,186,2018-12-26T15:00:00Z,False,9,13,90,1,10,5,5,29,15,14,-19,-10
Kongolo,197,1,193,2018-12-29T15:00:00Z,False,9,8,90,2,10,5,5,11,9,2,-1,-4
Kongolo,197,1,205,2019-01-02T19:45:00Z,True,9,3,90,1,10,5,5,15,10,5,-5,0
Kongolo,197,1,212,2019-01-12T15:00:00Z,False,9,4,0,0,10,5,5,18,13,5,-8,-8
Kongolo,197,1,223,2019-01-20T13:30:00Z,True,9,12,90,1,11,5,6,53,33,20,-42,-15
Kongolo,197,1,233,2019-01-29T19:45:00Z,True,9,7,90,2,11,5,6,30,21,9,-19,-4
Kongolo,197,1,243,2019-02-02T15:00:00Z,False,9,5,90,0,11,5,6,47,25,22,-36,-19
Kongolo,197,1,253,2019-02-09T15:00:00Z,True,9,0,55,-1,11,5,6,47,32,15,-36,-10
Kongolo,197,1,268,2019-02-23T15:00:00Z,False,9,14,0,0,11,5,6,25,13,12,-14,-7
Kongolo,197,1,273,2019-02-26T19:45:00Z,True,9,19,90,9,11,5,6,40,21,19,-29,-14
Kongolo,197,1,281,2019-03-02T15:00:00Z,False,9,2,90,2,14,8,6,27,19,8,-13,-13
Kongolo,197,1,294,2019-03-09T15:00:00Z,True,9,1,0,0,14,8,6,34,25,9,-20,-1
Kongolo,197,1,308,2019-03-16T15:00:00Z,False,9,18,90,3,14,8,6,39,24,15,-25,-18
Kongolo,197,1,314,2019-03-30T15:00:00Z,False,9,6,90,1,14,8,6,33,13,20,-19,-7
Kongolo,197,1,323,2019-04-06T14:00:00Z,True,9,10,90,-1,14,8,6,44,23,21,-30,-13
Kongolo,197,1,338,2019-04-13T11:30:00Z,False,9,16,90,0,14,8,6,64,31,33,-50,-25
Kongolo,197,1,345,2019-04-20T14:00:00Z,True,9,17,90,1,14,8,6,46,26,20,-32,-12
Kongolo,197,1,355,2019-04-26T19:00:00Z,False,9,11,90,0,14,8,6,88,47,41,-74,-41
Kongolo,197,1,365,2019-05-05T13:00:00Z,True,9,13,90,2,14,8,6,65,36,29,-51,-21
Kongolo,197,1,377,2019-05-12T14:00:00Z,False,9,15,90,3,15,9,6,38,22,16,-23,-16
Mooy,198,2,3,2018-08-11T14:00:00Z,True,9,5,90,2,0,0,0,0,0,0,0,0
Mooy,198,2,17,2018-08-19T12:30:00Z,False,9,12,0,0,0,0,0,3,0,3,-3,0
Mooy,198,2,23,2018-08-25T14:00:00Z,True,9,4,90,3,0,0,0,1,1,0,-1,0
Mooy,198,2,35,2018-09-01T14:00:00Z,False,9,7,90,2,1,1,0,5,3,2,-4,-3
Mooy,198,2,43,2018-09-15T14:00:00Z,True,9,6,90,2,2,1,1,3,0,3,-1,-2
Mooy,198,2,56,2018-09-22T14:00:00Z,False,9,10,90,2,2,1,1,6,3,3,-4,-2
Mooy,198,2,65,2018-09-29T14:00:00Z,True,9,16,90,2,2,1,1,12,3,9,-10,-8
Mooy,198,2,71,2018-10-06T14:00:00Z,False,9,3,90,2,2,1,1,7,3,4,-5,-2
Mooy,198,2,85,2018-10-20T16:30:00Z,True,9,11,90,2,3,1,2,20,10,10,-17,-9
Mooy,198,2,99,2018-10-27T14:00:00Z,False,9,17,90,1,3,1,2,16,9,7,-13,-7
Mooy,198,2,105,2018-11-05T20:00:00Z,True,9,8,90,3,3,1,2,5,4,1,-2,0
Mooy,198,2,114,2018-11-10T15:00:00Z,True,9,18,90,2,6,4,2,11,7,4,-5,0
Mooy,198,2,129,2018-11-25T16:00:00Z,False,9,19,90,16,7,5,2,16,8,8,-9,-6
Mooy,198,2,134,2018-12-01T15:00:00Z,True,9,2,62,2,10,5,5,15,11,4,-5,1
Mooy,198,2,140,2018-12-04T19:45:00Z,False,9,1,90,1,10,5,5,20,11,9,-10,-6
Mooy,198,2,150,2018-12-08T15:00:00Z,False,9,0,90,2,10,5,5,31,17,14,-21,-12
Mooy,198,2,163,2018-12-15T15:00:00Z,True,9,14,0,0,10,5,5,13,6,7,-3,-2
Mooy,198,2,175,2018-12-22T15:00:00Z,True,9,15,0,0,10,5,5,12,8,4,-2,1
Mooy,198,2,186,2018-12-26T15:00:00Z,False,9,13,0,0,10,5,5,29,15,14,-19,-10
Mooy,198,2,193,2018-12-29T15:00:00Z,False,9,8,0,0,10,5,5,11,9,2,-1,-4
Mooy,198,2,205,2019-01-02T19:45:00Z,True,9,3,0,0,10,5,5,15,10,5,-5,0
Mooy,198,2,212,2019-01-12T15:00:00Z,False,9,4,0,0,10,5,5,18,13,5,-8,-8
Mooy,198,2,223,2019-01-20T13:30:00Z,True,9,12,0,0,11,5,6,53,33,20,-42,-15
Mooy,198,2,233,2019-01-29T19:45:00Z,True,9,7,35,1,11,5,6,30,21,9,-19,-4
Mooy,198,2,243,2019-02-02T15:00:00Z,False,9,5,90,2,11,5,6,47,25,22,-36,-19
Mooy,198,2,253,2019-02-09T15:00:00Z,True,9,0,90,2,11,5,6,47,32,15,-36,-10
Mooy,198,2,268,2019-02-23T15:00:00Z,False,9,14,90,2,11,5,6,25,13,12,-14,-7
Mooy,198,2,273,2019-02-26T19:45:00Z,True,9,19,12,1,11,5,6,40,21,19,-29,-14
Mooy,198,2,281,2019-03-02T15:00:00Z,False,9,2,49,0,14,8,6,27,19,8,-13,-13
Mooy,198,2,294,2019-03-09T15:00:00Z,True,9,1,90,1,14,8,6,34,25,9,-20,-1
Mooy,198,2,308,2019-03-16T15:00:00Z,False,9,18,90,6,14,8,6,39,24,15,-25,-18
Mooy,198,2,314,2019-03-30T15:00:00Z,False,9,6,90,2,14,8,6,33,13,20,-19,-7
Mooy,198,2,323,2019-04-06T14:00:00Z,True,9,10,90,8,14,8,6,44,23,21,-30,-13
Mooy,198,2,338,2019-04-13T11:30:00Z,False,9,16,8,1,14,8,6,64,31,33,-50,-25
Mooy,198,2,345,2019-04-20T14:00:00Z,True,9,17,90,2,14,8,6,46,26,20,-32,-12
Mooy,198,2,355,2019-04-26T19:00:00Z,False,9,11,0,0,14,8,6,88,47,41,-74,-41
Mooy,198,2,365,2019-05-05T13:00:00Z,True,9,13,90,2,14,8,6,65,36,29,-51,-21
Mooy,198,2,377,2019-05-12T14:00:00Z,False,9,15,90,2,15,9,6,38,22,16,-23,-16
van La Parra,199,2,3,2018-08-11T14:00:00Z,True,9,5,0,0,0,0,0,0,0,0,0,0
van La Parra,199,2,17,2018-08-19T12:30:00Z,False,9,12,0,0,0,0,0,3,0,3,-3,0
van La Parra,199,2,23,2018-08-25T14:00:00Z,True,9,4,90,3,0,0,0,1,1,0,-1,0
van La Parra,199,2,35,2018-09-01T14:00:00Z,False,9,7,90,2,1,1,0,5,3,2,-4,-3
van La Parra,199,2,43,2018-09-15T14:00:00Z,True,9,6,77,2,2,1,1,3,0,3,-1,-2
van La Parra,199,2,56,2018-09-22T14:00:00Z,False,9,10,90,2,2,1,1,6,3,3,-4,-2
van La Parra,199,2,65,2018-09-29T14:00:00Z,True,9,16,0,0,2,1,1,12,3,9,-10,-8
van La Parra,199,2,71,2018-10-06T14:00:00Z,False,9,3,58,1,2,1,1,7,3,4,-5,-2
van La Parra,199,2,85,2018-10-20T16:30:00Z,True,9,11,0,0,3,1,2,20,10,10,-17,-9
van La Parra,199,2,99,2018-10-27T14:00:00Z,False,9,17,0,0,3,1,2,16,9,7,-13,-7
van La Parra,199,2,105,2018-11-05T20:00:00Z,True,9,8,0,0,3,1,2,5,4,1,-2,0
van La Parra,199,2,114,2018-11-10T15:00:00Z,True,9,18,0,0,6,4,2,11,7,4,-5,0
van La Parra,199,2,129,2018-11-25T16:00:00Z,False,9,19,0,0,7,5,2,16,8,8,-9,-6
van La Parra,199,2,134,2018-12-01T15:00:00Z,True,9,2,0,0,10,5,5,15,11,4,-5,1
van La Parra,199,2,140,2018-12-04T19:45:00Z,False,9,1,0,0,10,5,5,20,11,9,-10,-6
van La Parra,199,2,150,2018-12-08T15:00:00Z,False,9,0,0,0,10,5,5,31,17,14,-21,-12
van La Parra,199,2,163,2018-12-15T15:00:00Z,True,9,14,0,0,10,5,5,13,6,7,-3,-2
van La Parra,199,2,175,2018-12-22T15:00:00Z,True,9,15,0,0,10,5,5,12,8,4,-2,1
van La Parra,199,2,186,2018-12-26T15:00:00Z,False,9,13,0,0,10,5,5,29,15,14,-19,-10
van La Parra,199,2,193,2018-12-29T15:00:00Z,False,9,8,0,0,10,5,5,11,9,2,-1,-4
van La Parra,199,2,205,2019-01-02T19:45:00Z,True,9,3,0,0,10,5,5,15,10,5,-5,0
van La Parra,199,2,212,2019-01-12T15:00:00Z,False,9,4,0,0,10,5,5,18,13,5,-8,-8
van La Parra,199,2,223,2019-01-20T13:30:00Z,True,9,12,0,0,11,5,6,53,33,20,-42,-15
van La Parra,199,2,233,2019-01-29T19:45:00Z,True,9,7,0,0,11,5,6,30,21,9,-19,-4
van La Parra,199,2,243,2019-02-02T15:00:00Z,False,9,5,0,0,11,5,6,47,25,22,-36,-19
van La Parra,199,2,253,2019-02-09T15:00:00Z,True,9,0,0,0,11,5,6,47,32,15,-36,-10
van La Parra,199,2,268,2019-02-23T15:00:00Z,False,9,14,0,0,11,5,6,25,13,12,-14,-7
van La Parra,199,2,273,2019-02-26T19:45:00Z,True,9,19,0,0,11,5,6,40,21,19,-29,-14
van La Parra,199,2,281,2019-03-02T15:00:00Z,False,9,2,0,0,14,8,6,27,19,8,-13,-13
van La Parra,199,2,294,2019-03-09T15:00:00Z,True,9,1,0,0,14,8,6,34,25,9,-20,-1
van La Parra,199,2,308,2019-03-16T15:00:00Z,False,9,18,0,0,14,8,6,39,24,15,-25,-18
van La Parra,199,2,314,2019-03-30T15:00:00Z,False,9,6,0,0,14,8,6,33,13,20,-19,-7
van La Parra,199,2,323,2019-04-06T14:00:00Z,True,9,10,0,0,14,8,6,44,23,21,-30,-13
van La Parra,199,2,338,2019-04-13T11:30:00Z,False,9,16,0,0,14,8,6,64,31,33,-50,-25
van La Parra,199,2,345,2019-04-20T14:00:00Z,True,9,17,0,0,14,8,6,46,26,20,-32,-12
van La Parra,199,2,355,2019-04-26T19:00:00Z,False,9,11,0,0,14,8,6,88,47,41,-74,-41
van La Parra,199,2,365,2019-05-05T13:00:00Z,True,9,13,0,0,14,8,6,65,36,29,-51,-21
van La Parra,199,2,377,2019-05-12T14:00:00Z,False,9,15,0,0,15,9,6,38,22,16,-23,-16
Hogg,200,2,3,2018-08-11T14:00:00Z,True,9,5,90,2,0,0,0,0,0,0,0,0
Hogg,200,2,17,2018-08-19T12:30:00Z,False,9,12,0,0,0,0,0,3,0,3,-3,0
Hogg,200,2,23,2018-08-25T14:00:00Z,True,9,4,62,0,0,0,0,1,1,0,-1,0
Hogg,200,2,35,2018-09-01T14:00:00Z,False,9,7,0,0,1,1,0,5,3,2,-4,-3
Hogg,200,2,43,2018-09-15T14:00:00Z,True,9,6,0,0,2,1,1,3,0,3,-1,-2
Hogg,200,2,56,2018-09-22T14:00:00Z,False,9,10,0,0,2,1,1,6,3,3,-4,-2
Hogg,200,2,65,2018-09-29T14:00:00Z,True,9,16,90,2,2,1,1,12,3,9,-10,-8
Hogg,200,2,71,2018-10-06T14:00:00Z,False,9,3,90,2,2,1,1,7,3,4,-5,-2
Hogg,200,2,85,2018-10-20T16:30:00Z,True,9,11,90,2,3,1,2,20,10,10,-17,-9
Hogg,200,2,99,2018-10-27T14:00:00Z,False,9,17,90,2,3,1,2,16,9,7,-13,-7
Hogg,200,2,105,2018-11-05T20:00:00Z,True,9,8,90,3,3,1,2,5,4,1,-2,0
Hogg,200,2,114,2018-11-10T15:00:00Z,True,9,18,90,8,6,4,2,11,7,4,-5,0
Hogg,200,2,129,2018-11-25T16:00:00Z,False,9,19,90,2,7,5,2,16,8,8,-9,-6
Hogg,200,2,134,2018-12-01T15:00:00Z,True,9,2,76,2,10,5,5,15,11,4,-5,1
Hogg,200,2,140,2018-12-04T19:45:00Z,False,9,1,90,2,10,5,5,20,11,9,-10,-6
Hogg,200,2,150,2018-12-08T15:00:00Z,False,9,0,51,1,10,5,5,31,17,14,-21,-12
Hogg,200,2,163,2018-12-15T15:00:00Z,True,9,14,76,1,10,5,5,13,6,7,-3,-2
Hogg,200,2,175,2018-12-22T15:00:00Z,True,9,15,0,0,10,5,5,12,8,4,-2,1
Hogg,200,2,186,2018-12-26T15:00:00Z,False,9,13,0,0,10,5,5,29,15,14,-19,-10
Hogg,200,2,193,2018-12-29T15:00:00Z,False,9,8,90,1,10,5,5,11,9,2,-1,-4
Hogg,200,2,205,2019-01-02T19:45:00Z,True,9,3,90,2,10,5,5,15,10,5,-5,0
Hogg,200,2,212,2019-01-12T15:00:00Z,False,9,4,90,3,10,5,5,18,13,5,-8,-8
Hogg,200,2,223,2019-01-20T13:30:00Z,True,9,12,90,1,11,5,6,53,33,20,-42,-15
Hogg,200,2,233,2019-01-29T19:45:00Z,True,9,7,54,1,11,5,6,30,21,9,-19,-4
Hogg,200,2,243,2019-02-02T15:00:00Z,False,9,5,0,0,11,5,6,47,25,22,-36,-19
Hogg,200,2,253,2019-02-09T15:00:00Z,True,9,0,90,2,11,5,6,47,32,15,-36,-10
Hogg,200,2,268,2019-02-23T15:00:00Z,False,9,14,90,2,11,5,6,25,13,12,-14,-7
Hogg,200,2,273,2019-02-26T19:45:00Z,True,9,19,90,2,11,5,6,40,21,19,-29,-14
Hogg,200,2,281,2019-03-02T15:00:00Z,False,9,2,40,1,14,8,6,27,19,8,-13,-13
Hogg,200,2,294,2019-03-09T15:00:00Z,True,9,1,0,0,14,8,6,34,25,9,-20,-1
Hogg,200,2,308,2019-03-16T15:00:00Z,False,9,18,0,0,14,8,6,39,24,15,-25,-18
Hogg,200,2,314,2019-03-30T15:00:00Z,False,9,6,90,2,14,8,6,33,13,20,-19,-7
Hogg,200,2,323,2019-04-06T14:00:00Z,True,9,10,80,1,14,8,6,44,23,21,-30,-13
Hogg,200,2,338,2019-04-13T11:30:00Z,False,9,16,90,2,14,8,6,64,31,33,-50,-25
Hogg,200,2,345,2019-04-20T14:00:00Z,True,9,17,40,0,14,8,6,46,26,20,-32,-12
Hogg,200,2,355,2019-04-26T19:00:00Z,False,9,11,90,2,14,8,6,88,47,41,-74,-41
Hogg,200,2,365,2019-05-05T13:00:00Z,True,9,13,90,2,14,8,6,65,36,29,-51,-21
Hogg,200,2,377,2019-05-12T14:00:00Z,False,9,15,90,1,15,9,6,38,22,16,-23,-16
Billing,201,2,3,2018-08-11T14:00:00Z,True,9,5,90,2,0,0,0,0,0,0,0,0
Billing,201,2,17,2018-08-19T12:30:00Z,False,9,12,90,1,0,0,0,3,0,3,-3,0
Billing,201,2,23,2018-08-25T14:00:00Z,True,9,4,90,3,0,0,0,1,1,0,-1,0
Billing,201,2,35,2018-09-01T14:00:00Z,False,9,7,90,9,1,1,0,5,3,2,-4,-3
Billing,201,2,43,2018-09-15T14:00:00Z,True,9,6,90,2,2,1,1,3,0,3,-1,-2
Billing,201,2,56,2018-09-22T14:00:00Z,False,9,10,90,2,2,1,1,6,3,3,-4,-2
Billing,201,2,65,2018-09-29T14:00:00Z,True,9,16,90,1,2,1,1,12,3,9,-10,-8
Billing,201,2,71,2018-10-06T14:00:00Z,False,9,3,90,2,2,1,1,7,3,4,-5,-2
Billing,201,2,85,2018-10-20T16:30:00Z,True,9,11,69,2,3,1,2,20,10,10,-17,-9
Billing,201,2,99,2018-10-27T14:00:00Z,False,9,17,77,1,3,1,2,16,9,7,-13,-7
Billing,201,2,105,2018-11-05T20:00:00Z,True,9,8,90,3,3,1,2,5,4,1,-2,0
Billing,201,2,114,2018-11-10T15:00:00Z,True,9,18,90,2,6,4,2,11,7,4,-5,0
Billing,201,2,129,2018-11-25T16:00:00Z,False,9,19,90,3,7,5,2,16,8,8,-9,-6
Billing,201,2,134,2018-12-01T15:00:00Z,True,9,2,90,2,10,5,5,15,11,4,-5,1
Billing,201,2,140,2018-12-04T19:45:00Z,False,9,1,74,1,10,5,5,20,11,9,-10,-6
Billing,201,2,150,2018-12-08T15:00:00Z,False,9,0,0,0,10,5,5,31,17,14,-21,-12
Billing,201,2,163,2018-12-15T15:00:00Z,True,9,14,90,2,10,5,5,13,6,7,-3,-2
Billing,201,2,175,2018-12-22T15:00:00Z,True,9,15,90,8,10,5,5,12,8,4,-2,1
Billing,201,2,186,2018-12-26T15:00:00Z,False,9,13,90,2,10,5,5,29,15,14,-19,-10
Billing,201,2,193,2018-12-29T15:00:00Z,False,9,8,90,2,10,5,5,11,9,2,-1,-4
Billing,201,2,205,2019-01-02T19:45:00Z,True,9,3,90,2,10,5,5,15,10,5,-5,0
Billing,201,2,212,2019-01-12T15:00:00Z,False,9,4,90,3,10,5,5,18,13,5,-8,-8
Billing,201,2,223,2019-01-20T13:30:00Z,True,9,12,0,0,11,5,6,53,33,20,-42,-15
Billing,201,2,233,2019-01-29T19:45:00Z,True,9,7,0,0,11,5,6,30,21,9,-19,-4
Billing,201,2,243,2019-02-02T15:00:00Z,False,9,5,66,2,11,5,6,47,25,22,-36,-19
Billing,201,2,253,2019-02-09T15:00:00Z,True,9,0,0,0,11,5,6,47,32,15,-36,-10
Billing,201,2,268,2019-02-23T15:00:00Z,False,9,14,21,1,11,5,6,25,13,12,-14,-7
Billing,201,2,273,2019-02-26T19:45:00Z,True,9,19,90,2,11,5,6,40,21,19,-29,-14
Billing,201,2,281,2019-03-02T15:00:00Z,False,9,2,90,2,14,8,6,27,19,8,-13,-13
Billing,201,2,294,2019-03-09T15:00:00Z,True,9,1,45,1,14,8,6,34,25,9,-20,-1
Billing,201,2,308,2019-03-16T15:00:00Z,False,9,18,35,0,14,8,6,39,24,15,-25,-18
Billing,201,2,314,2019-03-30T15:00:00Z,False,9,6,0,0,14,8,6,33,13,20,-19,-7
Billing,201,2,323,2019-04-06T14:00:00Z,True,9,10,0,0,14,8,6,44,23,21,-30,-13
Billing,201,2,338,2019-04-13T11:30:00Z,False,9,16,0,0,14,8,6,64,31,33,-50,-25
Billing,201,2,345,2019-04-20T14:00:00Z,True,9,17,0,0,14,8,6,46,26,20,-32,-12
Billing,201,2,355,2019-04-26T19:00:00Z,False,9,11,0,0,14,8,6,88,47,41,-74,-41
Billing,201,2,365,2019-05-05T13:00:00Z,True,9,13,0,0,14,8,6,65,36,29,-51,-21
Billing,201,2,377,2019-05-12T14:00:00Z,False,9,15,0,0,15,9,6,38,22,16,-23,-16
Ince,202,2,3,2018-08-11T14:00:00Z,True,9,5,0,0,0,0,0,0,0,0,0,0
Ince,202,2,17,2018-08-19T12:30:00Z,False,9,12,0,0,0,0,0,3,0,3,-3,0
Ince,202,2,23,2018-08-25T14:00:00Z,True,9,4,0,0,0,0,0,1,1,0,-1,0
Ince,202,2,35,2018-09-01T14:00:00Z,False,9,7,0,0,1,1,0,5,3,2,-4,-3
Ince,202,2,43,2018-09-15T14:00:00Z,True,9,6,0,0,2,1,1,3,0,3,-1,-2
Ince,202,2,56,2018-09-22T14:00:00Z,False,9,10,0,0,2,1,1,6,3,3,-4,-2
Ince,202,2,65,2018-09-29T14:00:00Z,True,9,16,0,0,2,1,1,12,3,9,-10,-8
Ince,202,2,71,2018-10-06T14:00:00Z,False,9,3,0,0,2,1,1,7,3,4,-5,-2
Ince,202,2,85,2018-10-20T16:30:00Z,True,9,11,0,0,3,1,2,20,10,10,-17,-9
Ince,202,2,99,2018-10-27T14:00:00Z,False,9,17,0,0,3,1,2,16,9,7,-13,-7
Ince,202,2,105,2018-11-05T20:00:00Z,True,9,8,0,0,3,1,2,5,4,1,-2,0
Ince,202,2,114,2018-11-10T15:00:00Z,True,9,18,0,0,6,4,2,11,7,4,-5,0
Ince,202,2,129,2018-11-25T16:00:00Z,False,9,19,0,0,7,5,2,16,8,8,-9,-6
Ince,202,2,134,2018-12-01T15:00:00Z,True,9,2,0,0,10,5,5,15,11,4,-5,1
Ince,202,2,140,2018-12-04T19:45:00Z,False,9,1,0,0,10,5,5,20,11,9,-10,-6
Ince,202,2,150,2018-12-08T15:00:00Z,False,9,0,0,0,10,5,5,31,17,14,-21,-12
Ince,202,2,163,2018-12-15T15:00:00Z,True,9,14,0,0,10,5,5,13,6,7,-3,-2
Ince,202,2,175,2018-12-22T15:00:00Z,True,9,15,0,0,10,5,5,12,8,4,-2,1
Ince,202,2,186,2018-12-26T15:00:00Z,False,9,13,0,0,10,5,5,29,15,14,-19,-10
Ince,202,2,193,2018-12-29T15:00:00Z,False,9,8,0,0,10,5,5,11,9,2,-1,-4
Ince,202,2,205,2019-01-02T19:45:00Z,True,9,3,0,0,10,5,5,15,10,5,-5,0
Ince,202,2,212,2019-01-12T15:00:00Z,False,9,4,0,0,10,5,5,18,13,5,-8,-8
Ince,202,2,223,2019-01-20T13:30:00Z,True,9,12,0,0,11,5,6,53,33,20,-42,-15
Ince,202,2,233,2019-01-29T19:45:00Z,True,9,7,0,0,11,5,6,30,21,9,-19,-4
Ince,202,2,243,2019-02-02T15:00:00Z,False,9,5,0,0,11,5,6,47,25,22,-36,-19
Ince,202,2,253,2019-02-09T15:00:00Z,True,9,0,0,0,11,5,6,47,32,15,-36,-10
Ince,202,2,268,2019-02-23T15:00:00Z,False,9,14,0,0,11,5,6,25,13,12,-14,-7
Ince,202,2,273,2019-02-26T19:45:00Z,True,9,19,0,0,11,5,6,40,21,19,-29,-14
Ince,202,2,281,2019-03-02T15:00:00Z,False,9,2,0,0,14,8,6,27,19,8,-13,-13
Ince,202,2,294,2019-03-09T15:00:00Z,True,9,1,0,0,14,8,6,34,25,9,-20,-1
Ince,202,2,308,2019-03-16T15:00:00Z,False,9,18,0,0,14,8,6,39,24,15,-25,-18
Ince,202,2,314,2019-03-30T15:00:00Z,False,9,6,0,0,14,8,6,33,13,20,-19,-7
Ince,202,2,323,2019-04-06T14:00:00Z,True,9,10,0,0,14,8,6,44,23,21,-30,-13
Ince,202,2,338,2019-04-13T11:30:00Z,False,9,16,0,0,14,8,6,64,31,33,-50,-25
Ince,202,2,345,2019-04-20T14:00:00Z,True,9,17,0,0,14,8,6,46,26,20,-32,-12
Ince,202,2,355,2019-04-26T19:00:00Z,False,9,11,0,0,14,8,6,88,47,41,-74,-41
Ince,202,2,365,2019-05-05T13:00:00Z,True,9,13,0,0,14,8,6,65,36,29,-51,-21
Ince,202,2,377,2019-05-12T14:00:00Z,False,9,15,0,0,15,9,6,38,22,16,-23,-16
Williams,203,2,3,2018-08-11T14:00:00Z,True,9,5,0,0,0,0,0,0,0,0,0,0
Williams,203,2,17,2018-08-19T12:30:00Z,False,9,12,0,0,0,0,0,3,0,3,-3,0
Williams,203,2,23,2018-08-25T14:00:00Z,True,9,4,0,0,0,0,0,1,1,0,-1,0
Williams,203,2,35,2018-09-01T14:00:00Z,False,9,7,0,0,1,1,0,5,3,2,-4,-3
Williams,203,2,43,2018-09-15T14:00:00Z,True,9,6,0,0,2,1,1,3,0,3,-1,-2
Williams,203,2,56,2018-09-22T14:00:00Z,False,9,10,0,0,2,1,1,6,3,3,-4,-2
Williams,203,2,65,2018-09-29T14:00:00Z,True,9,16,0,0,2,1,1,12,3,9,-10,-8
Williams,203,2,71,2018-10-06T14:00:00Z,False,9,3,0,0,2,1,1,7,3,4,-5,-2
Williams,203,2,85,2018-10-20T16:30:00Z,True,9,11,0,0,3,1,2,20,10,10,-17,-9
Williams,203,2,99,2018-10-27T14:00:00Z,False,9,17,0,0,3,1,2,16,9,7,-13,-7
Williams,203,2,105,2018-11-05T20:00:00Z,True,9,8,0,0,3,1,2,5,4,1,-2,0
Williams,203,2,114,2018-11-10T15:00:00Z,True,9,18,0,0,6,4,2,11,7,4,-5,0
Williams,203,2,129,2018-11-25T16:00:00Z,False,9,19,1,1,7,5,2,16,8,8,-9,-6
Williams,203,2,134,2018-12-01T15:00:00Z,True,9,2,13,1,10,5,5,15,11,4,-5,1
Williams,203,2,140,2018-12-04T19:45:00Z,False,9,1,0,0,10,5,5,20,11,9,-10,-6
Williams,203,2,150,2018-12-08T15:00:00Z,False,9,0,69,2,10,5,5,31,17,14,-21,-12
Williams,203,2,163,2018-12-15T15:00:00Z,True,9,14,0,0,10,5,5,13,6,7,-3,-2
Williams,203,2,175,2018-12-22T15:00:00Z,True,9,15,0,0,10,5,5,12,8,4,-2,1
Williams,203,2,186,2018-12-26T15:00:00Z,False,9,13,0,0,10,5,5,29,15,14,-19,-10
Williams,203,2,193,2018-12-29T15:00:00Z,False,9,8,0,0,10,5,5,11,9,2,-1,-4
Williams,203,2,205,2019-01-02T19:45:00Z,True,9,3,0,0,10,5,5,15,10,5,-5,0
Williams,203,2,212,2019-01-12T15:00:00Z,False,9,4,0,0,10,5,5,18,13,5,-8,-8
Williams,203,2,223,2019-01-20T13:30:00Z,True,9,12,0,0,11,5,6,53,33,20,-42,-15
Williams,203,2,233,2019-01-29T19:45:00Z,True,9,7,0,0,11,5,6,30,21,9,-19,-4
Williams,203,2,243,2019-02-02T15:00:00Z,False,9,5,0,0,11,5,6,47,25,22,-36,-19
Williams,203,2,253,2019-02-09T15:00:00Z,True,9,0,0,0,11,5,6,47,32,15,-36,-10
Williams,203,2,268,2019-02-23T15:00:00Z,False,9,14,0,0,11,5,6,25,13,12,-14,-7
Williams,203,2,273,2019-02-26T19:45:00Z,True,9,19,0,0,11,5,6,40,21,19,-29,-14
Williams,203,2,281,2019-03-02T15:00:00Z,False,9,2,0,0,14,8,6,27,19,8,-13,-13
Williams,203,2,294,2019-03-09T15:00:00Z,True,9,1,0,0,14,8,6,34,25,9,-20,-1
Williams,203,2,308,2019-03-16T15:00:00Z,False,9,18,0,0,14,8,6,39,24,15,-25,-18
Williams,203,2,314,2019-03-30T15:00:00Z,False,9,6,10,1,14,8,6,33,13,20,-19,-7
Williams,203,2,323,2019-04-06T14:00:00Z,True,9,10,0,0,14,8,6,44,23,21,-30,-13
Williams,203,2,338,2019-04-13T11:30:00Z,False,9,16,1,1,14,8,6,64,31,33,-50,-25
Williams,203,2,345,2019-04-20T14:00:00Z,True,9,17,0,0,14,8,6,46,26,20,-32,-12
Williams,203,2,355,2019-04-26T19:00:00Z,False,9,11,0,0,14,8,6,88,47,41,-74,-41
Williams,203,2,365,2019-05-05T13:00:00Z,True,9,13,0,0,14,8,6,65,36,29,-51,-21
Williams,203,2,377,2019-05-12T14:00:00Z,False,9,15,0,0,15,9,6,38,22,16,-23,-16
Sabiri,204,2,3,2018-08-11T14:00:00Z,True,9,5,0,0,0,0,0,0,0,0,0,0
Sabiri,204,2,17,2018-08-19T12:30:00Z,False,9,12,45,1,0,0,0,3,0,3,-3,0
Sabiri,204,2,23,2018-08-25T14:00:00Z,True,9,4,0,0,0,0,0,1,1,0,-1,0
Sabiri,204,2,35,2018-09-01T14:00:00Z,False,9,7,0,0,1,1,0,5,3,2,-4,-3
Sabiri,204,2,43,2018-09-15T14:00:00Z,True,9,6,0,0,2,1,1,3,0,3,-1,-2
Sabiri,204,2,56,2018-09-22T14:00:00Z,False,9,10,0,0,2,1,1,6,3,3,-4,-2
Sabiri,204,2,65,2018-09-29T14:00:00Z,True,9,16,0,0,2,1,1,12,3,9,-10,-8
Sabiri,204,2,71,2018-10-06T14:00:00Z,False,9,3,0,0,2,1,1,7,3,4,-5,-2
Sabiri,204,2,85,2018-10-20T16:30:00Z,True,9,11,0,0,3,1,2,20,10,10,-17,-9
Sabiri,204,2,99,2018-10-27T14:00:00Z,False,9,17,0,0,3,1,2,16,9,7,-13,-7
Sabiri,204,2,105,2018-11-05T20:00:00Z,True,9,8,0,0,3,1,2,5,4,1,-2,0
Sabiri,204,2,114,2018-11-10T15:00:00Z,True,9,18,0,0,6,4,2,11,7,4,-5,0
Sabiri,204,2,129,2018-11-25T16:00:00Z,False,9,19,0,0,7,5,2,16,8,8,-9,-6
Sabiri,204,2,134,2018-12-01T15:00:00Z,True,9,2,0,0,10,5,5,15,11,4,-5,1
Sabiri,204,2,140,2018-12-04T19:45:00Z,False,9,1,3,1,10,5,5,20,11,9,-10,-6
Sabiri,204,2,150,2018-12-08T15:00:00Z,False,9,0,0,0,10,5,5,31,17,14,-21,-12
Sabiri,204,2,163,2018-12-15T15:00:00Z,True,9,14,0,0,10,5,5,13,6,7,-3,-2
Sabiri,204,2,175,2018-12-22T15:00:00Z,True,9,15,0,0,10,5,5,12,8,4,-2,1
Sabiri,204,2,186,2018-12-26T15:00:00Z,False,9,13,0,0,10,5,5,29,15,14,-19,-10
Sabiri,204,2,193,2018-12-29T15:00:00Z,False,9,8,0,0,10,5,5,11,9,2,-1,-4
Sabiri,204,2,205,2019-01-02T19:45:00Z,True,9,3,0,0,10,5,5,15,10,5,-5,0
Sabiri,204,2,212,2019-01-12T15:00:00Z,False,9,4,0,0,10,5,5,18,13,5,-8,-8
Sabiri,204,2,223,2019-01-20T13:30:00Z,True,9,12,0,0,11,5,6,53,33,20,-42,-15
Sabiri,204,2,233,2019-01-29T19:45:00Z,True,9,7,0,0,11,5,6,30,21,9,-19,-4
Sabiri,204,2,243,2019-02-02T15:00:00Z,False,9,5,0,0,11,5,6,47,25,22,-36,-19
Sabiri,204,2,253,2019-02-09T15:00:00Z,True,9,0,0,0,11,5,6,47,32,15,-36,-10
Sabiri,204,2,268,2019-02-23T15:00:00Z,False,9,14,0,0,11,5,6,25,13,12,-14,-7
Sabiri,204,2,273,2019-02-26T19:45:00Z,True,9,19,0,0,11,5,6,40,21,19,-29,-14
Sabiri,204,2,281,2019-03-02T15:00:00Z,False,9,2,0,0,14,8,6,27,19,8,-13,-13
Sabiri,204,2,294,2019-03-09T15:00:00Z,True,9,1,0,0,14,8,6,34,25,9,-20,-1
Sabiri,204,2,308,2019-03-16T15:00:00Z,False,9,18,0,0,14,8,6,39,24,15,-25,-18
Sabiri,204,2,314,2019-03-30T15:00:00Z,False,9,6,0,0,14,8,6,33,13,20,-19,-7
Sabiri,204,2,323,2019-04-06T14:00:00Z,True,9,10,0,0,14,8,6,44,23,21,-30,-13
Sabiri,204,2,338,2019-04-13T11:30:00Z,False,9,16,0,0,14,8,6,64,31,33,-50,-25
Sabiri,204,2,345,2019-04-20T14:00:00Z,True,9,17,0,0,14,8,6,46,26,20,-32,-12
Sabiri,204,2,355,2019-04-26T19:00:00Z,False,9,11,0,0,14,8,6,88,47,41,-74,-41
Sabiri,204,2,365,2019-05-05T13:00:00Z,True,9,13,0,0,14,8,6,65,36,29,-51,-21
Sabiri,204,2,377,2019-05-12T14:00:00Z,False,9,15,0,0,15,9,6,38,22,16,-23,-16
Pritchard,205,2,3,2018-08-11T14:00:00Z,True,9,5,45,1,0,0,0,0,0,0,0,0
Pritchard,205,2,17,2018-08-19T12:30:00Z,False,9,12,60,2,0,0,0,3,0,3,-3,0
Pritchard,205,2,23,2018-08-25T14:00:00Z,True,9,4,0,0,0,0,0,1,1,0,-1,0
Pritchard,205,2,35,2018-09-01T14:00:00Z,False,9,7,0,0,1,1,0,5,3,2,-4,-3
Pritchard,205,2,43,2018-09-15T14:00:00Z,True,9,6,0,0,2,1,1,3,0,3,-1,-2
Pritchard,205,2,56,2018-09-22T14:00:00Z,False,9,10,18,1,2,1,1,6,3,3,-4,-2
Pritchard,205,2,65,2018-09-29T14:00:00Z,True,9,16,84,2,2,1,1,12,3,9,-10,-8
Pritchard,205,2,71,2018-10-06T14:00:00Z,False,9,3,90,2,2,1,1,7,3,4,-5,-2
Pritchard,205,2,85,2018-10-20T16:30:00Z,True,9,11,90,2,3,1,2,20,10,10,-17,-9
Pritchard,205,2,99,2018-10-27T14:00:00Z,False,9,17,90,2,3,1,2,16,9,7,-13,-7
Pritchard,205,2,105,2018-11-05T20:00:00Z,True,9,8,81,3,3,1,2,5,4,1,-2,0
Pritchard,205,2,114,2018-11-10T15:00:00Z,True,9,18,71,8,6,4,2,11,7,4,-5,0
Pritchard,205,2,129,2018-11-25T16:00:00Z,False,9,19,90,3,7,5,2,16,8,8,-9,-6
Pritchard,205,2,134,2018-12-01T15:00:00Z,True,9,2,48,1,10,5,5,15,11,4,-5,1
Pritchard,205,2,140,2018-12-04T19:45:00Z,False,9,1,90,2,10,5,5,20,11,9,-10,-6
Pritchard,205,2,150,2018-12-08T15:00:00Z,False,9,0,90,1,10,5,5,31,17,14,-21,-12
Pritchard,205,2,163,2018-12-15T15:00:00Z,True,9,14,90,2,10,5,5,13,6,7,-3,-2
Pritchard,205,2,175,2018-12-22T15:00:00Z,True,9,15,90,2,10,5,5,12,8,4,-2,1
Pritchard,205,2,186,2018-12-26T15:00:00Z,False,9,13,90,2,10,5,5,29,15,14,-19,-10
Pritchard,205,2,193,2018-12-29T15:00:00Z,False,9,8,64,3,10,5,5,11,9,2,-1,-4
Pritchard,205,2,205,2019-01-02T19:45:00Z,True,9,3,43,1,10,5,5,15,10,5,-5,0
Pritchard,205,2,212,2019-01-12T15:00:00Z,False,9,4,72,3,10,5,5,18,13,5,-8,-8
Pritchard,205,2,223,2019-01-20T13:30:00Z,True,9,12,26,1,11,5,6,53,33,20,-42,-15
Pritchard,205,2,233,2019-01-29T19:45:00Z,True,9,7,0,0,11,5,6,30,21,9,-19,-4
Pritchard,205,2,243,2019-02-02T15:00:00Z,False,9,5,6,1,11,5,6,47,25,22,-36,-19
Pritchard,205,2,253,2019-02-09T15:00:00Z,True,9,0,0,0,11,5,6,47,32,15,-36,-10
Pritchard,205,2,268,2019-02-23T15:00:00Z,False,9,14,0,0,11,5,6,25,13,12,-14,-7
Pritchard,205,2,273,2019-02-26T19:45:00Z,True,9,19,77,3,11,5,6,40,21,19,-29,-14
Pritchard,205,2,281,2019-03-02T15:00:00Z,False,9,2,61,3,14,8,6,27,19,8,-13,-13
Pritchard,205,2,294,2019-03-09T15:00:00Z,True,9,1,90,2,14,8,6,34,25,9,-20,-1
Pritchard,205,2,308,2019-03-16T15:00:00Z,False,9,18,90,1,14,8,6,39,24,15,-25,-18
Pritchard,205,2,314,2019-03-30T15:00:00Z,False,9,6,90,2,14,8,6,33,13,20,-19,-7
Pritchard,205,2,323,2019-04-06T14:00:00Z,True,9,10,59,1,14,8,6,44,23,21,-30,-13
Pritchard,205,2,338,2019-04-13T11:30:00Z,False,9,16,0,0,14,8,6,64,31,33,-50,-25
Pritchard,205,2,345,2019-04-20T14:00:00Z,True,9,17,0,0,14,8,6,46,26,20,-32,-12
Pritchard,205,2,355,2019-04-26T19:00:00Z,False,9,11,9,1,14,8,6,88,47,41,-74,-41
Pritchard,205,2,365,2019-05-05T13:00:00Z,True,9,13,90,2,14,8,6,65,36,29,-51,-21
Pritchard,205,2,377,2019-05-12T14:00:00Z,False,9,15,85,9,15,9,6,38,22,16,-23,-16
Sobhi,206,2,3,2018-08-11T14:00:00Z,True,9,5,0,0,0,0,0,0,0,0,0,0
Sobhi,206,2,17,2018-08-19T12:30:00Z,False,9,12,6,1,0,0,0,3,0,3,-3,0
Sobhi,206,2,23,2018-08-25T14:00:00Z,True,9,4,0,0,0,0,0,1,1,0,-1,0
Sobhi,206,2,35,2018-09-01T14:00:00Z,False,9,7,0,0,1,1,0,5,3,2,-4,-3
Sobhi,206,2,43,2018-09-15T14:00:00Z,True,9,6,0,0,2,1,1,3,0,3,-1,-2
Sobhi,206,2,56,2018-09-22T14:00:00Z,False,9,10,0,0,2,1,1,6,3,3,-4,-2
Sobhi,206,2,65,2018-09-29T14:00:00Z,True,9,16,0,0,2,1,1,12,3,9,-10,-8
Sobhi,206,2,71,2018-10-06T14:00:00Z,False,9,3,0,0,2,1,1,7,3,4,-5,-2
Sobhi,206,2,85,2018-10-20T16:30:00Z,True,9,11,0,0,3,1,2,20,10,10,-17,-9
Sobhi,206,2,99,2018-10-27T14:00:00Z,False,9,17,27,1,3,1,2,16,9,7,-13,-7
Sobhi,206,2,105,2018-11-05T20:00:00Z,True,9,8,0,0,3,1,2,5,4,1,-2,0
Sobhi,206,2,114,2018-11-10T15:00:00Z,True,9,18,0,0,6,4,2,11,7,4,-5,0
Sobhi,206,2,129,2018-11-25T16:00:00Z,False,9,19,0,0,7,5,2,16,8,8,-9,-6
Sobhi,206,2,134,2018-12-01T15:00:00Z,True,9,2,0,0,10,5,5,15,11,4,-5,1
Sobhi,206,2,140,2018-12-04T19:45:00Z,False,9,1,12,1,10,5,5,20,11,9,-10,-6
Sobhi,206,2,150,2018-12-08T15:00:00Z,False,9,0,0,0,10,5,5,31,17,14,-21,-12
Sobhi,206,2,163,2018-12-15T15:00:00Z,True,9,14,30,1,10,5,5,13,6,7,-3,-2
Sobhi,206,2,175,2018-12-22T15:00:00Z,True,9,15,0,0,10,5,5,12,8,4,-2,1
Sobhi,206,2,186,2018-12-26T15:00:00Z,False,9,13,0,0,10,5,5,29,15,14,-19,-10
Sobhi,206,2,193,2018-12-29T15:00:00Z,False,9,8,0,0,10,5,5,11,9,2,-1,-4
Sobhi,206,2,205,2019-01-02T19:45:00Z,True,9,3,0,0,10,5,5,15,10,5,-5,0
Sobhi,206,2,212,2019-01-12T15:00:00Z,False,9,4,0,0,10,5,5,18,13,5,-8,-8
Sobhi,206,2,223,2019-01-20T13:30:00Z,True,9,12,0,0,11,5,6,53,33,20,-42,-15
Sobhi,206,2,233,2019-01-29T19:45:00Z,True,9,7,0,0,11,5,6,30,21,9,-19,-4
Sobhi,206,2,243,2019-02-02T15:00:00Z,False,9,5,0,0,11,5,6,47,25,22,-36,-19
Sobhi,206,2,253,2019-02-09T15:00:00Z,True,9,0,0,0,11,5,6,47,32,15,-36,-10
Sobhi,206,2,268,2019-02-23T15:00:00Z,False,9,14,0,0,11,5,6,25,13,12,-14,-7
Sobhi,206,2,273,2019-02-26T19:45:00Z,True,9,19,0,0,11,5,6,40,21,19,-29,-14
Sobhi,206,2,281,2019-03-02T15:00:00Z,False,9,2,0,0,14,8,6,27,19,8,-13,-13
Sobhi,206,2,294,2019-03-09T15:00:00Z,True,9,1,0,0,14,8,6,34,25,9,-20,-1
Sobhi,206,2,308,2019-03-16T15:00:00Z,False,9,18,0,0,14,8,6,39,24,15,-25,-18
Sobhi,206,2,314,2019-03-30T15:00:00Z,False,9,6,0,0,14,8,6,33,13,20,-19,-7
Sobhi,206,2,323,2019-04-06T14:00:00Z,True,9,10,0,0,14,8,6,44,23,21,-30,-13
Sobhi,206,2,338,2019-04-13T11:30:00Z,False,9,16,0,0,14,8,6,64,31,33,-50,-25
Sobhi,206,2,345,2019-04-20T14:00:00Z,True,9,17,0,0,14,8,6,46,26,20,-32,-12
Sobhi,206,2,355,2019-04-26T19:00:00Z,False,9,11,0,0,14,8,6,88,47,41,-74,-41
Sobhi,206,2,365,2019-05-05T13:00:00Z,True,9,13,0,0,14,8,6,65,36,29,-51,-21
Sobhi,206,2,377,2019-05-12T14:00:00Z,False,9,15,0,0,15,9,6,38,22,16,-23,-16
Bacuna,207,2,3,2018-08-11T14:00:00Z,True,9,5,0,0,0,0,0,0,0,0,0,0
Bacuna,207,2,17,2018-08-19T12:30:00Z,False,9,12,0,0,0,0,0,3,0,3,-3,0
Bacuna,207,2,23,2018-08-25T14:00:00Z,True,9,4,0,0,0,0,0,1,1,0,-1,0
Bacuna,207,2,35,2018-09-01T14:00:00Z,False,9,7,0,0,1,1,0,5,3,2,-4,-3
Bacuna,207,2,43,2018-09-15T14:00:00Z,True,9,6,0,0,2,1,1,3,0,3,-1,-2
Bacuna,207,2,56,2018-09-22T14:00:00Z,False,9,10,0,0,2,1,1,6,3,3,-4,-2
Bacuna,207,2,65,2018-09-29T14:00:00Z,True,9,16,0,0,2,1,1,12,3,9,-10,-8
Bacuna,207,2,71,2018-10-06T14:00:00Z,False,9,3,0,0,2,1,1,7,3,4,-5,-2
Bacuna,207,2,85,2018-10-20T16:30:00Z,True,9,11,0,0,3,1,2,20,10,10,-17,-9
Bacuna,207,2,99,2018-10-27T14:00:00Z,False,9,17,12,1,3,1,2,16,9,7,-13,-7
Bacuna,207,2,105,2018-11-05T20:00:00Z,True,9,8,1,1,3,1,2,5,4,1,-2,0
Bacuna,207,2,114,2018-11-10T15:00:00Z,True,9,18,0,0,6,4,2,11,7,4,-5,0
Bacuna,207,2,129,2018-11-25T16:00:00Z,False,9,19,0,0,7,5,2,16,8,8,-9,-6
Bacuna,207,2,134,2018-12-01T15:00:00Z,True,9,2,0,0,10,5,5,15,11,4,-5,1
Bacuna,207,2,140,2018-12-04T19:45:00Z,False,9,1,0,0,10,5,5,20,11,9,-10,-6
Bacuna,207,2,150,2018-12-08T15:00:00Z,False,9,0,38,0,10,5,5,31,17,14,-21,-12
Bacuna,207,2,163,2018-12-15T15:00:00Z,True,9,14,90,2,10,5,5,13,6,7,-3,-2
Bacuna,207,2,175,2018-12-22T15:00:00Z,True,9,15,64,2,10,5,5,12,8,4,-2,1
Bacuna,207,2,186,2018-12-26T15:00:00Z,False,9,13,0,0,10,5,5,29,15,14,-19,-10
Bacuna,207,2,193,2018-12-29T15:00:00Z,False,9,8,0,0,10,5,5,11,9,2,-1,-4
Bacuna,207,2,205,2019-01-02T19:45:00Z,True,9,3,0,0,10,5,5,15,10,5,-5,0
Bacuna,207,2,212,2019-01-12T15:00:00Z,False,9,4,0,0,10,5,5,18,13,5,-8,-8
Bacuna,207,2,223,2019-01-20T13:30:00Z,True,9,12,63,1,11,5,6,53,33,20,-42,-15
Bacuna,207,2,233,2019-01-29T19:45:00Z,True,9,7,90,2,11,5,6,30,21,9,-19,-4
Bacuna,207,2,243,2019-02-02T15:00:00Z,False,9,5,90,2,11,5,6,47,25,22,-36,-19
Bacuna,207,2,253,2019-02-09T15:00:00Z,True,9,0,90,2,11,5,6,47,32,15,-36,-10
Bacuna,207,2,268,2019-02-23T15:00:00Z,False,9,14,68,2,11,5,6,25,13,12,-14,-7
Bacuna,207,2,273,2019-02-26T19:45:00Z,True,9,19,45,1,11,5,6,40,21,19,-29,-14
Bacuna,207,2,281,2019-03-02T15:00:00Z,False,9,2,90,2,14,8,6,27,19,8,-13,-13
Bacuna,207,2,294,2019-03-09T15:00:00Z,True,9,1,90,2,14,8,6,34,25,9,-20,-1
Bacuna,207,2,308,2019-03-16T15:00:00Z,False,9,18,66,8,14,8,6,39,24,15,-25,-18
Bacuna,207,2,314,2019-03-30T15:00:00Z,False,9,6,79,2,14,8,6,33,13,20,-19,-7
Bacuna,207,2,323,2019-04-06T14:00:00Z,True,9,10,9,1,14,8,6,44,23,21,-30,-13
Bacuna,207,2,338,2019-04-13T11:30:00Z,False,9,16,90,1,14,8,6,64,31,33,-50,-25
Bacuna,207,2,345,2019-04-20T14:00:00Z,True,9,17,90,1,14,8,6,46,26,20,-32,-12
Bacuna,207,2,355,2019-04-26T19:00:00Z,False,9,11,90,2,14,8,6,88,47,41,-74,-41
Bacuna,207,2,365,2019-05-05T13:00:00Z,True,9,13,90,2,14,8,6,65,36,29,-51,-21
Bacuna,207,2,377,2019-05-12T14:00:00Z,False,9,15,65,2,15,9,6,38,22,16,-23,-16
Quaner,208,3,3,2018-08-11T14:00:00Z,True,9,5,0,0,0,0,0,0,0,0,0,0
Quaner,208,3,17,2018-08-19T12:30:00Z,False,9,12,0,0,0,0,0,3,0,3,-3,0
Quaner,208,3,23,2018-08-25T14:00:00Z,True,9,4,0,0,0,0,0,1,1,0,-1,0
Quaner,208,3,35,2018-09-01T14:00:00Z,False,9,7,0,0,1,1,0,5,3,2,-4,-3
Quaner,208,3,43,2018-09-15T14:00:00Z,True,9,6,0,0,2,1,1,3,0,3,-1,-2
Quaner,208,3,56,2018-09-22T14:00:00Z,False,9,10,0,0,2,1,1,6,3,3,-4,-2
Quaner,208,3,65,2018-09-29T14:00:00Z,True,9,16,0,0,2,1,1,12,3,9,-10,-8
Quaner,208,3,71,2018-10-06T14:00:00Z,False,9,3,0,0,2,1,1,7,3,4,-5,-2
Quaner,208,3,85,2018-10-20T16:30:00Z,True,9,11,0,0,3,1,2,20,10,10,-17,-9
Quaner,208,3,99,2018-10-27T14:00:00Z,False,9,17,0,0,3,1,2,16,9,7,-13,-7
Quaner,208,3,105,2018-11-05T20:00:00Z,True,9,8,0,0,3,1,2,5,4,1,-2,0
Quaner,208,3,114,2018-11-10T15:00:00Z,True,9,18,0,0,6,4,2,11,7,4,-5,0
Quaner,208,3,129,2018-11-25T16:00:00Z,False,9,19,0,0,7,5,2,16,8,8,-9,-6
Quaner,208,3,134,2018-12-01T15:00:00Z,True,9,2,0,0,10,5,5,15,11,4,-5,1
Quaner,208,3,140,2018-12-04T19:45:00Z,False,9,1,0,0,10,5,5,20,11,9,-10,-6
Quaner,208,3,150,2018-12-08T15:00:00Z,False,9,0,0,0,10,5,5,31,17,14,-21,-12
Quaner,208,3,163,2018-12-15T15:00:00Z,True,9,14,0,0,10,5,5,13,6,7,-3,-2
Quaner,208,3,175,2018-12-22T15:00:00Z,True,9,15,9,1,10,5,5,12,8,4,-2,1
Quaner,208,3,186,2018-12-26T15:00:00Z,False,9,13,28,1,10,5,5,29,15,14,-19,-10
Quaner,208,3,193,2018-12-29T15:00:00Z,False,9,8,0,0,10,5,5,11,9,2,-1,-4
Quaner,208,3,205,2019-01-02T19:45:00Z,True,9,3,0,0,10,5,5,15,10,5,-5,0
Quaner,208,3,212,2019-01-12T15:00:00Z,False,9,4,0,0,10,5,5,18,13,5,-8,-8
Quaner,208,3,223,2019-01-20T13:30:00Z,True,9,12,0,0,11,5,6,53,33,20,-42,-15
Quaner,208,3,233,2019-01-29T19:45:00Z,True,9,7,0,0,11,5,6,30,21,9,-19,-4
Quaner,208,3,243,2019-02-02T15:00:00Z,False,9,5,0,0,11,5,6,47,25,22,-36,-19
Quaner,208,3,253,2019-02-09T15:00:00Z,True,9,0,0,0,11,5,6,47,32,15,-36,-10
Quaner,208,3,268,2019-02-23T15:00:00Z,False,9,14,0,0,11,5,6,25,13,12,-14,-7
Quaner,208,3,273,2019-02-26T19:45:00Z,True,9,19,0,0,11,5,6,40,21,19,-29,-14
Quaner,208,3,281,2019-03-02T15:00:00Z,False,9,2,0,0,14,8,6,27,19,8,-13,-13
Quaner,208,3,294,2019-03-09T15:00:00Z,True,9,1,0,0,14,8,6,34,25,9,-20,-1
Quaner,208,3,308,2019-03-16T15:00:00Z,False,9,18,0,0,14,8,6,39,24,15,-25,-18
Quaner,208,3,314,2019-03-30T15:00:00Z,False,9,6,0,0,14,8,6,33,13,20,-19,-7
Quaner,208,3,323,2019-04-06T14:00:00Z,True,9,10,0,0,14,8,6,44,23,21,-30,-13
Quaner,208,3,338,2019-04-13T11:30:00Z,False,9,16,0,0,14,8,6,64,31,33,-50,-25
Quaner,208,3,345,2019-04-20T14:00:00Z,True,9,17,0,0,14,8,6,46,26,20,-32,-12
Quaner,208,3,355,2019-04-26T19:00:00Z,False,9,11,0,0,14,8,6,88,47,41,-74,-41
Quaner,208,3,365,2019-05-05T13:00:00Z,True,9,13,0,0,14,8,6,65,36,29,-51,-21
Quaner,208,3,377,2019-05-12T14:00:00Z,False,9,15,0,0,15,9,6,38,22,16,-23,-16
Depoitre,209,3,3,2018-08-11T14:00:00Z,True,9,5,45,1,0,0,0,0,0,0,0,0
Depoitre,209,3,17,2018-08-19T12:30:00Z,False,9,12,45,1,0,0,0,3,0,3,-3,0
Depoitre,209,3,23,2018-08-25T14:00:00Z,True,9,4,10,1,0,0,0,1,1,0,-1,0
Depoitre,209,3,35,2018-09-01T14:00:00Z,False,9,7,1,1,1,1,0,5,3,2,-4,-3
Depoitre,209,3,43,2018-09-15T14:00:00Z,True,9,6,12,1,2,1,1,3,0,3,-1,-2
Depoitre,209,3,56,2018-09-22T14:00:00Z,False,9,10,90,5,2,1,1,6,3,3,-4,-2
Depoitre,209,3,65,2018-09-29T14:00:00Z,True,9,16,90,2,2,1,1,12,3,9,-10,-8
Depoitre,209,3,71,2018-10-06T14:00:00Z,False,9,3,58,0,2,1,1,7,3,4,-5,-2
Depoitre,209,3,85,2018-10-20T16:30:00Z,True,9,11,90,2,3,1,2,20,10,10,-17,-9
Depoitre,209,3,99,2018-10-27T14:00:00Z,False,9,17,62,2,3,1,2,16,9,7,-13,-7
Depoitre,209,3,105,2018-11-05T20:00:00Z,True,9,8,34,1,3,1,2,5,4,1,-2,0
Depoitre,209,3,114,2018-11-10T15:00:00Z,True,9,18,1,1,6,4,2,11,7,4,-5,0
Depoitre,209,3,129,2018-11-25T16:00:00Z,False,9,19,0,0,7,5,2,16,8,8,-9,-6
Depoitre,209,3,134,2018-12-01T15:00:00Z,True,9,2,41,1,10,5,5,15,11,4,-5,1
Depoitre,209,3,140,2018-12-04T19:45:00Z,False,9,1,90,2,10,5,5,20,11,9,-10,-6
Depoitre,209,3,150,2018-12-08T15:00:00Z,False,9,0,90,2,10,5,5,31,17,14,-21,-12
Depoitre,209,3,163,2018-12-15T15:00:00Z,True,9,14,90,2,10,5,5,13,6,7,-3,-2
Depoitre,209,3,175,2018-12-22T15:00:00Z,True,9,15,0,0,10,5,5,12,8,4,-2,1
Depoitre,209,3,186,2018-12-26T15:00:00Z,False,9,13,72,2,10,5,5,29,15,14,-19,-10
Depoitre,209,3,193,2018-12-29T15:00:00Z,False,9,8,25,1,10,5,5,11,9,2,-1,-4
Depoitre,209,3,205,2019-01-02T19:45:00Z,True,9,3,7,1,10,5,5,15,10,5,-5,0
Depoitre,209,3,212,2019-01-12T15:00:00Z,False,9,4,3,1,10,5,5,18,13,5,-8,-8
Depoitre,209,3,223,2019-01-20T13:30:00Z,True,9,12,0,0,11,5,6,53,33,20,-42,-15
Depoitre,209,3,233,2019-01-29T19:45:00Z,True,9,7,3,1,11,5,6,30,21,9,-19,-4
Depoitre,209,3,243,2019-02-02T15:00:00Z,False,9,5,0,0,11,5,6,47,25,22,-36,-19
Depoitre,209,3,253,2019-02-09T15:00:00Z,True,9,0,24,1,11,5,6,47,32,15,-36,-10
Depoitre,209,3,268,2019-02-23T15:00:00Z,False,9,14,75,2,11,5,6,25,13,12,-14,-7
Depoitre,209,3,273,2019-02-26T19:45:00Z,True,9,19,0,0,11,5,6,40,21,19,-29,-14
Depoitre,209,3,281,2019-03-02T15:00:00Z,False,9,2,0,0,14,8,6,27,19,8,-13,-13
Depoitre,209,3,294,2019-03-09T15:00:00Z,True,9,1,0,0,14,8,6,34,25,9,-20,-1
Depoitre,209,3,308,2019-03-16T15:00:00Z,False,9,18,0,0,14,8,6,39,24,15,-25,-18
Depoitre,209,3,314,2019-03-30T15:00:00Z,False,9,6,0,0,14,8,6,33,13,20,-19,-7
Depoitre,209,3,323,2019-04-06T14:00:00Z,True,9,10,0,0,14,8,6,44,23,21,-30,-13
Depoitre,209,3,338,2019-04-13T11:30:00Z,False,9,16,0,0,14,8,6,64,31,33,-50,-25
Depoitre,209,3,345,2019-04-20T14:00:00Z,True,9,17,0,0,14,8,6,46,26,20,-32,-12
Depoitre,209,3,355,2019-04-26T19:00:00Z,False,9,11,0,0,14,8,6,88,47,41,-74,-41
Depoitre,209,3,365,2019-05-05T13:00:00Z,True,9,13,0,0,14,8,6,65,36,29,-51,-21
Depoitre,209,3,377,2019-05-12T14:00:00Z,False,9,15,0,0,15,9,6,38,22,16,-23,-16
Mounie,210,3,3,2018-08-11T14:00:00Z,True,9,5,90,2,0,0,0,0,0,0,0,0
Mounie,210,3,17,2018-08-19T12:30:00Z,False,9,12,83,5,0,0,0,3,0,3,-3,0
Mounie,210,3,23,2018-08-25T14:00:00Z,True,9,4,79,2,0,0,0,1,1,0,-1,0
Mounie,210,3,35,2018-09-01T14:00:00Z,False,9,7,90,2,1,1,0,5,3,2,-4,-3
Mounie,210,3,43,2018-09-15T14:00:00Z,True,9,6,90,2,2,1,1,3,0,3,-1,-2
Mounie,210,3,56,2018-09-22T14:00:00Z,False,9,10,0,0,2,1,1,6,3,3,-4,-2
Mounie,210,3,65,2018-09-29T14:00:00Z,True,9,16,5,1,2,1,1,12,3,9,-10,-8
Mounie,210,3,71,2018-10-06T14:00:00Z,False,9,3,31,1,2,1,1,7,3,4,-5,-2
Mounie,210,3,85,2018-10-20T16:30:00Z,True,9,11,20,1,3,1,2,20,10,10,-17,-9
Mounie,210,3,99,2018-10-27T14:00:00Z,False,9,17,27,1,3,1,2,16,9,7,-13,-7
Mounie,210,3,105,2018-11-05T20:00:00Z,True,9,8,55,1,3,1,2,5,4,1,-2,0
Mounie,210,3,114,2018-11-10T15:00:00Z,True,9,18,88,2,6,4,2,11,7,4,-5,0
Mounie,210,3,129,2018-11-25T16:00:00Z,False,9,19,90,5,7,5,2,16,8,8,-9,-6
Mounie,210,3,134,2018-12-01T15:00:00Z,True,9,2,31,-2,10,5,5,15,11,4,-5,1
Mounie,210,3,140,2018-12-04T19:45:00Z,False,9,1,0,0,10,5,5,20,11,9,-10,-6
Mounie,210,3,150,2018-12-08T15:00:00Z,False,9,0,0,0,10,5,5,31,17,14,-21,-12
Mounie,210,3,163,2018-12-15T15:00:00Z,True,9,14,0,0,10,5,5,13,6,7,-3,-2
Mounie,210,3,175,2018-12-22T15:00:00Z,True,9,15,90,5,10,5,5,12,8,4,-2,1
Mounie,210,3,186,2018-12-26T15:00:00Z,False,9,13,17,4,10,5,5,29,15,14,-19,-10
Mounie,210,3,193,2018-12-29T15:00:00Z,False,9,8,64,2,10,5,5,11,9,2,-1,-4
Mounie,210,3,205,2019-01-02T19:45:00Z,True,9,3,90,8,10,5,5,15,10,5,-5,0
Mounie,210,3,212,2019-01-12T15:00:00Z,False,9,4,86,2,10,5,5,18,13,5,-8,-8
Mounie,210,3,223,2019-01-20T13:30:00Z,True,9,12,31,1,11,5,6,53,33,20,-42,-15
Mounie,210,3,233,2019-01-29T19:45:00Z,True,9,7,90,2,11,5,6,30,21,9,-19,-4
Mounie,210,3,243,2019-02-02T15:00:00Z,False,9,5,63,2,11,5,6,47,25,22,-36,-19
Mounie,210,3,253,2019-02-09T15:00:00Z,True,9,0,0,0,11,5,6,47,32,15,-36,-10
Mounie,210,3,268,2019-02-23T15:00:00Z,False,9,14,14,1,11,5,6,25,13,12,-14,-7
Mounie,210,3,273,2019-02-26T19:45:00Z,True,9,19,90,8,11,5,6,40,21,19,-29,-14
Mounie,210,3,281,2019-03-02T15:00:00Z,False,9,2,90,1,14,8,6,27,19,8,-13,-13
Mounie,210,3,294,2019-03-09T15:00:00Z,True,9,1,60,2,14,8,6,34,25,9,-20,-1
Mounie,210,3,308,2019-03-16T15:00:00Z,False,9,18,20,1,14,8,6,39,24,15,-25,-18
Mounie,210,3,314,2019-03-30T15:00:00Z,False,9,6,0,0,14,8,6,33,13,20,-19,-7
Mounie,210,3,323,2019-04-06T14:00:00Z,True,9,10,30,1,14,8,6,44,23,21,-30,-13
Mounie,210,3,338,2019-04-13T11:30:00Z,False,9,16,21,1,14,8,6,64,31,33,-50,-25
Mounie,210,3,345,2019-04-20T14:00:00Z,True,9,17,64,2,14,8,6,46,26,20,-32,-12
Mounie,210,3,355,2019-04-26T19:00:00Z,False,9,11,64,2,14,8,6,88,47,41,-74,-41
Mounie,210,3,365,2019-05-05T13:00:00Z,True,9,13,0,0,14,8,6,65,36,29,-51,-21
Mounie,210,3,377,2019-05-12T14:00:00Z,False,9,15,4,1,15,9,6,38,22,16,-23,-16
Kachunga,211,3,3,2018-08-11T14:00:00Z,True,9,5,0,0,0,0,0,0,0,0,0,0
Kachunga,211,3,17,2018-08-19T12:30:00Z,False,9,12,0,0,0,0,0,3,0,3,-3,0
Kachunga,211,3,23,2018-08-25T14:00:00Z,True,9,4,0,0,0,0,0,1,1,0,-1,0
Kachunga,211,3,35,2018-09-01T14:00:00Z,False,9,7,30,1,1,1,0,5,3,2,-4,-3
Kachunga,211,3,43,2018-09-15T14:00:00Z,True,9,6,67,2,2,1,1,3,0,3,-1,-2
Kachunga,211,3,56,2018-09-22T14:00:00Z,False,9,10,56,1,2,1,1,6,3,3,-4,-2
Kachunga,211,3,65,2018-09-29T14:00:00Z,True,9,16,0,0,2,1,1,12,3,9,-10,-8
Kachunga,211,3,71,2018-10-06T14:00:00Z,False,9,3,0,0,2,1,1,7,3,4,-5,-2
Kachunga,211,3,85,2018-10-20T16:30:00Z,True,9,11,0,0,3,1,2,20,10,10,-17,-9
Kachunga,211,3,99,2018-10-27T14:00:00Z,False,9,17,0,0,3,1,2,16,9,7,-13,-7
Kachunga,211,3,105,2018-11-05T20:00:00Z,True,9,8,0,0,3,1,2,5,4,1,-2,0
Kachunga,211,3,114,2018-11-10T15:00:00Z,True,9,18,0,0,6,4,2,11,7,4,-5,0
Kachunga,211,3,129,2018-11-25T16:00:00Z,False,9,19,0,0,7,5,2,16,8,8,-9,-6
Kachunga,211,3,134,2018-12-01T15:00:00Z,True,9,2,0,0,10,5,5,15,11,4,-5,1
Kachunga,211,3,140,2018-12-04T19:45:00Z,False,9,1,0,0,10,5,5,20,11,9,-10,-6
Kachunga,211,3,150,2018-12-08T15:00:00Z,False,9,0,0,0,10,5,5,31,17,14,-21,-12
Kachunga,211,3,163,2018-12-15T15:00:00Z,True,9,14,0,0,10,5,5,13,6,7,-3,-2
Kachunga,211,3,175,2018-12-22T15:00:00Z,True,9,15,25,1,10,5,5,12,8,4,-2,1
Kachunga,211,3,186,2018-12-26T15:00:00Z,False,9,13,56,0,10,5,5,29,15,14,-19,-10
Kachunga,211,3,193,2018-12-29T15:00:00Z,False,9,8,25,1,10,5,5,11,9,2,-1,-4
Kachunga,211,3,205,2019-01-02T19:45:00Z,True,9,3,90,2,10,5,5,15,10,5,-5,0
Kachunga,211,3,212,2019-01-12T15:00:00Z,False,9,4,90,2,10,5,5,18,13,5,-8,-8
Kachunga,211,3,223,2019-01-20T13:30:00Z,True,9,12,90,2,11,5,6,53,33,20,-42,-15
Kachunga,211,3,233,2019-01-29T19:45:00Z,True,9,7,80,2,11,5,6,30,21,9,-19,-4
Kachunga,211,3,243,2019-02-02T15:00:00Z,False,9,5,90,2,11,5,6,47,25,22,-36,-19
Kachunga,211,3,253,2019-02-09T15:00:00Z,True,9,0,82,2,11,5,6,47,32,15,-36,-10
Kachunga,211,3,268,2019-02-23T15:00:00Z,False,9,14,90,2,11,5,6,25,13,12,-14,-7
Kachunga,211,3,273,2019-02-26T19:45:00Z,True,9,19,8,1,11,5,6,40,21,19,-29,-14
Kachunga,211,3,281,2019-03-02T15:00:00Z,False,9,2,28,1,14,8,6,27,19,8,-13,-13
Kachunga,211,3,294,2019-03-09T15:00:00Z,True,9,1,75,1,14,8,6,34,25,9,-20,-1
Kachunga,211,3,308,2019-03-16T15:00:00Z,False,9,18,0,0,14,8,6,39,24,15,-25,-18
Kachunga,211,3,314,2019-03-30T15:00:00Z,False,9,6,10,1,14,8,6,33,13,20,-19,-7
Kachunga,211,3,323,2019-04-06T14:00:00Z,True,9,10,0,0,14,8,6,44,23,21,-30,-13
Kachunga,211,3,338,2019-04-13T11:30:00Z,False,9,16,90,2,14,8,6,64,31,33,-50,-25
Kachunga,211,3,345,2019-04-20T14:00:00Z,True,9,17,90,2,14,8,6,46,26,20,-32,-12
Kachunga,211,3,355,2019-04-26T19:00:00Z,False,9,11,3,1,14,8,6,88,47,41,-74,-41
Kachunga,211,3,365,2019-05-05T13:00:00Z,True,9,13,0,0,14,8,6,65,36,29,-51,-21
Kachunga,211,3,377,2019-05-12T14:00:00Z,False,9,15,0,0,15,9,6,38,22,16,-23,-16
Schmeichel,212,0,5,2018-08-10T19:00:00Z,False,10,13,90,2,0,0,0,0,0,0,0,0
Schmeichel,212,0,16,2018-08-18T14:00:00Z,True,10,19,90,6,0,0,0,1,1,0,-1,0
Schmeichel,212,0,27,2018-08-25T14:00:00Z,False,10,15,90,3,3,3,0,1,1,0,2,-1
Schmeichel,212,0,36,2018-09-01T11:30:00Z,True,10,11,90,1,6,3,3,9,6,3,-3,0
Schmeichel,212,0,40,2018-09-15T14:00:00Z,False,10,1,90,-1,6,3,3,7,4,3,-1,-1
Schmeichel,212,0,56,2018-09-22T14:00:00Z,True,10,9,90,2,6,3,3,2,1,1,4,2
Schmeichel,212,0,67,2018-09-29T14:00:00Z,False,10,14,90,6,9,6,3,2,0,2,7,3
Schmeichel,212,0,74,2018-10-06T14:00:00Z,True,10,7,90,3,12,6,6,9,7,2,3,4
Schmeichel,212,0,80,2018-10-22T19:00:00Z,False,10,0,90,2,12,6,6,18,9,9,-6,-3
Schmeichel,212,0,94,2018-10-27T16:30:00Z,True,10,18,90,2,12,6,6,7,4,3,5,3
Schmeichel,212,0,102,2018-11-03T15:00:00Z,False,10,4,90,8,13,7,6,5,4,1,8,2
Schmeichel,212,0,115,2018-11-10T15:00:00Z,True,10,3,90,6,16,7,9,8,4,4,8,3
Schmeichel,212,0,121,2018-11-24T15:00:00Z,False,10,2,90,2,17,8,9,14,10,4,3,-1
Schmeichel,212,0,135,2018-12-01T15:00:00Z,True,10,17,90,6,18,8,10,20,12,8,-2,0
Schmeichel,212,0,143,2018-12-05T19:45:00Z,False,10,8,90,5,21,11,10,8,7,1,13,3
Schmeichel,212,0,156,2018-12-08T19:45:00Z,True,10,16,90,1,22,11,11,33,12,21,-11,-10
Schmeichel,212,0,161,2018-12-15T15:00:00Z,False,10,6,90,2,22,11,11,12,5,7,10,6
Schmeichel,212,0,173,2018-12-22T15:00:00Z,False,10,5,90,10,22,11,11,37,21,16,-15,-10
Schmeichel,212,0,184,2018-12-26T15:00:00Z,True,10,12,90,3,25,11,14,44,27,17,-19,-6
Schmeichel,212,0,194,2018-12-29T15:00:00Z,True,10,4,90,2,28,14,14,15,13,2,13,12
Schmeichel,212,0,204,2019-01-01T12:30:00Z,False,10,7,90,6,28,14,14,27,18,9,1,-4
Schmeichel,212,0,216,2019-01-12T15:00:00Z,True,10,15,90,1,31,14,17,16,8,8,15,6
Schmeichel,212,0,229,2019-01-19T12:30:00Z,False,10,19,90,1,31,14,17,29,14,15,2,3
Schmeichel,212,0,236,2019-01-30T20:00:00Z,False,10,11,90,2,31,14,17,60,31,29,-29,-14
Schmeichel,212,0,246,2019-02-03T14:05:00Z,True,10,13,90,3,32,14,18,45,25,20,-13,-6
Schmeichel,212,0,257,2019-02-10T13:30:00Z,False,10,16,90,1,32,14,18,57,24,33,-25,-6
Schmeichel,212,0,266,2019-02-23T17:30:00Z,True,10,6,90,-1,32,14,18,27,13,14,5,0
Schmeichel,212,0,274,2019-02-26T19:45:00Z,True,10,2,90,2,32,14,18,27,19,8,5,6
Schmeichel,212,0,287,2019-03-03T12:00:00Z,False,10,17,90,2,35,17,18,40,20,20,-5,-2
Schmeichel,212,0,295,2019-03-09T15:00:00Z,True,10,8,90,2,35,17,18,17,15,2,18,15
Schmeichel,212,0,302,2019-03-16T15:00:00Z,False,10,3,90,2,38,20,18,30,17,13,8,1
Schmeichel,212,0,316,2019-03-30T15:00:00Z,True,10,1,90,6,41,20,21,38,26,12,3,8
Schmeichel,212,0,323,2019-04-06T14:00:00Z,False,10,9,90,3,44,23,21,14,8,6,30,13
Schmeichel,212,0,334,2019-04-12T19:00:00Z,True,10,14,90,2,47,23,24,35,22,13,12,10
Schmeichel,212,0,348,2019-04-20T14:00:00Z,False,10,18,90,1,47,23,24,42,27,15,5,-3
Schmeichel,212,0,354,2019-04-28T11:00:00Z,True,10,0,90,6,48,23,25,66,44,22,-18,1
Schmeichel,212,0,366,2019-05-06T19:00:00Z,False,10,12,90,3,51,26,25,92,51,41,-41,-26
Schmeichel,212,0,374,2019-05-12T14:00:00Z,True,10,5,90,7,51,26,25,71,42,29,-20,-3
Jakupovic,213,0,5,2018-08-10T19:00:00Z,False,10,13,0,0,0,0,0,0,0,0,0,0
Jakupovic,213,0,16,2018-08-18T14:00:00Z,True,10,19,0,0,0,0,0,1,1,0,-1,0
Jakupovic,213,0,27,2018-08-25T14:00:00Z,False,10,15,0,0,3,3,0,1,1,0,2,-1
Jakupovic,213,0,36,2018-09-01T11:30:00Z,True,10,11,0,0,6,3,3,9,6,3,-3,0
Jakupovic,213,0,40,2018-09-15T14:00:00Z,False,10,1,0,0,6,3,3,7,4,3,-1,-1
Jakupovic,213,0,56,2018-09-22T14:00:00Z,True,10,9,0,0,6,3,3,2,1,1,4,2
Jakupovic,213,0,67,2018-09-29T14:00:00Z,False,10,14,0,0,9,6,3,2,0,2,7,3
Jakupovic,213,0,74,2018-10-06T14:00:00Z,True,10,7,0,0,12,6,6,9,7,2,3,4
Jakupovic,213,0,80,2018-10-22T19:00:00Z,False,10,0,0,0,12,6,6,18,9,9,-6,-3
Jakupovic,213,0,94,2018-10-27T16:30:00Z,True,10,18,0,0,12,6,6,7,4,3,5,3
Jakupovic,213,0,102,2018-11-03T15:00:00Z,False,10,4,0,0,13,7,6,5,4,1,8,2
Jakupovic,213,0,115,2018-11-10T15:00:00Z,True,10,3,0,0,16,7,9,8,4,4,8,3
Jakupovic,213,0,121,2018-11-24T15:00:00Z,False,10,2,0,0,17,8,9,14,10,4,3,-1
Jakupovic,213,0,135,2018-12-01T15:00:00Z,True,10,17,0,0,18,8,10,20,12,8,-2,0
Jakupovic,213,0,143,2018-12-05T19:45:00Z,False,10,8,0,0,21,11,10,8,7,1,13,3
Jakupovic,213,0,156,2018-12-08T19:45:00Z,True,10,16,0,0,22,11,11,33,12,21,-11,-10
Jakupovic,213,0,161,2018-12-15T15:00:00Z,False,10,6,0,0,22,11,11,12,5,7,10,6
Jakupovic,213,0,173,2018-12-22T15:00:00Z,False,10,5,0,0,22,11,11,37,21,16,-15,-10
Jakupovic,213,0,184,2018-12-26T15:00:00Z,True,10,12,0,0,25,11,14,44,27,17,-19,-6
Jakupovic,213,0,194,2018-12-29T15:00:00Z,True,10,4,0,0,28,14,14,15,13,2,13,12
Jakupovic,213,0,204,2019-01-01T12:30:00Z,False,10,7,0,0,28,14,14,27,18,9,1,-4
Jakupovic,213,0,216,2019-01-12T15:00:00Z,True,10,15,0,0,31,14,17,16,8,8,15,6
Jakupovic,213,0,229,2019-01-19T12:30:00Z,False,10,19,0,0,31,14,17,29,14,15,2,3
Jakupovic,213,0,236,2019-01-30T20:00:00Z,False,10,11,0,0,31,14,17,60,31,29,-29,-14
Jakupovic,213,0,246,2019-02-03T14:05:00Z,True,10,13,0,0,32,14,18,45,25,20,-13,-6
Jakupovic,213,0,257,2019-02-10T13:30:00Z,False,10,16,0,0,32,14,18,57,24,33,-25,-6
Jakupovic,213,0,266,2019-02-23T17:30:00Z,True,10,6,0,0,32,14,18,27,13,14,5,0
Jakupovic,213,0,274,2019-02-26T19:45:00Z,True,10,2,0,0,32,14,18,27,19,8,5,6
Jakupovic,213,0,287,2019-03-03T12:00:00Z,False,10,17,0,0,35,17,18,40,20,20,-5,-2
Jakupovic,213,0,295,2019-03-09T15:00:00Z,True,10,8,0,0,35,17,18,17,15,2,18,15
Jakupovic,213,0,302,2019-03-16T15:00:00Z,False,10,3,0,0,38,20,18,30,17,13,8,1
Jakupovic,213,0,316,2019-03-30T15:00:00Z,True,10,1,0,0,41,20,21,38,26,12,3,8
Jakupovic,213,0,323,2019-04-06T14:00:00Z,False,10,9,0,0,44,23,21,14,8,6,30,13
Jakupovic,213,0,334,2019-04-12T19:00:00Z,True,10,14,0,0,47,23,24,35,22,13,12,10
Jakupovic,213,0,348,2019-04-20T14:00:00Z,False,10,18,0,0,47,23,24,42,27,15,5,-3
Jakupovic,213,0,354,2019-04-28T11:00:00Z,True,10,0,0,0,48,23,25,66,44,22,-18,1
Jakupovic,213,0,366,2019-05-06T19:00:00Z,False,10,12,0,0,51,26,25,92,51,41,-41,-26
Jakupovic,213,0,374,2019-05-12T14:00:00Z,True,10,5,0,0,51,26,25,71,42,29,-20,-3
Morgan,214,1,5,2018-08-10T19:00:00Z,False,10,13,90,1,0,0,0,0,0,0,0,0
Morgan,214,1,16,2018-08-18T14:00:00Z,True,10,19,0,0,0,0,0,1,1,0,-1,0
Morgan,214,1,27,2018-08-25T14:00:00Z,False,10,15,90,2,3,3,0,1,1,0,2,-1
Morgan,214,1,36,2018-09-01T11:30:00Z,True,10,11,90,1,6,3,3,9,6,3,-3,0
Morgan,214,1,40,2018-09-15T14:00:00Z,False,10,1,68,-3,6,3,3,7,4,3,-1,-1
Morgan,214,1,56,2018-09-22T14:00:00Z,True,10,9,0,0,6,3,3,2,1,1,4,2
Morgan,214,1,67,2018-09-29T14:00:00Z,False,10,14,90,7,9,6,3,2,0,2,7,3
Morgan,214,1,74,2018-10-06T14:00:00Z,True,10,7,62,-2,12,6,6,9,7,2,3,4
Morgan,214,1,80,2018-10-22T19:00:00Z,False,10,0,0,0,12,6,6,18,9,9,-6,-3
Morgan,214,1,94,2018-10-27T16:30:00Z,True,10,18,0,0,12,6,6,7,4,3,5,3
Morgan,214,1,102,2018-11-03T15:00:00Z,False,10,4,90,7,13,7,6,5,4,1,8,2
Morgan,214,1,115,2018-11-10T15:00:00Z,True,10,3,90,5,16,7,9,8,4,4,8,3
Morgan,214,1,121,2018-11-24T15:00:00Z,False,10,2,90,2,17,8,9,14,10,4,3,-1
Morgan,214,1,135,2018-12-01T15:00:00Z,True,10,17,90,6,18,8,10,20,12,8,-2,0
Morgan,214,1,143,2018-12-05T19:45:00Z,False,10,8,90,2,21,11,10,8,7,1,13,3
Morgan,214,1,156,2018-12-08T19:45:00Z,True,10,16,90,1,22,11,11,33,12,21,-11,-10
Morgan,214,1,161,2018-12-15T15:00:00Z,False,10,6,90,2,22,11,11,12,5,7,10,6
Morgan,214,1,173,2018-12-22T15:00:00Z,False,10,5,90,6,22,11,11,37,21,16,-15,-10
Morgan,214,1,184,2018-12-26T15:00:00Z,True,10,12,90,2,25,11,14,44,27,17,-19,-6
Morgan,214,1,194,2018-12-29T15:00:00Z,True,10,4,0,0,28,14,14,15,13,2,13,12
Morgan,214,1,204,2019-01-01T12:30:00Z,False,10,7,0,0,28,14,14,27,18,9,1,-4
Morgan,214,1,216,2019-01-12T15:00:00Z,True,10,15,90,1,31,14,17,16,8,8,15,6
Morgan,214,1,229,2019-01-19T12:30:00Z,False,10,19,90,6,31,14,17,29,14,15,2,3
Morgan,214,1,236,2019-01-30T20:00:00Z,False,10,11,0,0,31,14,17,60,31,29,-29,-14
Morgan,214,1,246,2019-02-03T14:05:00Z,True,10,13,0,0,32,14,18,45,25,20,-13,-6
Morgan,214,1,257,2019-02-10T13:30:00Z,False,10,16,0,0,32,14,18,57,24,33,-25,-6
Morgan,214,1,266,2019-02-23T17:30:00Z,True,10,6,0,0,32,14,18,27,13,14,5,0
Morgan,214,1,274,2019-02-26T19:45:00Z,True,10,2,0,0,32,14,18,27,19,8,5,6
Morgan,214,1,287,2019-03-03T12:00:00Z,False,10,17,90,1,35,17,18,40,20,20,-5,-2
Morgan,214,1,295,2019-03-09T15:00:00Z,True,10,8,0,0,35,17,18,17,15,2,18,15
Morgan,214,1,302,2019-03-16T15:00:00Z,False,10,3,84,10,38,20,18,30,17,13,8,1
Morgan,214,1,316,2019-03-30T15:00:00Z,True,10,1,90,15,41,20,21,38,26,12,3,8
Morgan,214,1,323,2019-04-06T14:00:00Z,False,10,9,90,2,44,23,21,14,8,6,30,13
Morgan,214,1,334,2019-04-12T19:00:00Z,True,10,14,90,2,47,23,24,35,22,13,12,10
Morgan,214,1,348,2019-04-20T14:00:00Z,False,10,18,0,0,47,23,24,42,27,15,5,-3
Morgan,214,1,354,2019-04-28T11:00:00Z,True,10,0,0,0,48,23,25,66,44,22,-18,1
Morgan,214,1,366,2019-05-06T19:00:00Z,False,10,12,0,0,51,26,25,92,51,41,-41,-26
Morgan,214,1,374,2019-05-12T14:00:00Z,True,10,5,0,0,51,26,25,71,42,29,-20,-3
Fuchs,215,1,5,2018-08-10T19:00:00Z,False,10,13,0,0,0,0,0,0,0,0,0,0
Fuchs,215,1,16,2018-08-18T14:00:00Z,True,10,19,0,0,0,0,0,1,1,0,-1,0
Fuchs,215,1,27,2018-08-25T14:00:00Z,False,10,15,0,0,3,3,0,1,1,0,2,-1
Fuchs,215,1,36,2018-09-01T11:30:00Z,True,10,11,0,0,6,3,3,9,6,3,-3,0
Fuchs,215,1,40,2018-09-15T14:00:00Z,False,10,1,0,0,6,3,3,7,4,3,-1,-1
Fuchs,215,1,56,2018-09-22T14:00:00Z,True,10,9,0,0,6,3,3,2,1,1,4,2
Fuchs,215,1,67,2018-09-29T14:00:00Z,False,10,14,0,0,9,6,3,2,0,2,7,3
Fuchs,215,1,74,2018-10-06T14:00:00Z,True,10,7,0,0,12,6,6,9,7,2,3,4
Fuchs,215,1,80,2018-10-22T19:00:00Z,False,10,0,0,0,12,6,6,18,9,9,-6,-3
Fuchs,215,1,94,2018-10-27T16:30:00Z,True,10,18,0,0,12,6,6,7,4,3,5,3
Fuchs,215,1,102,2018-11-03T15:00:00Z,False,10,4,0,0,13,7,6,5,4,1,8,2
Fuchs,215,1,115,2018-11-10T15:00:00Z,True,10,3,0,0,16,7,9,8,4,4,8,3
Fuchs,215,1,121,2018-11-24T15:00:00Z,False,10,2,0,0,17,8,9,14,10,4,3,-1
Fuchs,215,1,135,2018-12-01T15:00:00Z,True,10,17,0,0,18,8,10,20,12,8,-2,0
Fuchs,215,1,143,2018-12-05T19:45:00Z,False,10,8,0,0,21,11,10,8,7,1,13,3
Fuchs,215,1,156,2018-12-08T19:45:00Z,True,10,16,0,0,22,11,11,33,12,21,-11,-10
Fuchs,215,1,161,2018-12-15T15:00:00Z,False,10,6,90,2,22,11,11,12,5,7,10,6
Fuchs,215,1,173,2018-12-22T15:00:00Z,False,10,5,0,0,22,11,11,37,21,16,-15,-10
Fuchs,215,1,184,2018-12-26T15:00:00Z,True,10,12,0,0,25,11,14,44,27,17,-19,-6
Fuchs,215,1,194,2018-12-29T15:00:00Z,True,10,4,0,0,28,14,14,15,13,2,13,12
Fuchs,215,1,204,2019-01-01T12:30:00Z,False,10,7,0,0,28,14,14,27,18,9,1,-4
Fuchs,215,1,216,2019-01-12T15:00:00Z,True,10,15,0,0,31,14,17,16,8,8,15,6
Fuchs,215,1,229,2019-01-19T12:30:00Z,False,10,19,0,0,31,14,17,29,14,15,2,3
Fuchs,215,1,236,2019-01-30T20:00:00Z,False,10,11,0,0,31,14,17,60,31,29,-29,-14
Fuchs,215,1,246,2019-02-03T14:05:00Z,True,10,13,0,0,32,14,18,45,25,20,-13,-6
Fuchs,215,1,257,2019-02-10T13:30:00Z,False,10,16,0,0,32,14,18,57,24,33,-25,-6
Fuchs,215,1,266,2019-02-23T17:30:00Z,True,10,6,90,0,32,14,18,27,13,14,5,0
Fuchs,215,1,274,2019-02-26T19:45:00Z,True,10,2,0,0,32,14,18,27,19,8,5,6
Fuchs,215,1,287,2019-03-03T12:00:00Z,False,10,17,0,0,35,17,18,40,20,20,-5,-2
Fuchs,215,1,295,2019-03-09T15:00:00Z,True,10,8,0,0,35,17,18,17,15,2,18,15
Fuchs,215,1,302,2019-03-16T15:00:00Z,False,10,3,26,1,38,20,18,30,17,13,8,1
Fuchs,215,1,316,2019-03-30T15:00:00Z,True,10,1,0,0,41,20,21,38,26,12,3,8
Fuchs,215,1,323,2019-04-06T14:00:00Z,False,10,9,0,0,44,23,21,14,8,6,30,13
Fuchs,215,1,334,2019-04-12T19:00:00Z,True,10,14,0,0,47,23,24,35,22,13,12,10
Fuchs,215,1,348,2019-04-20T14:00:00Z,False,10,18,0,0,47,23,24,42,27,15,5,-3
Fuchs,215,1,354,2019-04-28T11:00:00Z,True,10,0,0,0,48,23,25,66,44,22,-18,1
Fuchs,215,1,366,2019-05-06T19:00:00Z,False,10,12,0,0,51,26,25,92,51,41,-41,-26
Fuchs,215,1,374,2019-05-12T14:00:00Z,True,10,5,0,0,51,26,25,71,42,29,-20,-3
Simpson,216,1,5,2018-08-10T19:00:00Z,False,10,13,0,0,0,0,0,0,0,0,0,0
Simpson,216,1,16,2018-08-18T14:00:00Z,True,10,19,0,0,0,0,0,1,1,0,-1,0
Simpson,216,1,27,2018-08-25T14:00:00Z,False,10,15,0,0,3,3,0,1,1,0,2,-1
Simpson,216,1,36,2018-09-01T11:30:00Z,True,10,11,0,0,6,3,3,9,6,3,-3,0
Simpson,216,1,40,2018-09-15T14:00:00Z,False,10,1,0,0,6,3,3,7,4,3,-1,-1
Simpson,216,1,56,2018-09-22T14:00:00Z,True,10,9,0,0,6,3,3,2,1,1,4,2
Simpson,216,1,67,2018-09-29T14:00:00Z,False,10,14,0,0,9,6,3,2,0,2,7,3
Simpson,216,1,74,2018-10-06T14:00:00Z,True,10,7,0,0,12,6,6,9,7,2,3,4
Simpson,216,1,80,2018-10-22T19:00:00Z,False,10,0,0,0,12,6,6,18,9,9,-6,-3
Simpson,216,1,94,2018-10-27T16:30:00Z,True,10,18,0,0,12,6,6,7,4,3,5,3
Simpson,216,1,102,2018-11-03T15:00:00Z,False,10,4,20,1,13,7,6,5,4,1,8,2
Simpson,216,1,115,2018-11-10T15:00:00Z,True,10,3,0,0,16,7,9,8,4,4,8,3
Simpson,216,1,121,2018-11-24T15:00:00Z,False,10,2,0,0,17,8,9,14,10,4,3,-1
Simpson,216,1,135,2018-12-01T15:00:00Z,True,10,17,0,0,18,8,10,20,12,8,-2,0
Simpson,216,1,143,2018-12-05T19:45:00Z,False,10,8,71,2,21,11,10,8,7,1,13,3
Simpson,216,1,156,2018-12-08T19:45:00Z,True,10,16,0,0,22,11,11,33,12,21,-11,-10
Simpson,216,1,161,2018-12-15T15:00:00Z,False,10,6,0,0,22,11,11,12,5,7,10,6
Simpson,216,1,173,2018-12-22T15:00:00Z,False,10,5,0,0,22,11,11,37,21,16,-15,-10
Simpson,216,1,184,2018-12-26T15:00:00Z,True,10,12,12,1,25,11,14,44,27,17,-19,-6
Simpson,216,1,194,2018-12-29T15:00:00Z,True,10,4,0,0,28,14,14,15,13,2,13,12
Simpson,216,1,204,2019-01-01T12:30:00Z,False,10,7,90,6,28,14,14,27,18,9,1,-4
Simpson,216,1,216,2019-01-12T15:00:00Z,True,10,15,0,0,31,14,17,16,8,8,15,6
Simpson,216,1,229,2019-01-19T12:30:00Z,False,10,19,82,1,31,14,17,29,14,15,2,3
Simpson,216,1,236,2019-01-30T20:00:00Z,False,10,11,0,0,31,14,17,60,31,29,-29,-14
Simpson,216,1,246,2019-02-03T14:05:00Z,True,10,13,0,0,32,14,18,45,25,20,-13,-6
Simpson,216,1,257,2019-02-10T13:30:00Z,False,10,16,0,0,32,14,18,57,24,33,-25,-6
Simpson,216,1,266,2019-02-23T17:30:00Z,True,10,6,0,0,32,14,18,27,13,14,5,0
Simpson,216,1,274,2019-02-26T19:45:00Z,True,10,2,0,0,32,14,18,27,19,8,5,6
Simpson,216,1,287,2019-03-03T12:00:00Z,False,10,17,0,0,35,17,18,40,20,20,-5,-2
Simpson,216,1,295,2019-03-09T15:00:00Z,True,10,8,0,0,35,17,18,17,15,2,18,15
Simpson,216,1,302,2019-03-16T15:00:00Z,False,10,3,0,0,38,20,18,30,17,13,8,1
Simpson,216,1,316,2019-03-30T15:00:00Z,True,10,1,0,0,41,20,21,38,26,12,3,8
Simpson,216,1,323,2019-04-06T14:00:00Z,False,10,9,0,0,44,23,21,14,8,6,30,13
Simpson,216,1,334,2019-04-12T19:00:00Z,True,10,14,0,0,47,23,24,35,22,13,12,10
Simpson,216,1,348,2019-04-20T14:00:00Z,False,10,18,0,0,47,23,24,42,27,15,5,-3
Simpson,216,1,354,2019-04-28T11:00:00Z,True,10,0,0,0,48,23,25,66,44,22,-18,1
Simpson,216,1,366,2019-05-06T19:00:00Z,False,10,12,0,0,51,26,25,92,51,41,-41,-26
Simpson,216,1,374,2019-05-12T14:00:00Z,True,10,5,14,1,51,26,25,71,42,29,-20,-3
Benalouane,217,1,5,2018-08-10T19:00:00Z,False,10,13,0,0,0,0,0,0,0,0,0,0
Benalouane,217,1,16,2018-08-18T14:00:00Z,True,10,19,0,0,0,0,0,1,1,0,-1,0
Benalouane,217,1,27,2018-08-25T14:00:00Z,False,10,15,0,0,3,3,0,1,1,0,2,-1
Benalouane,217,1,36,2018-09-01T11:30:00Z,True,10,11,0,0,6,3,3,9,6,3,-3,0
Benalouane,217,1,40,2018-09-15T14:00:00Z,False,10,1,0,0,6,3,3,7,4,3,-1,-1
Benalouane,217,1,56,2018-09-22T14:00:00Z,True,10,9,0,0,6,3,3,2,1,1,4,2
Benalouane,217,1,67,2018-09-29T14:00:00Z,False,10,14,0,0,9,6,3,2,0,2,7,3
Benalouane,217,1,74,2018-10-06T14:00:00Z,True,10,7,0,0,12,6,6,9,7,2,3,4
Benalouane,217,1,80,2018-10-22T19:00:00Z,False,10,0,0,0,12,6,6,18,9,9,-6,-3
Benalouane,217,1,94,2018-10-27T16:30:00Z,True,10,18,0,0,12,6,6,7,4,3,5,3
Benalouane,217,1,102,2018-11-03T15:00:00Z,False,10,4,0,0,13,7,6,5,4,1,8,2
Benalouane,217,1,115,2018-11-10T15:00:00Z,True,10,3,0,0,16,7,9,8,4,4,8,3
Benalouane,217,1,121,2018-11-24T15:00:00Z,False,10,2,0,0,17,8,9,14,10,4,3,-1
Benalouane,217,1,135,2018-12-01T15:00:00Z,True,10,17,0,0,18,8,10,20,12,8,-2,0
Benalouane,217,1,143,2018-12-05T19:45:00Z,False,10,8,0,0,21,11,10,8,7,1,13,3
Benalouane,217,1,156,2018-12-08T19:45:00Z,True,10,16,0,0,22,11,11,33,12,21,-11,-10
Benalouane,217,1,161,2018-12-15T15:00:00Z,False,10,6,0,0,22,11,11,12,5,7,10,6
Benalouane,217,1,173,2018-12-22T15:00:00Z,False,10,5,0,0,22,11,11,37,21,16,-15,-10
Benalouane,217,1,184,2018-12-26T15:00:00Z,True,10,12,0,0,25,11,14,44,27,17,-19,-6
Benalouane,217,1,194,2018-12-29T15:00:00Z,True,10,4,0,0,28,14,14,15,13,2,13,12
Benalouane,217,1,204,2019-01-01T12:30:00Z,False,10,7,0,0,28,14,14,27,18,9,1,-4
Benalouane,217,1,216,2019-01-12T15:00:00Z,True,10,15,0,0,31,14,17,16,8,8,15,6
Benalouane,217,1,229,2019-01-19T12:30:00Z,False,10,19,0,0,31,14,17,29,14,15,2,3
Benalouane,217,1,236,2019-01-30T20:00:00Z,False,10,11,0,0,31,14,17,60,31,29,-29,-14
Benalouane,217,1,246,2019-02-03T14:05:00Z,True,10,13,0,0,32,14,18,45,25,20,-13,-6
Benalouane,217,1,257,2019-02-10T13:30:00Z,False,10,16,0,0,32,14,18,57,24,33,-25,-6
Benalouane,217,1,266,2019-02-23T17:30:00Z,True,10,6,0,0,32,14,18,27,13,14,5,0
Benalouane,217,1,274,2019-02-26T19:45:00Z,True,10,2,0,0,32,14,18,27,19,8,5,6
Benalouane,217,1,287,2019-03-03T12:00:00Z,False,10,17,0,0,35,17,18,40,20,20,-5,-2
Benalouane,217,1,295,2019-03-09T15:00:00Z,True,10,8,0,0,35,17,18,17,15,2,18,15
Benalouane,217,1,302,2019-03-16T15:00:00Z,False,10,3,0,0,38,20,18,30,17,13,8,1
Benalouane,217,1,316,2019-03-30T15:00:00Z,True,10,1,0,0,41,20,21,38,26,12,3,8
Benalouane,217,1,323,2019-04-06T14:00:00Z,False,10,9,0,0,44,23,21,14,8,6,30,13
Benalouane,217,1,334,2019-04-12T19:00:00Z,True,10,14,0,0,47,23,24,35,22,13,12,10
Benalouane,217,1,348,2019-04-20T14:00:00Z,False,10,18,0,0,47,23,24,42,27,15,5,-3
Benalouane,217,1,354,2019-04-28T11:00:00Z,True,10,0,0,0,48,23,25,66,44,22,-18,1
Benalouane,217,1,366,2019-05-06T19:00:00Z,False,10,12,0,0,51,26,25,92,51,41,-41,-26
Benalouane,217,1,374,2019-05-12T14:00:00Z,True,10,5,0,0,51,26,25,71,42,29,-20,-3
Chilwell,218,1,5,2018-08-10T19:00:00Z,False,10,13,90,1,0,0,0,0,0,0,0,0
Chilwell,218,1,16,2018-08-18T14:00:00Z,True,10,19,90,8,0,0,0,1,1,0,-1,0
Chilwell,218,1,27,2018-08-25T14:00:00Z,False,10,15,90,2,3,3,0,1,1,0,2,-1
Chilwell,218,1,36,2018-09-01T11:30:00Z,True,10,11,90,1,6,3,3,9,6,3,-3,0
Chilwell,218,1,40,2018-09-15T14:00:00Z,False,10,1,90,0,6,3,3,7,4,3,-1,-1
Chilwell,218,1,56,2018-09-22T14:00:00Z,True,10,9,90,2,6,3,3,2,1,1,4,2
Chilwell,218,1,67,2018-09-29T14:00:00Z,False,10,14,90,6,9,6,3,2,0,2,7,3
Chilwell,218,1,74,2018-10-06T14:00:00Z,True,10,7,90,0,12,6,6,9,7,2,3,4
Chilwell,218,1,80,2018-10-22T19:00:00Z,False,10,0,90,4,12,6,6,18,9,9,-6,-3
Chilwell,218,1,94,2018-10-27T16:30:00Z,True,10,18,90,2,12,6,6,7,4,3,5,3
Chilwell,218,1,102,2018-11-03T15:00:00Z,False,10,4,90,12,13,7,6,5,4,1,8,2
Chilwell,218,1,115,2018-11-10T15:00:00Z,True,10,3,90,6,16,7,9,8,4,4,8,3
Chilwell,218,1,121,2018-11-24T15:00:00Z,False,10,2,90,2,17,8,9,14,10,4,3,-1
Chilwell,218,1,135,2018-12-01T15:00:00Z,True,10,17,90,6,18,8,10,20,12,8,-2,0
Chilwell,218,1,143,2018-12-05T19:45:00Z,False,10,8,90,2,21,11,10,8,7,1,13,3
Chilwell,218,1,156,2018-12-08T19:45:00Z,True,10,16,90,1,22,11,11,33,12,21,-11,-10
Chilwell,218,1,161,2018-12-15T15:00:00Z,False,10,6,0,0,22,11,11,12,5,7,10,6
Chilwell,218,1,173,2018-12-22T15:00:00Z,False,10,5,90,6,22,11,11,37,21,16,-15,-10
Chilwell,218,1,184,2018-12-26T15:00:00Z,True,10,12,90,2,25,11,14,44,27,17,-19,-6
Chilwell,218,1,194,2018-12-29T15:00:00Z,True,10,4,90,2,28,14,14,15,13,2,13,12
Chilwell,218,1,204,2019-01-01T12:30:00Z,False,10,7,90,6,28,14,14,27,18,9,1,-4
Chilwell,218,1,216,2019-01-12T15:00:00Z,True,10,15,90,0,31,14,17,16,8,8,15,6
Chilwell,218,1,229,2019-01-19T12:30:00Z,False,10,19,90,0,31,14,17,29,14,15,2,3
Chilwell,218,1,236,2019-01-30T20:00:00Z,False,10,11,90,7,31,14,17,60,31,29,-29,-14
Chilwell,218,1,246,2019-02-03T14:05:00Z,True,10,13,90,2,32,14,18,45,25,20,-13,-6
Chilwell,218,1,257,2019-02-10T13:30:00Z,False,10,16,90,1,32,14,18,57,24,33,-25,-6
Chilwell,218,1,266,2019-02-23T17:30:00Z,True,10,6,0,0,32,14,18,27,13,14,5,0
Chilwell,218,1,274,2019-02-26T19:45:00Z,True,10,2,90,2,32,14,18,27,19,8,5,6
Chilwell,218,1,287,2019-03-03T12:00:00Z,False,10,17,90,1,35,17,18,40,20,20,-5,-2
Chilwell,218,1,295,2019-03-09T15:00:00Z,True,10,8,90,2,35,17,18,17,15,2,18,15
Chilwell,218,1,302,2019-03-16T15:00:00Z,False,10,3,90,2,38,20,18,30,17,13,8,1
Chilwell,218,1,316,2019-03-30T15:00:00Z,True,10,1,90,9,41,20,21,38,26,12,3,8
Chilwell,218,1,323,2019-04-06T14:00:00Z,False,10,9,90,2,44,23,21,14,8,6,30,13
Chilwell,218,1,334,2019-04-12T19:00:00Z,True,10,14,90,2,47,23,24,35,22,13,12,10
Chilwell,218,1,348,2019-04-20T14:00:00Z,False,10,18,90,4,47,23,24,42,27,15,5,-3
Chilwell,218,1,354,2019-04-28T11:00:00Z,True,10,0,90,5,48,23,25,66,44,22,-18,1
Chilwell,218,1,366,2019-05-06T19:00:00Z,False,10,12,90,2,51,26,25,92,51,41,-41,-26
Chilwell,218,1,374,2019-05-12T14:00:00Z,True,10,5,90,6,51,26,25,71,42,29,-20,-3
Maguire,219,1,5,2018-08-10T19:00:00Z,False,10,13,90,1,0,0,0,0,0,0,0,0
Maguire,219,1,16,2018-08-18T14:00:00Z,True,10,19,90,5,0,0,0,1,1,0,-1,0
Maguire,219,1,27,2018-08-25T14:00:00Z,False,10,15,90,10,3,3,0,1,1,0,2,-1
Maguire,219,1,36,2018-09-01T11:30:00Z,True,10,11,90,1,6,3,3,9,6,3,-3,0
Maguire,219,1,40,2018-09-15T14:00:00Z,False,10,1,90,-1,6,3,3,7,4,3,-1,-1
Maguire,219,1,56,2018-09-22T14:00:00Z,True,10,9,90,2,6,3,3,2,1,1,4,2
Maguire,219,1,67,2018-09-29T14:00:00Z,False,10,14,90,18,9,6,3,2,0,2,7,3
Maguire,219,1,74,2018-10-06T14:00:00Z,True,10,7,90,1,12,6,6,9,7,2,3,4
Maguire,219,1,80,2018-10-22T19:00:00Z,False,10,0,90,1,12,6,6,18,9,9,-6,-3
Maguire,219,1,94,2018-10-27T16:30:00Z,True,10,18,90,2,12,6,6,7,4,3,5,3
Maguire,219,1,102,2018-11-03T15:00:00Z,False,10,4,26,1,13,7,6,5,4,1,8,2
Maguire,219,1,115,2018-11-10T15:00:00Z,True,10,3,0,0,16,7,9,8,4,4,8,3
Maguire,219,1,121,2018-11-24T15:00:00Z,False,10,2,0,0,17,8,9,14,10,4,3,-1
Maguire,219,1,135,2018-12-01T15:00:00Z,True,10,17,0,0,18,8,10,20,12,8,-2,0
Maguire,219,1,143,2018-12-05T19:45:00Z,False,10,8,0,0,21,11,10,8,7,1,13,3
Maguire,219,1,156,2018-12-08T19:45:00Z,True,10,16,0,0,22,11,11,33,12,21,-11,-10
Maguire,219,1,161,2018-12-15T15:00:00Z,False,10,6,90,2,22,11,11,12,5,7,10,6
Maguire,219,1,173,2018-12-22T15:00:00Z,False,10,5,90,6,22,11,11,37,21,16,-15,-10
Maguire,219,1,184,2018-12-26T15:00:00Z,True,10,12,90,1,25,11,14,44,27,17,-19,-6
Maguire,219,1,194,2018-12-29T15:00:00Z,True,10,4,90,2,28,14,14,15,13,2,13,12
Maguire,219,1,204,2019-01-01T12:30:00Z,False,10,7,90,7,28,14,14,27,18,9,1,-4
Maguire,219,1,216,2019-01-12T15:00:00Z,True,10,15,90,1,31,14,17,16,8,8,15,6
Maguire,219,1,229,2019-01-19T12:30:00Z,False,10,19,47,0,31,14,17,29,14,15,2,3
Maguire,219,1,236,2019-01-30T20:00:00Z,False,10,11,90,8,31,14,17,60,31,29,-29,-14
Maguire,219,1,246,2019-02-03T14:05:00Z,True,10,13,90,2,32,14,18,45,25,20,-13,-6
Maguire,219,1,257,2019-02-10T13:30:00Z,False,10,16,90,1,32,14,18,57,24,33,-25,-6
Maguire,219,1,266,2019-02-23T17:30:00Z,True,10,6,90,0,32,14,18,27,13,14,5,0
Maguire,219,1,274,2019-02-26T19:45:00Z,True,10,2,90,2,32,14,18,27,19,8,5,6
Maguire,219,1,287,2019-03-03T12:00:00Z,False,10,17,90,1,35,17,18,40,20,20,-5,-2
Maguire,219,1,295,2019-03-09T15:00:00Z,True,10,8,90,2,35,17,18,17,15,2,18,15
Maguire,219,1,302,2019-03-16T15:00:00Z,False,10,3,3,-2,38,20,18,30,17,13,8,1
Maguire,219,1,316,2019-03-30T15:00:00Z,True,10,1,0,0,41,20,21,38,26,12,3,8
Maguire,219,1,323,2019-04-06T14:00:00Z,False,10,9,0,0,44,23,21,14,8,6,30,13
Maguire,219,1,334,2019-04-12T19:00:00Z,True,10,14,90,2,47,23,24,35,22,13,12,10
Maguire,219,1,348,2019-04-20T14:00:00Z,False,10,18,90,1,47,23,24,42,27,15,5,-3
Maguire,219,1,354,2019-04-28T11:00:00Z,True,10,0,90,6,48,23,25,66,44,22,-18,1
Maguire,219,1,366,2019-05-06T19:00:00Z,False,10,12,90,1,51,26,25,92,51,41,-41,-26
Maguire,219,1,374,2019-05-12T14:00:00Z,True,10,5,90,8,51,26,25,71,42,29,-20,-3
Pereira,220,1,5,2018-08-10T19:00:00Z,False,10,13,90,4,0,0,0,0,0,0,0,0
Pereira,220,1,16,2018-08-18T14:00:00Z,True,10,19,90,12,0,0,0,1,1,0,-1,0
Pereira,220,1,27,2018-08-25T14:00:00Z,False,10,15,90,2,3,3,0,1,1,0,2,-1
Pereira,220,1,36,2018-09-01T11:30:00Z,True,10,11,90,1,6,3,3,9,6,3,-3,0
Pereira,220,1,40,2018-09-15T14:00:00Z,False,10,1,90,3,6,3,3,7,4,3,-1,-1
Pereira,220,1,56,2018-09-22T14:00:00Z,True,10,9,0,0,6,3,3,2,1,1,4,2
Pereira,220,1,67,2018-09-29T14:00:00Z,False,10,14,90,6,9,6,3,2,0,2,7,3
Pereira,220,1,74,2018-10-06T14:00:00Z,True,10,7,85,7,12,6,6,9,7,2,3,4
Pereira,220,1,80,2018-10-22T19:00:00Z,False,10,0,68,0,12,6,6,18,9,9,-6,-3
Pereira,220,1,94,2018-10-27T16:30:00Z,True,10,18,0,0,12,6,6,7,4,3,5,3
Pereira,220,1,102,2018-11-03T15:00:00Z,False,10,4,90,5,13,7,6,5,4,1,8,2
Pereira,220,1,115,2018-11-10T15:00:00Z,True,10,3,90,9,16,7,9,8,4,4,8,3
Pereira,220,1,121,2018-11-24T15:00:00Z,False,10,2,90,2,17,8,9,14,10,4,3,-1
Pereira,220,1,135,2018-12-01T15:00:00Z,True,10,17,90,9,18,8,10,20,12,8,-2,0
Pereira,220,1,143,2018-12-05T19:45:00Z,False,10,8,0,0,21,11,10,8,7,1,13,3
Pereira,220,1,156,2018-12-08T19:45:00Z,True,10,16,90,1,22,11,11,33,12,21,-11,-10
Pereira,220,1,161,2018-12-15T15:00:00Z,False,10,6,90,1,22,11,11,12,5,7,10,6
Pereira,220,1,173,2018-12-22T15:00:00Z,False,10,5,90,7,22,11,11,37,21,16,-15,-10
Pereira,220,1,184,2018-12-26T15:00:00Z,True,10,12,90,9,25,11,14,44,27,17,-19,-6
Pereira,220,1,194,2018-12-29T15:00:00Z,True,10,4,90,2,28,14,14,15,13,2,13,12
Pereira,220,1,204,2019-01-01T12:30:00Z,False,10,7,90,12,28,14,14,27,18,9,1,-4
Pereira,220,1,216,2019-01-12T15:00:00Z,True,10,15,90,4,31,14,17,16,8,8,15,6
Pereira,220,1,229,2019-01-19T12:30:00Z,False,10,19,90,-1,31,14,17,29,14,15,2,3
Pereira,220,1,236,2019-01-30T20:00:00Z,False,10,11,90,1,31,14,17,60,31,29,-29,-14
Pereira,220,1,246,2019-02-03T14:05:00Z,True,10,13,90,2,32,14,18,45,25,20,-13,-6
Pereira,220,1,257,2019-02-10T13:30:00Z,False,10,16,90,4,32,14,18,57,24,33,-25,-6
Pereira,220,1,266,2019-02-23T17:30:00Z,True,10,6,90,0,32,14,18,27,13,14,5,0
Pereira,220,1,274,2019-02-26T19:45:00Z,True,10,2,90,2,32,14,18,27,19,8,5,6
Pereira,220,1,287,2019-03-03T12:00:00Z,False,10,17,90,0,35,17,18,40,20,20,-5,-2
Pereira,220,1,295,2019-03-09T15:00:00Z,True,10,8,90,2,35,17,18,17,15,2,18,15
Pereira,220,1,302,2019-03-16T15:00:00Z,False,10,3,90,2,38,20,18,30,17,13,8,1
Pereira,220,1,316,2019-03-30T15:00:00Z,True,10,1,90,8,41,20,21,38,26,12,3,8
Pereira,220,1,323,2019-04-06T14:00:00Z,False,10,9,90,6,44,23,21,14,8,6,30,13
Pereira,220,1,334,2019-04-12T19:00:00Z,True,10,14,90,2,47,23,24,35,22,13,12,10
Pereira,220,1,348,2019-04-20T14:00:00Z,False,10,18,90,1,47,23,24,42,27,15,5,-3
Pereira,220,1,354,2019-04-28T11:00:00Z,True,10,0,90,10,48,23,25,66,44,22,-18,1
Pereira,220,1,366,2019-05-06T19:00:00Z,False,10,12,90,2,51,26,25,92,51,41,-41,-26
Pereira,220,1,374,2019-05-12T14:00:00Z,True,10,5,90,9,51,26,25,71,42,29,-20,-3
Evans,221,1,5,2018-08-10T19:00:00Z,False,10,13,0,0,0,0,0,0,0,0,0,0
Evans,221,1,16,2018-08-18T14:00:00Z,True,10,19,90,5,0,0,0,1,1,0,-1,0
Evans,221,1,27,2018-08-25T14:00:00Z,False,10,15,0,0,3,3,0,1,1,0,2,-1
Evans,221,1,36,2018-09-01T11:30:00Z,True,10,11,0,0,6,3,3,9,6,3,-3,0
Evans,221,1,40,2018-09-15T14:00:00Z,False,10,1,6,1,6,3,3,7,4,3,-1,-1
Evans,221,1,56,2018-09-22T14:00:00Z,True,10,9,90,2,6,3,3,2,1,1,4,2
Evans,221,1,67,2018-09-29T14:00:00Z,False,10,14,0,0,9,6,3,2,0,2,7,3
Evans,221,1,74,2018-10-06T14:00:00Z,True,10,7,0,0,12,6,6,9,7,2,3,4
Evans,221,1,80,2018-10-22T19:00:00Z,False,10,0,90,1,12,6,6,18,9,9,-6,-3
Evans,221,1,94,2018-10-27T16:30:00Z,True,10,18,0,0,12,6,6,7,4,3,5,3
Evans,221,1,102,2018-11-03T15:00:00Z,False,10,4,63,6,13,7,6,5,4,1,8,2
Evans,221,1,115,2018-11-10T15:00:00Z,True,10,3,89,6,16,7,9,8,4,4,8,3
Evans,221,1,121,2018-11-24T15:00:00Z,False,10,2,90,2,17,8,9,14,10,4,3,-1
Evans,221,1,135,2018-12-01T15:00:00Z,True,10,17,83,6,18,8,10,20,12,8,-2,0
Evans,221,1,143,2018-12-05T19:45:00Z,False,10,8,0,0,21,11,10,8,7,1,13,3
Evans,221,1,156,2018-12-08T19:45:00Z,True,10,16,90,1,22,11,11,33,12,21,-11,-10
Evans,221,1,161,2018-12-15T15:00:00Z,False,10,6,0,0,22,11,11,12,5,7,10,6
Evans,221,1,173,2018-12-22T15:00:00Z,False,10,5,0,0,22,11,11,37,21,16,-15,-10
Evans,221,1,184,2018-12-26T15:00:00Z,True,10,12,0,0,25,11,14,44,27,17,-19,-6
Evans,221,1,194,2018-12-29T15:00:00Z,True,10,4,0,0,28,14,14,15,13,2,13,12
Evans,221,1,204,2019-01-01T12:30:00Z,False,10,7,90,5,28,14,14,27,18,9,1,-4
Evans,221,1,216,2019-01-12T15:00:00Z,True,10,15,0,0,31,14,17,16,8,8,15,6
Evans,221,1,229,2019-01-19T12:30:00Z,False,10,19,42,0,31,14,17,29,14,15,2,3
Evans,221,1,236,2019-01-30T20:00:00Z,False,10,11,90,2,31,14,17,60,31,29,-29,-14
Evans,221,1,246,2019-02-03T14:05:00Z,True,10,13,90,2,32,14,18,45,25,20,-13,-6
Evans,221,1,257,2019-02-10T13:30:00Z,False,10,16,90,1,32,14,18,57,24,33,-25,-6
Evans,221,1,266,2019-02-23T17:30:00Z,True,10,6,90,7,32,14,18,27,13,14,5,0
Evans,221,1,274,2019-02-26T19:45:00Z,True,10,2,90,2,32,14,18,27,19,8,5,6
Evans,221,1,287,2019-03-03T12:00:00Z,False,10,17,90,1,35,17,18,40,20,20,-5,-2
Evans,221,1,295,2019-03-09T15:00:00Z,True,10,8,90,2,35,17,18,17,15,2,18,15
Evans,221,1,302,2019-03-16T15:00:00Z,False,10,3,90,2,38,20,18,30,17,13,8,1
Evans,221,1,316,2019-03-30T15:00:00Z,True,10,1,90,6,41,20,21,38,26,12,3,8
Evans,221,1,323,2019-04-06T14:00:00Z,False,10,9,0,0,44,23,21,14,8,6,30,13
Evans,221,1,334,2019-04-12T19:00:00Z,True,10,14,0,0,47,23,24,35,22,13,12,10
Evans,221,1,348,2019-04-20T14:00:00Z,False,10,18,90,1,47,23,24,42,27,15,5,-3
Evans,221,1,354,2019-04-28T11:00:00Z,True,10,0,90,6,48,23,25,66,44,22,-18,1
Evans,221,1,366,2019-05-06T19:00:00Z,False,10,12,90,2,51,26,25,92,51,41,-41,-26
Evans,221,1,374,2019-05-12T14:00:00Z,True,10,5,90,8,51,26,25,71,42,29,-20,-3
Mahrez,222,2,0,2018-08-12T15:00:00Z,False,12,0,59,1,0,0,0,0,0,0,0,0
Mahrez,222,2,17,2018-08-19T12:30:00Z,True,12,9,26,1,3,0,3,0,0,0,3,0
Mahrez,222,2,29,2018-08-25T11:30:00Z,False,12,19,5,1,6,3,3,1,1,0,5,2
Mahrez,222,2,37,2018-09-01T16:30:00Z,True,12,14,75,2,7,3,4,1,0,1,6,2
Mahrez,222,2,44,2018-09-15T14:00:00Z,True,12,8,16,1,10,6,4,4,3,1,6,5
Mahrez,222,2,53,2018-09-22T14:00:00Z,False,12,4,29,12,13,9,4,2,1,1,11,3
Mahrez,222,2,66,2018-09-29T14:00:00Z,True,12,2,19,1,16,9,7,5,4,1,11,8
Mahrez,222,2,75,2018-10-07T15:30:00Z,False,12,11,90,1,19,12,7,19,9,10,0,-2
Mahrez,222,2,86,2018-10-20T14:00:00Z,True,12,3,90,10,20,12,8,8,4,4,12,8
Mahrez,222,2,98,2018-10-29T20:00:00Z,False,12,16,90,11,23,15,8,21,6,15,2,2
Mahrez,222,2,106,2018-11-04T15:00:00Z,True,12,15,0,0,26,15,11,7,3,4,19,11
Mahrez,222,2,117,2018-11-11T16:30:00Z,True,12,13,61,5,29,18,11,20,10,10,9,8
Mahrez,222,2,128,2018-11-24T15:00:00Z,False,12,18,16,1,32,21,11,12,7,5,20,4
Mahrez,222,2,137,2018-12-01T15:00:00Z,True,12,1,3,1,35,21,14,20,11,9,15,12
Mahrez,222,2,145,2018-12-04T20:00:00Z,False,12,17,90,13,38,24,14,20,12,8,18,2
Mahrez,222,2,154,2018-12-08T17:30:00Z,False,12,5,83,2,41,24,17,31,18,13,10,-1
Mahrez,222,2,165,2018-12-15T12:30:00Z,True,12,7,74,2,41,24,17,24,18,6,17,18
Mahrez,222,2,176,2018-12-22T15:00:00Z,True,12,6,21,1,44,27,17,15,8,7,29,20
Mahrez,222,2,184,2018-12-26T15:00:00Z,False,12,10,7,1,44,27,17,25,11,14,19,6
Mahrez,222,2,197,2018-12-30T14:15:00Z,False,12,15,83,2,44,27,17,15,8,7,29,9
Mahrez,222,2,206,2019-01-03T20:00:00Z,True,12,11,0,0,47,27,20,54,28,26,-7,1
Mahrez,222,2,217,2019-01-14T20:00:00Z,True,12,19,0,0,50,30,20,29,14,15,21,15
Mahrez,222,2,223,2019-01-20T13:30:00Z,False,12,9,0,0,53,33,20,11,5,6,42,15
Mahrez,222,2,237,2019-01-29T20:00:00Z,False,12,14,0,0,56,33,23,21,10,11,35,13
Mahrez,222,2,247,2019-02-03T16:30:00Z,True,12,0,2,1,56,33,23,47,32,15,9,18
Mahrez,222,2,265,2019-02-06T19:45:00Z,False,12,7,0,0,59,36,23,33,21,12,26,2
Mahrez,222,2,255,2019-02-10T16:00:00Z,True,12,5,22,1,62,36,26,50,28,22,12,14
Mahrez,222,2,277,2019-02-27T20:00:00Z,True,12,18,54,1,65,39,26,36,21,15,29,24
Mahrez,222,2,280,2019-03-02T15:00:00Z,False,12,1,45,6,68,42,26,34,25,9,34,1
Mahrez,222,2,297,2019-03-09T17:30:00Z,True,12,17,89,7,71,42,29,43,23,20,28,22
Mahrez,222,2,315,2019-03-30T12:30:00Z,False,12,8,2,1,74,45,29,17,15,2,57,14
Mahrez,222,2,324,2019-04-03T18:45:00Z,True,12,4,90,3,77,45,32,28,20,8,49,37
Mahrez,222,2,332,2019-04-14T13:05:00Z,False,12,6,0,0,80,48,32,39,16,23,41,16
Mahrez,222,2,346,2019-04-20T11:30:00Z,True,12,16,0,0,83,48,35,67,34,33,16,15
Mahrez,222,2,305,2019-04-24T19:00:00Z,False,12,13,0,0,86,51,35,64,35,29,22,0
Mahrez,222,2,351,2019-04-28T13:05:00Z,False,12,3,0,0,89,51,38,40,23,17,49,15
Mahrez,222,2,366,2019-05-06T19:00:00Z,True,12,10,0,0,92,51,41,51,26,25,41,26
Mahrez,222,2,370,2019-05-12T14:00:00Z,False,12,2,90,13,95,54,41,36,23,13,59,18
Albrighton,223,2,5,2018-08-10T19:00:00Z,False,10,13,0,0,0,0,0,0,0,0,0,0
Albrighton,223,2,16,2018-08-18T14:00:00Z,True,10,19,59,1,0,0,0,1,1,0,-1,0
Albrighton,223,2,27,2018-08-25T14:00:00Z,False,10,15,23,4,3,3,0,1,1,0,2,-1
Albrighton,223,2,36,2018-09-01T11:30:00Z,True,10,11,60,2,6,3,3,9,6,3,-3,0
Albrighton,223,2,40,2018-09-15T14:00:00Z,False,10,1,29,6,6,3,3,7,4,3,-1,-1
Albrighton,223,2,56,2018-09-22T14:00:00Z,True,10,9,13,1,6,3,3,2,1,1,4,2
Albrighton,223,2,67,2018-09-29T14:00:00Z,False,10,14,16,1,9,6,3,2,0,2,7,3
Albrighton,223,2,74,2018-10-06T14:00:00Z,True,10,7,23,1,12,6,6,9,7,2,3,4
Albrighton,223,2,80,2018-10-22T19:00:00Z,False,10,0,29,0,12,6,6,18,9,9,-6,-3
Albrighton,223,2,94,2018-10-27T16:30:00Z,True,10,18,90,2,12,6,6,7,4,3,5,3
Albrighton,223,2,102,2018-11-03T15:00:00Z,False,10,4,90,3,13,7,6,5,4,1,8,2
Albrighton,223,2,115,2018-11-10T15:00:00Z,True,10,3,59,1,16,7,9,8,4,4,8,3
Albrighton,223,2,121,2018-11-24T15:00:00Z,False,10,2,90,2,17,8,9,14,10,4,3,-1
Albrighton,223,2,135,2018-12-01T15:00:00Z,True,10,17,90,5,18,8,10,20,12,8,-2,0
Albrighton,223,2,143,2018-12-05T19:45:00Z,False,10,8,90,2,21,11,10,8,7,1,13,3
Albrighton,223,2,156,2018-12-08T19:45:00Z,True,10,16,34,0,22,11,11,33,12,21,-11,-10
Albrighton,223,2,161,2018-12-15T15:00:00Z,False,10,6,88,2,22,11,11,12,5,7,10,6
Albrighton,223,2,173,2018-12-22T15:00:00Z,False,10,5,90,3,22,11,11,37,21,16,-15,-10
Albrighton,223,2,184,2018-12-26T15:00:00Z,True,10,12,90,10,25,11,14,44,27,17,-19,-6
Albrighton,223,2,194,2018-12-29T15:00:00Z,True,10,4,57,1,28,14,14,15,13,2,13,12
Albrighton,223,2,204,2019-01-01T12:30:00Z,False,10,7,45,1,28,14,14,27,18,9,1,-4
Albrighton,223,2,216,2019-01-12T15:00:00Z,True,10,15,45,1,31,14,17,16,8,8,15,6
Albrighton,223,2,229,2019-01-19T12:30:00Z,False,10,19,0,0,31,14,17,29,14,15,2,3
Albrighton,223,2,236,2019-01-30T20:00:00Z,False,10,11,90,3,31,14,17,60,31,29,-29,-14
Albrighton,223,2,246,2019-02-03T14:05:00Z,True,10,13,0,0,32,14,18,45,25,20,-13,-6
Albrighton,223,2,257,2019-02-10T13:30:00Z,False,10,16,0,0,32,14,18,57,24,33,-25,-6
Albrighton,223,2,266,2019-02-23T17:30:00Z,True,10,6,0,0,32,14,18,27,13,14,5,0
Albrighton,223,2,274,2019-02-26T19:45:00Z,True,10,2,0,0,32,14,18,27,19,8,5,6
Albrighton,223,2,287,2019-03-03T12:00:00Z,False,10,17,0,0,35,17,18,40,20,20,-5,-2
Albrighton,223,2,295,2019-03-09T15:00:00Z,True,10,8,0,0,35,17,18,17,15,2,18,15
Albrighton,223,2,302,2019-03-16T15:00:00Z,False,10,3,0,0,38,20,18,30,17,13,8,1
Albrighton,223,2,316,2019-03-30T15:00:00Z,True,10,1,0,0,41,20,21,38,26,12,3,8
Albrighton,223,2,323,2019-04-06T14:00:00Z,False,10,9,0,0,44,23,21,14,8,6,30,13
Albrighton,223,2,334,2019-04-12T19:00:00Z,True,10,14,10,1,47,23,24,35,22,13,12,10
Albrighton,223,2,348,2019-04-20T14:00:00Z,False,10,18,63,2,47,23,24,42,27,15,5,-3
Albrighton,223,2,354,2019-04-28T11:00:00Z,True,10,0,85,3,48,23,25,66,44,22,-18,1
Albrighton,223,2,366,2019-05-06T19:00:00Z,False,10,12,84,2,51,26,25,92,51,41,-41,-26
Albrighton,223,2,374,2019-05-12T14:00:00Z,True,10,5,75,3,51,26,25,71,42,29,-20,-3
Gray,224,2,5,2018-08-10T19:00:00Z,False,10,13,90,2,0,0,0,0,0,0,0,0
Gray,224,2,16,2018-08-18T14:00:00Z,True,10,19,81,3,0,0,0,1,1,0,-1,0
Gray,224,2,27,2018-08-25T14:00:00Z,False,10,15,87,9,3,3,0,1,1,0,2,-1
Gray,224,2,36,2018-09-01T11:30:00Z,True,10,11,75,2,6,3,3,9,6,3,-3,0
Gray,224,2,40,2018-09-15T14:00:00Z,False,10,1,60,2,6,3,3,7,4,3,-1,-1
Gray,224,2,56,2018-09-22T14:00:00Z,True,10,9,45,1,6,3,3,2,1,1,4,2
Gray,224,2,67,2018-09-29T14:00:00Z,False,10,14,0,0,9,6,3,2,0,2,7,3
Gray,224,2,74,2018-10-06T14:00:00Z,True,10,7,0,0,12,6,6,9,7,2,3,4
Gray,224,2,80,2018-10-22T19:00:00Z,False,10,0,0,0,12,6,6,18,9,9,-6,-3
Gray,224,2,94,2018-10-27T16:30:00Z,True,10,18,29,4,12,6,6,7,4,3,5,3
Gray,224,2,102,2018-11-03T15:00:00Z,False,10,4,69,7,13,7,6,5,4,1,8,2
Gray,224,2,115,2018-11-10T15:00:00Z,True,10,3,83,3,16,7,9,8,4,4,8,3
Gray,224,2,121,2018-11-24T15:00:00Z,False,10,2,55,1,17,8,9,14,10,4,3,-1
Gray,224,2,135,2018-12-01T15:00:00Z,True,10,17,68,3,18,8,10,20,12,8,-2,0
Gray,224,2,143,2018-12-05T19:45:00Z,False,10,8,35,1,21,11,10,8,7,1,13,3
Gray,224,2,156,2018-12-08T19:45:00Z,True,10,16,90,1,22,11,11,33,12,21,-11,-10
Gray,224,2,161,2018-12-15T15:00:00Z,False,10,6,72,2,22,11,11,12,5,7,10,6
Gray,224,2,173,2018-12-22T15:00:00Z,False,10,5,8,1,22,11,11,37,21,16,-15,-10
Gray,224,2,184,2018-12-26T15:00:00Z,True,10,12,27,1,25,11,14,44,27,17,-19,-6
Gray,224,2,194,2018-12-29T15:00:00Z,True,10,4,78,3,28,14,14,15,13,2,13,12
Gray,224,2,204,2019-01-01T12:30:00Z,False,10,7,1,1,28,14,14,27,18,9,1,-4
Gray,224,2,216,2019-01-12T15:00:00Z,True,10,15,45,1,31,14,17,16,8,8,15,6
Gray,224,2,229,2019-01-19T12:30:00Z,False,10,19,90,7,31,14,17,29,14,15,2,3
Gray,224,2,236,2019-01-30T20:00:00Z,False,10,11,83,2,31,14,17,60,31,29,-29,-14
Gray,224,2,246,2019-02-03T14:05:00Z,True,10,13,73,2,32,14,18,45,25,20,-13,-6
Gray,224,2,257,2019-02-10T13:30:00Z,False,10,16,58,1,32,14,18,57,24,33,-25,-6
Gray,224,2,266,2019-02-23T17:30:00Z,True,10,6,45,1,32,14,18,27,13,14,5,0
Gray,224,2,274,2019-02-26T19:45:00Z,True,10,2,90,8,32,14,18,27,19,8,5,6
Gray,224,2,287,2019-03-03T12:00:00Z,False,10,17,24,1,35,17,18,40,20,20,-5,-2
Gray,224,2,295,2019-03-09T15:00:00Z,True,10,8,71,2,35,17,18,17,15,2,18,15
Gray,224,2,302,2019-03-16T15:00:00Z,False,10,3,5,1,38,20,18,30,17,13,8,1
Gray,224,2,316,2019-03-30T15:00:00Z,True,10,1,88,3,41,20,21,38,26,12,3,8
Gray,224,2,323,2019-04-06T14:00:00Z,False,10,9,90,2,44,23,21,14,8,6,30,13
Gray,224,2,334,2019-04-12T19:00:00Z,True,10,14,71,2,47,23,24,35,22,13,12,10
Gray,224,2,348,2019-04-20T14:00:00Z,False,10,18,83,2,47,23,24,42,27,15,5,-3
Gray,224,2,354,2019-04-28T11:00:00Z,True,10,0,4,1,48,23,25,66,44,22,-18,1
Gray,224,2,366,2019-05-06T19:00:00Z,False,10,12,5,1,51,26,25,92,51,41,-41,-26
Gray,224,2,374,2019-05-12T14:00:00Z,True,10,5,0,0,51,26,25,71,42,29,-20,-3
Amartey,225,2,5,2018-08-10T19:00:00Z,False,10,13,62,1,0,0,0,0,0,0,0,0
Amartey,225,2,16,2018-08-18T14:00:00Z,True,10,19,30,1,0,0,0,1,1,0,-1,0
Amartey,225,2,27,2018-08-25T14:00:00Z,False,10,15,90,2,3,3,0,1,1,0,2,-1
Amartey,225,2,36,2018-09-01T11:30:00Z,True,10,11,7,1,6,3,3,9,6,3,-3,0
Amartey,225,2,40,2018-09-15T14:00:00Z,False,10,1,0,0,6,3,3,7,4,3,-1,-1
Amartey,225,2,56,2018-09-22T14:00:00Z,True,10,9,90,2,6,3,3,2,1,1,4,2
Amartey,225,2,67,2018-09-29T14:00:00Z,False,10,14,90,3,9,6,3,2,0,2,7,3
Amartey,225,2,74,2018-10-06T14:00:00Z,True,10,7,90,1,12,6,6,9,7,2,3,4
Amartey,225,2,80,2018-10-22T19:00:00Z,False,10,0,90,2,12,6,6,18,9,9,-6,-3
Amartey,225,2,94,2018-10-27T16:30:00Z,True,10,18,90,2,12,6,6,7,4,3,5,3
Amartey,225,2,102,2018-11-03T15:00:00Z,False,10,4,0,0,13,7,6,5,4,1,8,2
Amartey,225,2,115,2018-11-10T15:00:00Z,True,10,3,0,0,16,7,9,8,4,4,8,3
Amartey,225,2,121,2018-11-24T15:00:00Z,False,10,2,0,0,17,8,9,14,10,4,3,-1
Amartey,225,2,135,2018-12-01T15:00:00Z,True,10,17,0,0,18,8,10,20,12,8,-2,0
Amartey,225,2,143,2018-12-05T19:45:00Z,False,10,8,0,0,21,11,10,8,7,1,13,3
Amartey,225,2,156,2018-12-08T19:45:00Z,True,10,16,0,0,22,11,11,33,12,21,-11,-10
Amartey,225,2,161,2018-12-15T15:00:00Z,False,10,6,0,0,22,11,11,12,5,7,10,6
Amartey,225,2,173,2018-12-22T15:00:00Z,False,10,5,0,0,22,11,11,37,21,16,-15,-10
Amartey,225,2,184,2018-12-26T15:00:00Z,True,10,12,0,0,25,11,14,44,27,17,-19,-6
Amartey,225,2,194,2018-12-29T15:00:00Z,True,10,4,0,0,28,14,14,15,13,2,13,12
Amartey,225,2,204,2019-01-01T12:30:00Z,False,10,7,0,0,28,14,14,27,18,9,1,-4
Amartey,225,2,216,2019-01-12T15:00:00Z,True,10,15,0,0,31,14,17,16,8,8,15,6
Amartey,225,2,229,2019-01-19T12:30:00Z,False,10,19,0,0,31,14,17,29,14,15,2,3
Amartey,225,2,236,2019-01-30T20:00:00Z,False,10,11,0,0,31,14,17,60,31,29,-29,-14
Amartey,225,2,246,2019-02-03T14:05:00Z,True,10,13,0,0,32,14,18,45,25,20,-13,-6
Amartey,225,2,257,2019-02-10T13:30:00Z,False,10,16,0,0,32,14,18,57,24,33,-25,-6
Amartey,225,2,266,2019-02-23T17:30:00Z,True,10,6,0,0,32,14,18,27,13,14,5,0
Amartey,225,2,274,2019-02-26T19:45:00Z,True,10,2,0,0,32,14,18,27,19,8,5,6
Amartey,225,2,287,2019-03-03T12:00:00Z,False,10,17,0,0,35,17,18,40,20,20,-5,-2
Amartey,225,2,295,2019-03-09T15:00:00Z,True,10,8,0,0,35,17,18,17,15,2,18,15
Amartey,225,2,302,2019-03-16T15:00:00Z,False,10,3,0,0,38,20,18,30,17,13,8,1
Amartey,225,2,316,2019-03-30T15:00:00Z,True,10,1,0,0,41,20,21,38,26,12,3,8
Amartey,225,2,323,2019-04-06T14:00:00Z,False,10,9,0,0,44,23,21,14,8,6,30,13
Amartey,225,2,334,2019-04-12T19:00:00Z,True,10,14,0,0,47,23,24,35,22,13,12,10
Amartey,225,2,348,2019-04-20T14:00:00Z,False,10,18,0,0,47,23,24,42,27,15,5,-3
Amartey,225,2,354,2019-04-28T11:00:00Z,True,10,0,0,0,48,23,25,66,44,22,-18,1
Amartey,225,2,366,2019-05-06T19:00:00Z,False,10,12,0,0,51,26,25,92,51,41,-41,-26
Amartey,225,2,374,2019-05-12T14:00:00Z,True,10,5,0,0,51,26,25,71,42,29,-20,-3
Ndidi,226,2,5,2018-08-10T19:00:00Z,False,10,13,90,2,0,0,0,0,0,0,0,0
Ndidi,226,2,16,2018-08-18T14:00:00Z,True,10,19,90,3,0,0,0,1,1,0,-1,0
Ndidi,226,2,27,2018-08-25T14:00:00Z,False,10,15,90,2,3,3,0,1,1,0,2,-1
Ndidi,226,2,36,2018-09-01T11:30:00Z,True,10,11,90,1,6,3,3,9,6,3,-3,0
Ndidi,226,2,40,2018-09-15T14:00:00Z,False,10,1,90,2,6,3,3,7,4,3,-1,-1
Ndidi,226,2,56,2018-09-22T14:00:00Z,True,10,9,90,1,6,3,3,2,1,1,4,2
Ndidi,226,2,67,2018-09-29T14:00:00Z,False,10,14,90,3,9,6,3,2,0,2,7,3
Ndidi,226,2,74,2018-10-06T14:00:00Z,True,10,7,90,2,12,6,6,9,7,2,3,4
Ndidi,226,2,80,2018-10-22T19:00:00Z,False,10,0,90,2,12,6,6,18,9,9,-6,-3
Ndidi,226,2,94,2018-10-27T16:30:00Z,True,10,18,90,10,12,6,6,7,4,3,5,3
Ndidi,226,2,102,2018-11-03T15:00:00Z,False,10,4,90,3,13,7,6,5,4,1,8,2
Ndidi,226,2,115,2018-11-10T15:00:00Z,True,10,3,90,3,16,7,9,8,4,4,8,3
Ndidi,226,2,121,2018-11-24T15:00:00Z,False,10,2,58,0,17,8,9,14,10,4,3,-1
Ndidi,226,2,135,2018-12-01T15:00:00Z,True,10,17,90,3,18,8,10,20,12,8,-2,0
Ndidi,226,2,143,2018-12-05T19:45:00Z,False,10,8,90,2,21,11,10,8,7,1,13,3
Ndidi,226,2,156,2018-12-08T19:45:00Z,True,10,16,90,2,22,11,11,33,12,21,-11,-10
Ndidi,226,2,161,2018-12-15T15:00:00Z,False,10,6,90,2,22,11,11,12,5,7,10,6
Ndidi,226,2,173,2018-12-22T15:00:00Z,False,10,5,90,2,22,11,11,37,21,16,-15,-10
Ndidi,226,2,184,2018-12-26T15:00:00Z,True,10,12,90,2,25,11,14,44,27,17,-19,-6
Ndidi,226,2,194,2018-12-29T15:00:00Z,True,10,4,90,2,28,14,14,15,13,2,13,12
Ndidi,226,2,204,2019-01-01T12:30:00Z,False,10,7,90,3,28,14,14,27,18,9,1,-4
Ndidi,226,2,216,2019-01-12T15:00:00Z,True,10,15,90,8,31,14,17,16,8,8,15,6
Ndidi,226,2,229,2019-01-19T12:30:00Z,False,10,19,90,1,31,14,17,29,14,15,2,3
Ndidi,226,2,236,2019-01-30T20:00:00Z,False,10,11,90,2,31,14,17,60,31,29,-29,-14
Ndidi,226,2,246,2019-02-03T14:05:00Z,True,10,13,90,1,32,14,18,45,25,20,-13,-6
Ndidi,226,2,257,2019-02-10T13:30:00Z,False,10,16,90,2,32,14,18,57,24,33,-25,-6
Ndidi,226,2,266,2019-02-23T17:30:00Z,True,10,6,90,1,32,14,18,27,13,14,5,0
Ndidi,226,2,274,2019-02-26T19:45:00Z,True,10,2,90,2,32,14,18,27,19,8,5,6
Ndidi,226,2,287,2019-03-03T12:00:00Z,False,10,17,90,2,35,17,18,40,20,20,-5,-2
Ndidi,226,2,295,2019-03-09T15:00:00Z,True,10,8,90,2,35,17,18,17,15,2,18,15
Ndidi,226,2,302,2019-03-16T15:00:00Z,False,10,3,90,2,38,20,18,30,17,13,8,1
Ndidi,226,2,316,2019-03-30T15:00:00Z,True,10,1,90,3,41,20,21,38,26,12,3,8
Ndidi,226,2,323,2019-04-06T14:00:00Z,False,10,9,86,2,44,23,21,14,8,6,30,13
Ndidi,226,2,334,2019-04-12T19:00:00Z,True,10,14,71,2,47,23,24,35,22,13,12,10
Ndidi,226,2,348,2019-04-20T14:00:00Z,False,10,18,90,2,47,23,24,42,27,15,5,-3
Ndidi,226,2,354,2019-04-28T11:00:00Z,True,10,0,45,0,48,23,25,66,44,22,-18,1
Ndidi,226,2,366,2019-05-06T19:00:00Z,False,10,12,90,2,51,26,25,92,51,41,-41,-26
Ndidi,226,2,374,2019-05-12T14:00:00Z,True,10,5,65,3,51,26,25,71,42,29,-20,-3
Iborra,227,2,5,2018-08-10T19:00:00Z,False,10,13,10,1,0,0,0,0,0,0,0,0
Iborra,227,2,16,2018-08-18T14:00:00Z,True,10,19,0,0,0,0,0,1,1,0,-1,0
Iborra,227,2,27,2018-08-25T14:00:00Z,False,10,15,0,0,3,3,0,1,1,0,2,-1
Iborra,227,2,36,2018-09-01T11:30:00Z,True,10,11,0,0,6,3,3,9,6,3,-3,0
Iborra,227,2,40,2018-09-15T14:00:00Z,False,10,1,0,0,6,3,3,7,4,3,-1,-1
Iborra,227,2,56,2018-09-22T14:00:00Z,True,10,9,0,0,6,3,3,2,1,1,4,2
Iborra,227,2,67,2018-09-29T14:00:00Z,False,10,14,5,1,9,6,3,2,0,2,7,3
Iborra,227,2,74,2018-10-06T14:00:00Z,True,10,7,0,0,12,6,6,9,7,2,3,4
Iborra,227,2,80,2018-10-22T19:00:00Z,False,10,0,0,0,12,6,6,18,9,9,-6,-3
Iborra,227,2,94,2018-10-27T16:30:00Z,True,10,18,90,2,12,6,6,7,4,3,5,3
Iborra,227,2,102,2018-11-03T15:00:00Z,False,10,4,8,1,13,7,6,5,4,1,8,2
Iborra,227,2,115,2018-11-10T15:00:00Z,True,10,3,0,0,16,7,9,8,4,4,8,3
Iborra,227,2,121,2018-11-24T15:00:00Z,False,10,2,31,1,17,8,9,14,10,4,3,-1
Iborra,227,2,135,2018-12-01T15:00:00Z,True,10,17,6,1,18,8,10,20,12,8,-2,0
Iborra,227,2,143,2018-12-05T19:45:00Z,False,10,8,19,1,21,11,10,8,7,1,13,3
Iborra,227,2,156,2018-12-08T19:45:00Z,True,10,16,55,1,22,11,11,33,12,21,-11,-10
Iborra,227,2,161,2018-12-15T15:00:00Z,False,10,6,0,0,22,11,11,12,5,7,10,6
Iborra,227,2,173,2018-12-22T15:00:00Z,False,10,5,0,0,22,11,11,37,21,16,-15,-10
Iborra,227,2,184,2018-12-26T15:00:00Z,True,10,12,0,0,25,11,14,44,27,17,-19,-6
Iborra,227,2,194,2018-12-29T15:00:00Z,True,10,4,0,0,28,14,14,15,13,2,13,12
Iborra,227,2,204,2019-01-01T12:30:00Z,False,10,7,0,0,28,14,14,27,18,9,1,-4
Iborra,227,2,216,2019-01-12T15:00:00Z,True,10,15,0,0,31,14,17,16,8,8,15,6
Iborra,227,2,229,2019-01-19T12:30:00Z,False,10,19,0,0,31,14,17,29,14,15,2,3
Iborra,227,2,236,2019-01-30T20:00:00Z,False,10,11,0,0,31,14,17,60,31,29,-29,-14
Iborra,227,2,246,2019-02-03T14:05:00Z,True,10,13,0,0,32,14,18,45,25,20,-13,-6
Iborra,227,2,257,2019-02-10T13:30:00Z,False,10,16,0,0,32,14,18,57,24,33,-25,-6
Iborra,227,2,266,2019-02-23T17:30:00Z,True,10,6,0,0,32,14,18,27,13,14,5,0
Iborra,227,2,274,2019-02-26T19:45:00Z,True,10,2,0,0,32,14,18,27,19,8,5,6
Iborra,227,2,287,2019-03-03T12:00:00Z,False,10,17,0,0,35,17,18,40,20,20,-5,-2
Iborra,227,2,295,2019-03-09T15:00:00Z,True,10,8,0,0,35,17,18,17,15,2,18,15
Iborra,227,2,302,2019-03-16T15:00:00Z,False,10,3,0,0,38,20,18,30,17,13,8,1
Iborra,227,2,316,2019-03-30T15:00:00Z,True,10,1,0,0,41,20,21,38,26,12,3,8
Iborra,227,2,323,2019-04-06T14:00:00Z,False,10,9,0,0,44,23,21,14,8,6,30,13
Iborra,227,2,334,2019-04-12T19:00:00Z,True,10,14,0,0,47,23,24,35,22,13,12,10
Iborra,227,2,348,2019-04-20T14:00:00Z,False,10,18,0,0,47,23,24,42,27,15,5,-3
Iborra,227,2,354,2019-04-28T11:00:00Z,True,10,0,0,0,48,23,25,66,44,22,-18,1
Iborra,227,2,366,2019-05-06T19:00:00Z,False,10,12,0,0,51,26,25,92,51,41,-41,-26
Iborra,227,2,374,2019-05-12T14:00:00Z,True,10,5,0,0,51,26,25,71,42,29,-20,-3
James,228,2,5,2018-08-10T19:00:00Z,False,10,13,0,0,0,0,0,0,0,0,0,0
James,228,2,16,2018-08-18T14:00:00Z,True,10,19,0,0,0,0,0,1,1,0,-1,0
James,228,2,27,2018-08-25T14:00:00Z,False,10,15,0,0,3,3,0,1,1,0,2,-1
James,228,2,36,2018-09-01T11:30:00Z,True,10,11,0,0,6,3,3,9,6,3,-3,0
James,228,2,40,2018-09-15T14:00:00Z,False,10,1,0,0,6,3,3,7,4,3,-1,-1
James,228,2,56,2018-09-22T14:00:00Z,True,10,9,0,0,6,3,3,2,1,1,4,2
James,228,2,67,2018-09-29T14:00:00Z,False,10,14,0,0,9,6,3,2,0,2,7,3
James,228,2,74,2018-10-06T14:00:00Z,True,10,7,0,0,12,6,6,9,7,2,3,4
James,228,2,80,2018-10-22T19:00:00Z,False,10,0,0,0,12,6,6,18,9,9,-6,-3
James,228,2,94,2018-10-27T16:30:00Z,True,10,18,0,0,12,6,6,7,4,3,5,3
James,228,2,102,2018-11-03T15:00:00Z,False,10,4,0,0,13,7,6,5,4,1,8,2
James,228,2,115,2018-11-10T15:00:00Z,True,10,3,0,0,16,7,9,8,4,4,8,3
James,228,2,121,2018-11-24T15:00:00Z,False,10,2,0,0,17,8,9,14,10,4,3,-1
James,228,2,135,2018-12-01T15:00:00Z,True,10,17,0,0,18,8,10,20,12,8,-2,0
James,228,2,143,2018-12-05T19:45:00Z,False,10,8,0,0,21,11,10,8,7,1,13,3
James,228,2,156,2018-12-08T19:45:00Z,True,10,16,0,0,22,11,11,33,12,21,-11,-10
James,228,2,161,2018-12-15T15:00:00Z,False,10,6,0,0,22,11,11,12,5,7,10,6
James,228,2,173,2018-12-22T15:00:00Z,False,10,5,0,0,22,11,11,37,21,16,-15,-10
James,228,2,184,2018-12-26T15:00:00Z,True,10,12,0,0,25,11,14,44,27,17,-19,-6
James,228,2,194,2018-12-29T15:00:00Z,True,10,4,0,0,28,14,14,15,13,2,13,12
James,228,2,204,2019-01-01T12:30:00Z,False,10,7,0,0,28,14,14,27,18,9,1,-4
James,228,2,216,2019-01-12T15:00:00Z,True,10,15,0,0,31,14,17,16,8,8,15,6
James,228,2,229,2019-01-19T12:30:00Z,False,10,19,0,0,31,14,17,29,14,15,2,3
James,228,2,236,2019-01-30T20:00:00Z,False,10,11,0,0,31,14,17,60,31,29,-29,-14
James,228,2,246,2019-02-03T14:05:00Z,True,10,13,0,0,32,14,18,45,25,20,-13,-6
James,228,2,257,2019-02-10T13:30:00Z,False,10,16,0,0,32,14,18,57,24,33,-25,-6
James,228,2,266,2019-02-23T17:30:00Z,True,10,6,0,0,32,14,18,27,13,14,5,0
James,228,2,274,2019-02-26T19:45:00Z,True,10,2,0,0,32,14,18,27,19,8,5,6
James,228,2,287,2019-03-03T12:00:00Z,False,10,17,0,0,35,17,18,40,20,20,-5,-2
James,228,2,295,2019-03-09T15:00:00Z,True,10,8,0,0,35,17,18,17,15,2,18,15
James,228,2,302,2019-03-16T15:00:00Z,False,10,3,0,0,38,20,18,30,17,13,8,1
James,228,2,316,2019-03-30T15:00:00Z,True,10,1,0,0,41,20,21,38,26,12,3,8
James,228,2,323,2019-04-06T14:00:00Z,False,10,9,0,0,44,23,21,14,8,6,30,13
James,228,2,334,2019-04-12T19:00:00Z,True,10,14,0,0,47,23,24,35,22,13,12,10
James,228,2,348,2019-04-20T14:00:00Z,False,10,18,0,0,47,23,24,42,27,15,5,-3
James,228,2,354,2019-04-28T11:00:00Z,True,10,0,0,0,48,23,25,66,44,22,-18,1
James,228,2,366,2019-05-06T19:00:00Z,False,10,12,0,0,51,26,25,92,51,41,-41,-26
James,228,2,374,2019-05-12T14:00:00Z,True,10,5,0,0,51,26,25,71,42,29,-20,-3
Choudhury,229,2,5,2018-08-10T19:00:00Z,False,10,13,0,0,0,0,0,0,0,0,0,0
Choudhury,229,2,16,2018-08-18T14:00:00Z,True,10,19,0,0,0,0,0,1,1,0,-1,0
Choudhury,229,2,27,2018-08-25T14:00:00Z,False,10,15,0,0,3,3,0,1,1,0,2,-1
Choudhury,229,2,36,2018-09-01T11:30:00Z,True,10,11,0,0,6,3,3,9,6,3,-3,0
Choudhury,229,2,40,2018-09-15T14:00:00Z,False,10,1,0,0,6,3,3,7,4,3,-1,-1
Choudhury,229,2,56,2018-09-22T14:00:00Z,True,10,9,0,0,6,3,3,2,1,1,4,2
Choudhury,229,2,67,2018-09-29T14:00:00Z,False,10,14,0,0,9,6,3,2,0,2,7,3
Choudhury,229,2,74,2018-10-06T14:00:00Z,True,10,7,0,0,12,6,6,9,7,2,3,4
Choudhury,229,2,80,2018-10-22T19:00:00Z,False,10,0,0,0,12,6,6,18,9,9,-6,-3
Choudhury,229,2,94,2018-10-27T16:30:00Z,True,10,18,0,0,12,6,6,7,4,3,5,3
Choudhury,229,2,102,2018-11-03T15:00:00Z,False,10,4,0,0,13,7,6,5,4,1,8,2
Choudhury,229,2,115,2018-11-10T15:00:00Z,True,10,3,0,0,16,7,9,8,4,4,8,3
Choudhury,229,2,121,2018-11-24T15:00:00Z,False,10,2,0,0,17,8,9,14,10,4,3,-1
Choudhury,229,2,135,2018-12-01T15:00:00Z,True,10,17,0,0,18,8,10,20,12,8,-2,0
Choudhury,229,2,143,2018-12-05T19:45:00Z,False,10,8,0,0,21,11,10,8,7,1,13,3
Choudhury,229,2,156,2018-12-08T19:45:00Z,True,10,16,0,0,22,11,11,33,12,21,-11,-10
Choudhury,229,2,161,2018-12-15T15:00:00Z,False,10,6,0,0,22,11,11,12,5,7,10,6
Choudhury,229,2,173,2018-12-22T15:00:00Z,False,10,5,90,3,22,11,11,37,21,16,-15,-10
Choudhury,229,2,184,2018-12-26T15:00:00Z,True,10,12,62,2,25,11,14,44,27,17,-19,-6
Choudhury,229,2,194,2018-12-29T15:00:00Z,True,10,4,0,0,28,14,14,15,13,2,13,12
Choudhury,229,2,204,2019-01-01T12:30:00Z,False,10,7,90,3,28,14,14,27,18,9,1,-4
Choudhury,229,2,216,2019-01-12T15:00:00Z,True,10,15,75,2,31,14,17,16,8,8,15,6
Choudhury,229,2,229,2019-01-19T12:30:00Z,False,10,19,0,0,31,14,17,29,14,15,2,3
Choudhury,229,2,236,2019-01-30T20:00:00Z,False,10,11,15,1,31,14,17,60,31,29,-29,-14
Choudhury,229,2,246,2019-02-03T14:05:00Z,True,10,13,0,0,32,14,18,45,25,20,-13,-6
Choudhury,229,2,257,2019-02-10T13:30:00Z,False,10,16,0,0,32,14,18,57,24,33,-25,-6
Choudhury,229,2,266,2019-02-23T17:30:00Z,True,10,6,0,0,32,14,18,27,13,14,5,0
Choudhury,229,2,274,2019-02-26T19:45:00Z,True,10,2,0,0,32,14,18,27,19,8,5,6
Choudhury,229,2,287,2019-03-03T12:00:00Z,False,10,17,0,0,35,17,18,40,20,20,-5,-2
Choudhury,229,2,295,2019-03-09T15:00:00Z,True,10,8,0,0,35,17,18,17,15,2,18,15
Choudhury,229,2,302,2019-03-16T15:00:00Z,False,10,3,0,0,38,20,18,30,17,13,8,1
Choudhury,229,2,316,2019-03-30T15:00:00Z,True,10,1,0,0,41,20,21,38,26,12,3,8
Choudhury,229,2,323,2019-04-06T14:00:00Z,False,10,9,3,1,44,23,21,14,8,6,30,13
Choudhury,229,2,334,2019-04-12T19:00:00Z,True,10,14,0,0,47,23,24,35,22,13,12,10
Choudhury,229,2,348,2019-04-20T14:00:00Z,False,10,18,0,0,47,23,24,42,27,15,5,-3
Choudhury,229,2,354,2019-04-28T11:00:00Z,True,10,0,78,3,48,23,25,66,44,22,-18,1
Choudhury,229,2,366,2019-05-06T19:00:00Z,False,10,12,90,2,51,26,25,92,51,41,-41,-26
Choudhury,229,2,374,2019-05-12T14:00:00Z,True,10,5,90,3,51,26,25,71,42,29,-20,-3
Silva,230,2,5,2018-08-10T19:00:00Z,False,10,13,79,2,0,0,0,0,0,0,0,0
Silva,230,2,16,2018-08-18T14:00:00Z,True,10,19,8,1,0,0,0,1,1,0,-1,0
Silva,230,2,27,2018-08-25T14:00:00Z,False,10,15,0,0,3,3,0,1,1,0,2,-1
Silva,230,2,36,2018-09-01T11:30:00Z,True,10,11,0,0,6,3,3,9,6,3,-3,0
Silva,230,2,40,2018-09-15T14:00:00Z,False,10,1,0,0,6,3,3,7,4,3,-1,-1
Silva,230,2,56,2018-09-22T14:00:00Z,True,10,9,0,0,6,3,3,2,1,1,4,2
Silva,230,2,67,2018-09-29T14:00:00Z,False,10,14,0,0,9,6,3,2,0,2,7,3
Silva,230,2,74,2018-10-06T14:00:00Z,True,10,7,0,0,12,6,6,9,7,2,3,4
Silva,230,2,80,2018-10-22T19:00:00Z,False,10,0,0,0,12,6,6,18,9,9,-6,-3
Silva,230,2,94,2018-10-27T16:30:00Z,True,10,18,0,0,12,6,6,7,4,3,5,3
Silva,230,2,102,2018-11-03T15:00:00Z,False,10,4,0,0,13,7,6,5,4,1,8,2
Silva,230,2,115,2018-11-10T15:00:00Z,True,10,3,0,0,16,7,9,8,4,4,8,3
Silva,230,2,121,2018-11-24T15:00:00Z,False,10,2,0,0,17,8,9,14,10,4,3,-1
Silva,230,2,135,2018-12-01T15:00:00Z,True,10,17,0,0,18,8,10,20,12,8,-2,0
Silva,230,2,143,2018-12-05T19:45:00Z,False,10,8,0,0,21,11,10,8,7,1,13,3
Silva,230,2,156,2018-12-08T19:45:00Z,True,10,16,0,0,22,11,11,33,12,21,-11,-10
Silva,230,2,161,2018-12-15T15:00:00Z,False,10,6,0,0,22,11,11,12,5,7,10,6
Silva,230,2,173,2018-12-22T15:00:00Z,False,10,5,0,0,22,11,11,37,21,16,-15,-10
Silva,230,2,184,2018-12-26T15:00:00Z,True,10,12,0,0,25,11,14,44,27,17,-19,-6
Silva,230,2,194,2018-12-29T15:00:00Z,True,10,4,0,0,28,14,14,15,13,2,13,12
Silva,230,2,204,2019-01-01T12:30:00Z,False,10,7,0,0,28,14,14,27,18,9,1,-4
Silva,230,2,216,2019-01-12T15:00:00Z,True,10,15,0,0,31,14,17,16,8,8,15,6
Silva,230,2,229,2019-01-19T12:30:00Z,False,10,19,0,0,31,14,17,29,14,15,2,3
Silva,230,2,236,2019-01-30T20:00:00Z,False,10,11,0,0,31,14,17,60,31,29,-29,-14
Silva,230,2,246,2019-02-03T14:05:00Z,True,10,13,0,0,32,14,18,45,25,20,-13,-6
Silva,230,2,257,2019-02-10T13:30:00Z,False,10,16,0,0,32,14,18,57,24,33,-25,-6
Silva,230,2,266,2019-02-23T17:30:00Z,True,10,6,0,0,32,14,18,27,13,14,5,0
Silva,230,2,274,2019-02-26T19:45:00Z,True,10,2,0,0,32,14,18,27,19,8,5,6
Silva,230,2,287,2019-03-03T12:00:00Z,False,10,17,0,0,35,17,18,40,20,20,-5,-2
Silva,230,2,295,2019-03-09T15:00:00Z,True,10,8,0,0,35,17,18,17,15,2,18,15
Silva,230,2,302,2019-03-16T15:00:00Z,False,10,3,0,0,38,20,18,30,17,13,8,1
Silva,230,2,316,2019-03-30T15:00:00Z,True,10,1,0,0,41,20,21,38,26,12,3,8
Silva,230,2,323,2019-04-06T14:00:00Z,False,10,9,0,0,44,23,21,14,8,6,30,13
Silva,230,2,334,2019-04-12T19:00:00Z,True,10,14,0,0,47,23,24,35,22,13,12,10
Silva,230,2,348,2019-04-20T14:00:00Z,False,10,18,0,0,47,23,24,42,27,15,5,-3
Silva,230,2,354,2019-04-28T11:00:00Z,True,10,0,0,0,48,23,25,66,44,22,-18,1
Silva,230,2,366,2019-05-06T19:00:00Z,False,10,12,0,0,51,26,25,92,51,41,-41,-26
Silva,230,2,374,2019-05-12T14:00:00Z,True,10,5,0,0,51,26,25,71,42,29,-20,-3
Diabate,231,2,5,2018-08-10T19:00:00Z,False,10,13,0,0,0,0,0,0,0,0,0,0
Diabate,231,2,16,2018-08-18T14:00:00Z,True,10,19,0,0,0,0,0,1,1,0,-1,0
Diabate,231,2,27,2018-08-25T14:00:00Z,False,10,15,0,0,3,3,0,1,1,0,2,-1
Diabate,231,2,36,2018-09-01T11:30:00Z,True,10,11,0,0,6,3,3,9,6,3,-3,0
Diabate,231,2,40,2018-09-15T14:00:00Z,False,10,1,0,0,6,3,3,7,4,3,-1,-1
Diabate,231,2,56,2018-09-22T14:00:00Z,True,10,9,0,0,6,3,3,2,1,1,4,2
Diabate,231,2,67,2018-09-29T14:00:00Z,False,10,14,0,0,9,6,3,2,0,2,7,3
Diabate,231,2,74,2018-10-06T14:00:00Z,True,10,7,0,0,12,6,6,9,7,2,3,4
Diabate,231,2,80,2018-10-22T19:00:00Z,False,10,0,0,0,12,6,6,18,9,9,-6,-3
Diabate,231,2,94,2018-10-27T16:30:00Z,True,10,18,0,0,12,6,6,7,4,3,5,3
Diabate,231,2,102,2018-11-03T15:00:00Z,False,10,4,0,0,13,7,6,5,4,1,8,2
Diabate,231,2,115,2018-11-10T15:00:00Z,True,10,3,0,0,16,7,9,8,4,4,8,3
Diabate,231,2,121,2018-11-24T15:00:00Z,False,10,2,0,0,17,8,9,14,10,4,3,-1
Diabate,231,2,135,2018-12-01T15:00:00Z,True,10,17,0,0,18,8,10,20,12,8,-2,0
Diabate,231,2,143,2018-12-05T19:45:00Z,False,10,8,54,1,21,11,10,8,7,1,13,3
Diabate,231,2,156,2018-12-08T19:45:00Z,True,10,16,0,0,22,11,11,33,12,21,-11,-10
Diabate,231,2,161,2018-12-15T15:00:00Z,False,10,6,0,0,22,11,11,12,5,7,10,6
Diabate,231,2,173,2018-12-22T15:00:00Z,False,10,5,0,0,22,11,11,37,21,16,-15,-10
Diabate,231,2,184,2018-12-26T15:00:00Z,True,10,12,0,0,25,11,14,44,27,17,-19,-6
Diabate,231,2,194,2018-12-29T15:00:00Z,True,10,4,0,0,28,14,14,15,13,2,13,12
Diabate,231,2,204,2019-01-01T12:30:00Z,False,10,7,0,0,28,14,14,27,18,9,1,-4
Diabate,231,2,216,2019-01-12T15:00:00Z,True,10,15,0,0,31,14,17,16,8,8,15,6
Diabate,231,2,229,2019-01-19T12:30:00Z,False,10,19,0,0,31,14,17,29,14,15,2,3
Diabate,231,2,236,2019-01-30T20:00:00Z,False,10,11,0,0,31,14,17,60,31,29,-29,-14
Diabate,231,2,246,2019-02-03T14:05:00Z,True,10,13,0,0,32,14,18,45,25,20,-13,-6
Diabate,231,2,257,2019-02-10T13:30:00Z,False,10,16,0,0,32,14,18,57,24,33,-25,-6
Diabate,231,2,266,2019-02-23T17:30:00Z,True,10,6,0,0,32,14,18,27,13,14,5,0
Diabate,231,2,274,2019-02-26T19:45:00Z,True,10,2,0,0,32,14,18,27,19,8,5,6
Diabate,231,2,287,2019-03-03T12:00:00Z,False,10,17,0,0,35,17,18,40,20,20,-5,-2
Diabate,231,2,295,2019-03-09T15:00:00Z,True,10,8,0,0,35,17,18,17,15,2,18,15
Diabate,231,2,302,2019-03-16T15:00:00Z,False,10,3,0,0,38,20,18,30,17,13,8,1
Diabate,231,2,316,2019-03-30T15:00:00Z,True,10,1,0,0,41,20,21,38,26,12,3,8
Diabate,231,2,323,2019-04-06T14:00:00Z,False,10,9,0,0,44,23,21,14,8,6,30,13
Diabate,231,2,334,2019-04-12T19:00:00Z,True,10,14,0,0,47,23,24,35,22,13,12,10
Diabate,231,2,348,2019-04-20T14:00:00Z,False,10,18,0,0,47,23,24,42,27,15,5,-3
Diabate,231,2,354,2019-04-28T11:00:00Z,True,10,0,0,0,48,23,25,66,44,22,-18,1
Diabate,231,2,366,2019-05-06T19:00:00Z,False,10,12,0,0,51,26,25,92,51,41,-41,-26
Diabate,231,2,374,2019-05-12T14:00:00Z,True,10,5,0,0,51,26,25,71,42,29,-20,-3
Maddison,232,2,5,2018-08-10T19:00:00Z,False,10,13,62,2,0,0,0,0,0,0,0,0
Maddison,232,2,16,2018-08-18T14:00:00Z,True,10,19,81,9,0,0,0,1,1,0,-1,0
Maddison,232,2,27,2018-08-25T14:00:00Z,False,10,15,77,2,3,3,0,1,1,0,2,-1
Maddison,232,2,36,2018-09-01T11:30:00Z,True,10,11,82,5,6,3,3,9,6,3,-3,0
Maddison,232,2,40,2018-09-15T14:00:00Z,False,10,1,90,8,6,3,3,7,4,3,-1,-1
Maddison,232,2,56,2018-09-22T14:00:00Z,True,10,9,84,8,6,3,3,2,1,1,4,2
Maddison,232,2,67,2018-09-29T14:00:00Z,False,10,14,84,6,9,6,3,2,0,2,7,3
Maddison,232,2,74,2018-10-06T14:00:00Z,True,10,7,79,2,12,6,6,9,7,2,3,4
Maddison,232,2,80,2018-10-22T19:00:00Z,False,10,0,74,2,12,6,6,18,9,9,-6,-3
Maddison,232,2,94,2018-10-27T16:30:00Z,True,10,18,90,2,12,6,6,7,4,3,5,3
Maddison,232,2,102,2018-11-03T15:00:00Z,False,10,4,81,3,13,7,6,5,4,1,8,2
Maddison,232,2,115,2018-11-10T15:00:00Z,True,10,3,0,0,16,7,9,8,4,4,8,3
Maddison,232,2,121,2018-11-24T15:00:00Z,False,10,2,27,-2,17,8,9,14,10,4,3,-1
Maddison,232,2,135,2018-12-01T15:00:00Z,True,10,17,90,8,18,8,10,20,12,8,-2,0
Maddison,232,2,143,2018-12-05T19:45:00Z,False,10,8,90,10,21,11,10,8,7,1,13,3
Maddison,232,2,156,2018-12-08T19:45:00Z,True,10,16,90,2,22,11,11,33,12,21,-11,-10
Maddison,232,2,161,2018-12-15T15:00:00Z,False,10,6,45,1,22,11,11,12,5,7,10,6
Maddison,232,2,173,2018-12-22T15:00:00Z,False,10,5,81,6,22,11,11,37,21,16,-15,-10
Maddison,232,2,184,2018-12-26T15:00:00Z,True,10,12,77,2,25,11,14,44,27,17,-19,-6
Maddison,232,2,194,2018-12-29T15:00:00Z,True,10,4,90,0,28,14,14,15,13,2,13,12
Maddison,232,2,204,2019-01-01T12:30:00Z,False,10,7,0,0,28,14,14,27,18,9,1,-4
Maddison,232,2,216,2019-01-12T15:00:00Z,True,10,15,90,1,31,14,17,16,8,8,15,6
Maddison,232,2,229,2019-01-19T12:30:00Z,False,10,19,17,4,31,14,17,29,14,15,2,3
Maddison,232,2,236,2019-01-30T20:00:00Z,False,10,11,74,2,31,14,17,60,31,29,-29,-14
Maddison,232,2,246,2019-02-03T14:05:00Z,True,10,13,61,2,32,14,18,45,25,20,-13,-6
Maddison,232,2,257,2019-02-10T13:30:00Z,False,10,16,90,2,32,14,18,57,24,33,-25,-6
Maddison,232,2,266,2019-02-23T17:30:00Z,True,10,6,90,2,32,14,18,27,13,14,5,0
Maddison,232,2,274,2019-02-26T19:45:00Z,True,10,2,90,6,32,14,18,27,19,8,5,6
Maddison,232,2,287,2019-03-03T12:00:00Z,False,10,17,90,2,35,17,18,40,20,20,-5,-2
Maddison,232,2,295,2019-03-09T15:00:00Z,True,10,8,80,6,35,17,18,17,15,2,18,15
Maddison,232,2,302,2019-03-16T15:00:00Z,False,10,3,63,9,38,20,18,30,17,13,8,1
Maddison,232,2,316,2019-03-30T15:00:00Z,True,10,1,90,3,41,20,21,38,26,12,3,8
Maddison,232,2,323,2019-04-06T14:00:00Z,False,10,9,90,7,44,23,21,14,8,6,30,13
Maddison,232,2,334,2019-04-12T19:00:00Z,True,10,14,90,2,47,23,24,35,22,13,12,10
Maddison,232,2,348,2019-04-20T14:00:00Z,False,10,18,90,2,47,23,24,42,27,15,5,-3
Maddison,232,2,354,2019-04-28T11:00:00Z,True,10,0,90,6,48,23,25,66,44,22,-18,1
Maddison,232,2,366,2019-05-06T19:00:00Z,False,10,12,79,2,51,26,25,92,51,41,-41,-26
Maddison,232,2,374,2019-05-12T14:00:00Z,True,10,5,83,3,51,26,25,71,42,29,-20,-3
Vardy,233,3,5,2018-08-10T19:00:00Z,False,10,13,27,6,0,0,0,0,0,0,0,0
Vardy,233,3,16,2018-08-18T14:00:00Z,True,10,19,65,-1,0,0,0,1,1,0,-1,0
Vardy,233,3,27,2018-08-25T14:00:00Z,False,10,15,0,0,3,3,0,1,1,0,2,-1
Vardy,233,3,36,2018-09-01T11:30:00Z,True,10,11,0,0,6,3,3,9,6,3,-3,0
Vardy,233,3,40,2018-09-15T14:00:00Z,False,10,1,83,2,6,3,3,7,4,3,-1,-1
Vardy,233,3,56,2018-09-22T14:00:00Z,True,10,9,90,11,6,3,3,2,1,1,4,2
Vardy,233,3,67,2018-09-29T14:00:00Z,False,10,14,73,8,9,6,3,2,0,2,7,3
Vardy,233,3,74,2018-10-06T14:00:00Z,True,10,7,90,2,12,6,6,9,7,2,3,4
Vardy,233,3,80,2018-10-22T19:00:00Z,False,10,0,90,2,12,6,6,18,9,9,-6,-3
Vardy,233,3,94,2018-10-27T16:30:00Z,True,10,18,45,1,12,6,6,7,4,3,5,3
Vardy,233,3,102,2018-11-03T15:00:00Z,False,10,4,90,2,13,7,6,5,4,1,8,2
Vardy,233,3,115,2018-11-10T15:00:00Z,True,10,3,90,2,16,7,9,8,4,4,8,3
Vardy,233,3,121,2018-11-24T15:00:00Z,False,10,2,34,8,17,8,9,14,10,4,3,-1
Vardy,233,3,135,2018-12-01T15:00:00Z,True,10,17,71,8,18,8,10,20,12,8,-2,0
Vardy,233,3,143,2018-12-05T19:45:00Z,False,10,8,0,0,21,11,10,8,7,1,13,3
Vardy,233,3,156,2018-12-08T19:45:00Z,True,10,16,0,0,22,11,11,33,12,21,-11,-10
Vardy,233,3,161,2018-12-15T15:00:00Z,False,10,6,90,2,22,11,11,12,5,7,10,6
Vardy,233,3,173,2018-12-22T15:00:00Z,False,10,5,83,9,22,11,11,37,21,16,-15,-10
Vardy,233,3,184,2018-12-26T15:00:00Z,True,10,12,87,4,25,11,14,44,27,17,-19,-6
Vardy,233,3,194,2018-12-29T15:00:00Z,True,10,4,67,2,28,14,14,15,13,2,13,12
Vardy,233,3,204,2019-01-01T12:30:00Z,False,10,7,90,8,28,14,14,27,18,9,1,-4
Vardy,233,3,216,2019-01-12T15:00:00Z,True,10,15,90,2,31,14,17,16,8,8,15,6
Vardy,233,3,229,2019-01-19T12:30:00Z,False,10,19,90,5,31,14,17,29,14,15,2,3
Vardy,233,3,236,2019-01-30T20:00:00Z,False,10,11,89,2,31,14,17,60,31,29,-29,-14
Vardy,233,3,246,2019-02-03T14:05:00Z,True,10,13,90,1,32,14,18,45,25,20,-13,-6
Vardy,233,3,257,2019-02-10T13:30:00Z,False,10,16,31,3,32,14,18,57,24,33,-25,-6
Vardy,233,3,266,2019-02-23T17:30:00Z,True,10,6,90,2,32,14,18,27,13,14,5,0
Vardy,233,3,274,2019-02-26T19:45:00Z,True,10,2,90,7,32,14,18,27,19,8,5,6
Vardy,233,3,287,2019-03-03T12:00:00Z,False,10,17,82,8,35,17,18,40,20,20,-5,-2
Vardy,233,3,295,2019-03-09T15:00:00Z,True,10,8,90,16,35,17,18,17,15,2,18,15
Vardy,233,3,302,2019-03-16T15:00:00Z,False,10,3,90,2,38,20,18,30,17,13,8,1
Vardy,233,3,316,2019-03-30T15:00:00Z,True,10,1,89,6,41,20,21,38,26,12,3,8
Vardy,233,3,323,2019-04-06T14:00:00Z,False,10,9,90,16,44,23,21,14,8,6,30,13
Vardy,233,3,334,2019-04-12T19:00:00Z,True,10,14,90,2,47,23,24,35,22,13,12,10
Vardy,233,3,348,2019-04-20T14:00:00Z,False,10,18,90,9,47,23,24,42,27,15,5,-3
Vardy,233,3,354,2019-04-28T11:00:00Z,True,10,0,90,13,48,23,25,66,44,22,-18,1
Vardy,233,3,366,2019-05-06T19:00:00Z,False,10,12,90,2,51,26,25,92,51,41,-41,-26
Vardy,233,3,374,2019-05-12T14:00:00Z,True,10,5,90,2,51,26,25,71,42,29,-20,-3
Okazaki,234,3,5,2018-08-10T19:00:00Z,False,10,13,0,0,0,0,0,0,0,0,0,0
Okazaki,234,3,16,2018-08-18T14:00:00Z,True,10,19,0,0,0,0,0,1,1,0,-1,0
Okazaki,234,3,27,2018-08-25T14:00:00Z,False,10,15,2,1,3,3,0,1,1,0,2,-1
Okazaki,234,3,36,2018-09-01T11:30:00Z,True,10,11,14,1,6,3,3,9,6,3,-3,0
Okazaki,234,3,40,2018-09-15T14:00:00Z,False,10,1,0,0,6,3,3,7,4,3,-1,-1
Okazaki,234,3,56,2018-09-22T14:00:00Z,True,10,9,5,1,6,3,3,2,1,1,4,2
Okazaki,234,3,67,2018-09-29T14:00:00Z,False,10,14,0,0,9,6,3,2,0,2,7,3
Okazaki,234,3,74,2018-10-06T14:00:00Z,True,10,7,4,1,12,6,6,9,7,2,3,4
Okazaki,234,3,80,2018-10-22T19:00:00Z,False,10,0,15,1,12,6,6,18,9,9,-6,-3
Okazaki,234,3,94,2018-10-27T16:30:00Z,True,10,18,10,1,12,6,6,7,4,3,5,3
Okazaki,234,3,102,2018-11-03T15:00:00Z,False,10,4,0,0,13,7,6,5,4,1,8,2
Okazaki,234,3,115,2018-11-10T15:00:00Z,True,10,3,6,1,16,7,9,8,4,4,8,3
Okazaki,234,3,121,2018-11-24T15:00:00Z,False,10,2,69,2,17,8,9,14,10,4,3,-1
Okazaki,234,3,135,2018-12-01T15:00:00Z,True,10,17,0,0,18,8,10,20,12,8,-2,0
Okazaki,234,3,143,2018-12-05T19:45:00Z,False,10,8,18,4,21,11,10,8,7,1,13,3
Okazaki,234,3,156,2018-12-08T19:45:00Z,True,10,16,11,1,22,11,11,33,12,21,-11,-10
Okazaki,234,3,161,2018-12-15T15:00:00Z,False,10,6,1,1,22,11,11,12,5,7,10,6
Okazaki,234,3,173,2018-12-22T15:00:00Z,False,10,5,0,0,22,11,11,37,21,16,-15,-10
Okazaki,234,3,184,2018-12-26T15:00:00Z,True,10,12,2,1,25,11,14,44,27,17,-19,-6
Okazaki,234,3,194,2018-12-29T15:00:00Z,True,10,4,11,1,28,14,14,15,13,2,13,12
Okazaki,234,3,204,2019-01-01T12:30:00Z,False,10,7,0,0,28,14,14,27,18,9,1,-4
Okazaki,234,3,216,2019-01-12T15:00:00Z,True,10,15,0,0,31,14,17,16,8,8,15,6
Okazaki,234,3,229,2019-01-19T12:30:00Z,False,10,19,0,0,31,14,17,29,14,15,2,3
Okazaki,234,3,236,2019-01-30T20:00:00Z,False,10,11,6,1,31,14,17,60,31,29,-29,-14
Okazaki,234,3,246,2019-02-03T14:05:00Z,True,10,13,16,1,32,14,18,45,25,20,-13,-6
Okazaki,234,3,257,2019-02-10T13:30:00Z,False,10,16,2,1,32,14,18,57,24,33,-25,-6
Okazaki,234,3,266,2019-02-23T17:30:00Z,True,10,6,5,1,32,14,18,27,13,14,5,0
Okazaki,234,3,274,2019-02-26T19:45:00Z,True,10,2,1,1,32,14,18,27,19,8,5,6
Okazaki,234,3,287,2019-03-03T12:00:00Z,False,10,17,0,0,35,17,18,40,20,20,-5,-2
Okazaki,234,3,295,2019-03-09T15:00:00Z,True,10,8,18,1,35,17,18,17,15,2,18,15
Okazaki,234,3,302,2019-03-16T15:00:00Z,False,10,3,0,0,38,20,18,30,17,13,8,1
Okazaki,234,3,316,2019-03-30T15:00:00Z,True,10,1,0,0,41,20,21,38,26,12,3,8
Okazaki,234,3,323,2019-04-06T14:00:00Z,False,10,9,29,1,44,23,21,14,8,6,30,13
Okazaki,234,3,334,2019-04-12T19:00:00Z,True,10,14,0,0,47,23,24,35,22,13,12,10
Okazaki,234,3,348,2019-04-20T14:00:00Z,False,10,18,0,0,47,23,24,42,27,15,5,-3
Okazaki,234,3,354,2019-04-28T11:00:00Z,True,10,0,0,0,48,23,25,66,44,22,-18,1
Okazaki,234,3,366,2019-05-06T19:00:00Z,False,10,12,0,0,51,26,25,92,51,41,-41,-26
Okazaki,234,3,374,2019-05-12T14:00:00Z,True,10,5,24,1,51,26,25,71,42,29,-20,-3
Iheanacho,235,3,5,2018-08-10T19:00:00Z,False,10,13,90,2,0,0,0,0,0,0,0,0
Iheanacho,235,3,16,2018-08-18T14:00:00Z,True,10,19,8,1,0,0,0,1,1,0,-1,0
Iheanacho,235,3,27,2018-08-25T14:00:00Z,False,10,15,66,5,3,3,0,1,1,0,2,-1
Iheanacho,235,3,36,2018-09-01T11:30:00Z,True,10,11,29,1,6,3,3,9,6,3,-3,0
Iheanacho,235,3,40,2018-09-15T14:00:00Z,False,10,1,29,4,6,3,3,7,4,3,-1,-1
Iheanacho,235,3,56,2018-09-22T14:00:00Z,True,10,9,76,12,6,3,3,2,1,1,4,2
Iheanacho,235,3,67,2018-09-29T14:00:00Z,False,10,14,90,2,9,6,3,2,0,2,7,3
Iheanacho,235,3,74,2018-10-06T14:00:00Z,True,10,7,66,5,12,6,6,9,7,2,3,4
Iheanacho,235,3,80,2018-10-22T19:00:00Z,False,10,0,60,2,12,6,6,18,9,9,-6,-3
Iheanacho,235,3,94,2018-10-27T16:30:00Z,True,10,18,60,2,12,6,6,7,4,3,5,3
Iheanacho,235,3,102,2018-11-03T15:00:00Z,False,10,4,0,0,13,7,6,5,4,1,8,2
Iheanacho,235,3,115,2018-11-10T15:00:00Z,True,10,3,30,0,16,7,9,8,4,4,8,3
Iheanacho,235,3,121,2018-11-24T15:00:00Z,False,10,2,20,4,17,8,9,14,10,4,3,-1
Iheanacho,235,3,135,2018-12-01T15:00:00Z,True,10,17,18,1,18,8,10,20,12,8,-2,0
Iheanacho,235,3,143,2018-12-05T19:45:00Z,False,10,8,90,2,21,11,10,8,7,1,13,3
Iheanacho,235,3,156,2018-12-08T19:45:00Z,True,10,16,55,1,22,11,11,33,12,21,-11,-10
Iheanacho,235,3,161,2018-12-15T15:00:00Z,False,10,6,17,1,22,11,11,12,5,7,10,6
Iheanacho,235,3,173,2018-12-22T15:00:00Z,False,10,5,6,1,22,11,11,37,21,16,-15,-10
Iheanacho,235,3,184,2018-12-26T15:00:00Z,True,10,12,0,0,25,11,14,44,27,17,-19,-6
Iheanacho,235,3,194,2018-12-29T15:00:00Z,True,10,4,22,1,28,14,14,15,13,2,13,12
Iheanacho,235,3,204,2019-01-01T12:30:00Z,False,10,7,0,0,28,14,14,27,18,9,1,-4
Iheanacho,235,3,216,2019-01-12T15:00:00Z,True,10,15,0,0,31,14,17,16,8,8,15,6
Iheanacho,235,3,229,2019-01-19T12:30:00Z,False,10,19,7,1,31,14,17,29,14,15,2,3
Iheanacho,235,3,236,2019-01-30T20:00:00Z,False,10,11,1,1,31,14,17,60,31,29,-29,-14
Iheanacho,235,3,246,2019-02-03T14:05:00Z,True,10,13,6,1,32,14,18,45,25,20,-13,-6
Iheanacho,235,3,257,2019-02-10T13:30:00Z,False,10,16,18,1,32,14,18,57,24,33,-25,-6
Iheanacho,235,3,266,2019-02-23T17:30:00Z,True,10,6,16,1,32,14,18,27,13,14,5,0
Iheanacho,235,3,274,2019-02-26T19:45:00Z,True,10,2,1,1,32,14,18,27,19,8,5,6
Iheanacho,235,3,287,2019-03-03T12:00:00Z,False,10,17,7,1,35,17,18,40,20,20,-5,-2
Iheanacho,235,3,295,2019-03-09T15:00:00Z,True,10,8,0,0,35,17,18,17,15,2,18,15
Iheanacho,235,3,302,2019-03-16T15:00:00Z,False,10,3,0,0,38,20,18,30,17,13,8,1
Iheanacho,235,3,316,2019-03-30T15:00:00Z,True,10,1,1,1,41,20,21,38,26,12,3,8
Iheanacho,235,3,323,2019-04-06T14:00:00Z,False,10,9,1,1,44,23,21,14,8,6,30,13
Iheanacho,235,3,334,2019-04-12T19:00:00Z,True,10,14,18,1,47,23,24,35,22,13,12,10
Iheanacho,235,3,348,2019-04-20T14:00:00Z,False,10,18,6,1,47,23,24,42,27,15,5,-3
Iheanacho,235,3,354,2019-04-28T11:00:00Z,True,10,0,0,0,48,23,25,66,44,22,-18,1
Iheanacho,235,3,366,2019-05-06T19:00:00Z,False,10,12,10,0,51,26,25,92,51,41,-41,-26
Iheanacho,235,3,374,2019-05-12T14:00:00Z,True,10,5,0,0,51,26,25,71,42,29,-20,-3
Mignolet,236,0,4,2018-08-12T12:30:00Z,True,11,18,0,0,0,0,0,0,0,0,0,0
Mignolet,236,0,14,2018-08-20T19:00:00Z,False,11,6,0,0,3,3,0,3,0,3,0,0
Mignolet,236,0,24,2018-08-25T16:30:00Z,True,11,2,0,0,6,3,3,3,3,0,3,3
Mignolet,236,0,36,2018-09-01T11:30:00Z,False,11,10,0,0,9,6,3,6,3,3,3,0
Mignolet,236,0,47,2018-09-15T11:30:00Z,False,11,16,0,0,12,6,6,9,3,6,3,3
Mignolet,236,0,57,2018-09-22T14:00:00Z,True,11,15,0,0,15,6,9,5,2,3,10,3
Mignolet,236,0,63,2018-09-29T16:30:00Z,False,11,5,0,0,18,9,9,16,9,7,2,0
Mignolet,236,0,75,2018-10-07T15:30:00Z,True,11,12,0,0,19,9,10,19,12,7,0,2
Mignolet,236,0,85,2018-10-20T16:30:00Z,False,11,9,0,0,20,10,10,3,1,2,17,9
Mignolet,236,0,95,2018-10-27T14:00:00Z,True,11,4,0,0,23,10,13,5,4,1,18,9
Mignolet,236,0,100,2018-11-03T17:30:00Z,False,11,0,0,0,26,13,13,22,12,10,4,1
Mignolet,236,0,116,2018-11-11T12:00:00Z,True,11,8,0,0,27,13,14,5,4,1,22,12
Mignolet,236,0,127,2018-11-24T15:00:00Z,False,11,17,0,0,30,16,14,20,12,8,10,2
Mignolet,236,0,136,2018-12-02T16:15:00Z,True,11,7,0,0,33,16,17,22,16,6,11,10
Mignolet,236,0,142,2018-12-05T19:45:00Z,False,11,3,0,0,36,19,17,9,4,5,27,13
Mignolet,236,0,151,2018-12-08T12:30:00Z,False,11,1,0,0,39,19,20,23,14,9,16,6
Mignolet,236,0,164,2018-12-16T16:00:00Z,True,11,13,0,0,42,19,23,26,15,11,16,8
Mignolet,236,0,179,2018-12-21T20:00:00Z,False,11,19,0,0,45,22,23,25,14,11,20,9
Mignolet,236,0,185,2018-12-26T15:00:00Z,True,11,14,0,0,48,22,26,17,7,10,31,12
Mignolet,236,0,195,2018-12-29T17:30:00Z,True,11,0,0,0,51,25,26,38,23,15,13,10
Mignolet,236,0,206,2019-01-03T20:00:00Z,False,11,12,0,0,54,28,26,47,27,20,7,-1
Mignolet,236,0,210,2019-01-12T15:00:00Z,False,11,2,0,0,54,28,26,26,18,8,28,8
Mignolet,236,0,224,2019-01-19T15:00:00Z,True,11,6,0,0,57,28,29,22,9,13,35,15
Mignolet,236,0,236,2019-01-30T20:00:00Z,True,11,10,0,0,60,31,29,31,14,17,29,14
Mignolet,236,0,249,2019-02-04T20:00:00Z,False,11,18,0,0,61,32,29,31,17,14,30,12
Mignolet,236,0,254,2019-02-09T15:00:00Z,True,11,1,0,0,62,32,30,33,24,9,29,23
Mignolet,236,0,267,2019-02-24T14:05:00Z,False,11,13,0,0,65,35,30,51,25,26,14,5
Mignolet,236,0,276,2019-02-27T20:00:00Z,True,11,17,0,0,66,35,31,40,20,20,26,15
Mignolet,236,0,283,2019-03-03T16:15:00Z,False,11,7,0,0,69,38,31,36,21,15,33,10
Mignolet,236,0,296,2019-03-10T12:00:00Z,True,11,3,0,0,70,38,32,30,17,13,40,25
Mignolet,236,0,304,2019-03-17T14:15:00Z,False,11,8,0,0,73,41,32,17,15,2,56,17
Mignolet,236,0,317,2019-03-31T15:30:00Z,True,11,16,0,0,76,41,35,61,28,33,15,8
Mignolet,236,0,326,2019-04-05T19:00:00Z,False,11,15,0,0,79,44,35,33,18,15,46,17
Mignolet,236,0,335,2019-04-14T15:30:00Z,True,11,5,0,0,82,44,38,66,38,28,16,16
Mignolet,236,0,342,2019-04-21T15:00:00Z,False,11,4,0,0,85,47,38,31,20,11,54,18
Mignolet,236,0,355,2019-04-26T19:00:00Z,True,11,9,0,0,88,47,41,14,8,6,74,41
Mignolet,236,0,367,2019-05-04T18:45:00Z,False,11,14,0,0,91,50,41,42,25,17,49,16
Mignolet,236,0,375,2019-05-12T14:00:00Z,True,11,19,0,0,94,50,44,57,34,23,37,27
Karius,237,0,4,2018-08-12T12:30:00Z,True,11,18,0,0,0,0,0,0,0,0,0,0
Karius,237,0,14,2018-08-20T19:00:00Z,False,11,6,0,0,3,3,0,3,0,3,0,0
Karius,237,0,24,2018-08-25T16:30:00Z,True,11,2,0,0,6,3,3,3,3,0,3,3
Karius,237,0,36,2018-09-01T11:30:00Z,False,11,10,0,0,9,6,3,6,3,3,3,0
Karius,237,0,47,2018-09-15T11:30:00Z,False,11,16,0,0,12,6,6,9,3,6,3,3
Karius,237,0,57,2018-09-22T14:00:00Z,True,11,15,0,0,15,6,9,5,2,3,10,3
Karius,237,0,63,2018-09-29T16:30:00Z,False,11,5,0,0,18,9,9,16,9,7,2,0
Karius,237,0,75,2018-10-07T15:30:00Z,True,11,12,0,0,19,9,10,19,12,7,0,2
Karius,237,0,85,2018-10-20T16:30:00Z,False,11,9,0,0,20,10,10,3,1,2,17,9
Karius,237,0,95,2018-10-27T14:00:00Z,True,11,4,0,0,23,10,13,5,4,1,18,9
Karius,237,0,100,2018-11-03T17:30:00Z,False,11,0,0,0,26,13,13,22,12,10,4,1
Karius,237,0,116,2018-11-11T12:00:00Z,True,11,8,0,0,27,13,14,5,4,1,22,12
Karius,237,0,127,2018-11-24T15:00:00Z,False,11,17,0,0,30,16,14,20,12,8,10,2
Karius,237,0,136,2018-12-02T16:15:00Z,True,11,7,0,0,33,16,17,22,16,6,11,10
Karius,237,0,142,2018-12-05T19:45:00Z,False,11,3,0,0,36,19,17,9,4,5,27,13
Karius,237,0,151,2018-12-08T12:30:00Z,False,11,1,0,0,39,19,20,23,14,9,16,6
Karius,237,0,164,2018-12-16T16:00:00Z,True,11,13,0,0,42,19,23,26,15,11,16,8
Karius,237,0,179,2018-12-21T20:00:00Z,False,11,19,0,0,45,22,23,25,14,11,20,9
Karius,237,0,185,2018-12-26T15:00:00Z,True,11,14,0,0,48,22,26,17,7,10,31,12
Karius,237,0,195,2018-12-29T17:30:00Z,True,11,0,0,0,51,25,26,38,23,15,13,10
Karius,237,0,206,2019-01-03T20:00:00Z,False,11,12,0,0,54,28,26,47,27,20,7,-1
Karius,237,0,210,2019-01-12T15:00:00Z,False,11,2,0,0,54,28,26,26,18,8,28,8
Karius,237,0,224,2019-01-19T15:00:00Z,True,11,6,0,0,57,28,29,22,9,13,35,15
Karius,237,0,236,2019-01-30T20:00:00Z,True,11,10,0,0,60,31,29,31,14,17,29,14
Karius,237,0,249,2019-02-04T20:00:00Z,False,11,18,0,0,61,32,29,31,17,14,30,12
Karius,237,0,254,2019-02-09T15:00:00Z,True,11,1,0,0,62,32,30,33,24,9,29,23
Karius,237,0,267,2019-02-24T14:05:00Z,False,11,13,0,0,65,35,30,51,25,26,14,5
Karius,237,0,276,2019-02-27T20:00:00Z,True,11,17,0,0,66,35,31,40,20,20,26,15
Karius,237,0,283,2019-03-03T16:15:00Z,False,11,7,0,0,69,38,31,36,21,15,33,10
Karius,237,0,296,2019-03-10T12:00:00Z,True,11,3,0,0,70,38,32,30,17,13,40,25
Karius,237,0,304,2019-03-17T14:15:00Z,False,11,8,0,0,73,41,32,17,15,2,56,17
Karius,237,0,317,2019-03-31T15:30:00Z,True,11,16,0,0,76,41,35,61,28,33,15,8
Karius,237,0,326,2019-04-05T19:00:00Z,False,11,15,0,0,79,44,35,33,18,15,46,17
Karius,237,0,335,2019-04-14T15:30:00Z,True,11,5,0,0,82,44,38,66,38,28,16,16
Karius,237,0,342,2019-04-21T15:00:00Z,False,11,4,0,0,85,47,38,31,20,11,54,18
Karius,237,0,355,2019-04-26T19:00:00Z,True,11,9,0,0,88,47,41,14,8,6,74,41
Karius,237,0,367,2019-05-04T18:45:00Z,False,11,14,0,0,91,50,41,42,25,17,49,16
Karius,237,0,375,2019-05-12T14:00:00Z,True,11,19,0,0,94,50,44,57,34,23,37,27
Lovren,238,1,4,2018-08-12T12:30:00Z,True,11,18,0,0,0,0,0,0,0,0,0,0
Lovren,238,1,14,2018-08-20T19:00:00Z,False,11,6,0,0,3,3,0,3,0,3,0,0
Lovren,238,1,24,2018-08-25T16:30:00Z,True,11,2,0,0,6,3,3,3,3,0,3,3
Lovren,238,1,36,2018-09-01T11:30:00Z,False,11,10,0,0,9,6,3,6,3,3,3,0
Lovren,238,1,47,2018-09-15T11:30:00Z,False,11,16,0,0,12,6,6,9,3,6,3,3
Lovren,238,1,57,2018-09-22T14:00:00Z,True,11,15,0,0,15,6,9,5,2,3,10,3
Lovren,238,1,63,2018-09-29T16:30:00Z,False,11,5,0,0,18,9,9,16,9,7,2,0
Lovren,238,1,75,2018-10-07T15:30:00Z,True,11,12,90,9,19,9,10,19,12,7,0,2
Lovren,238,1,85,2018-10-20T16:30:00Z,False,11,9,90,9,20,10,10,3,1,2,17,9
Lovren,238,1,95,2018-10-27T14:00:00Z,True,11,4,90,2,23,10,13,5,4,1,18,9
Lovren,238,1,100,2018-11-03T17:30:00Z,False,11,0,0,0,26,13,13,22,12,10,4,1
Lovren,238,1,116,2018-11-11T12:00:00Z,True,11,8,0,0,27,13,14,5,4,1,22,12
Lovren,238,1,127,2018-11-24T15:00:00Z,False,11,17,90,6,30,16,14,20,12,8,10,2
Lovren,238,1,136,2018-12-02T16:15:00Z,True,11,7,0,0,33,16,17,22,16,6,11,10
Lovren,238,1,142,2018-12-05T19:45:00Z,False,11,3,0,0,36,19,17,9,4,5,27,13
Lovren,238,1,151,2018-12-08T12:30:00Z,False,11,1,0,0,39,19,20,23,14,9,16,6
Lovren,238,1,164,2018-12-16T16:00:00Z,True,11,13,90,2,42,19,23,26,15,11,16,8
Lovren,238,1,179,2018-12-21T20:00:00Z,False,11,19,90,6,45,22,23,25,14,11,20,9
Lovren,238,1,185,2018-12-26T15:00:00Z,True,11,14,90,15,48,22,26,17,7,10,31,12
Lovren,238,1,195,2018-12-29T17:30:00Z,True,11,0,90,5,51,25,26,38,23,15,13,10
Lovren,238,1,206,2019-01-03T20:00:00Z,False,11,12,90,0,54,28,26,47,27,20,7,-1
Lovren,238,1,210,2019-01-12T15:00:00Z,False,11,2,0,0,54,28,26,26,18,8,28,8
Lovren,238,1,224,2019-01-19T15:00:00Z,True,11,6,0,0,57,28,29,22,9,13,35,15
Lovren,238,1,236,2019-01-30T20:00:00Z,True,11,10,0,0,60,31,29,31,14,17,29,14
Lovren,238,1,249,2019-02-04T20:00:00Z,False,11,18,0,0,61,32,29,31,17,14,30,12
Lovren,238,1,254,2019-02-09T15:00:00Z,True,11,1,0,0,62,32,30,33,24,9,29,23
Lovren,238,1,267,2019-02-24T14:05:00Z,False,11,13,0,0,65,35,30,51,25,26,14,5
Lovren,238,1,276,2019-02-27T20:00:00Z,True,11,17,0,0,66,35,31,40,20,20,26,15
Lovren,238,1,283,2019-03-03T16:15:00Z,False,11,7,0,0,69,38,31,36,21,15,33,10
Lovren,238,1,296,2019-03-10T12:00:00Z,True,11,3,0,0,70,38,32,30,17,13,40,25
Lovren,238,1,304,2019-03-17T14:15:00Z,False,11,8,0,0,73,41,32,17,15,2,56,17
Lovren,238,1,317,2019-03-31T15:30:00Z,True,11,16,1,1,76,41,35,61,28,33,15,8
Lovren,238,1,326,2019-04-05T19:00:00Z,False,11,15,2,1,79,44,35,33,18,15,46,17
Lovren,238,1,335,2019-04-14T15:30:00Z,True,11,5,0,0,82,44,38,66,38,28,16,16
Lovren,238,1,342,2019-04-21T15:00:00Z,False,11,4,0,0,85,47,38,31,20,11,54,18
Lovren,238,1,355,2019-04-26T19:00:00Z,True,11,9,90,6,88,47,41,14,8,6,74,41
Lovren,238,1,367,2019-05-04T18:45:00Z,False,11,14,83,1,91,50,41,42,25,17,49,16
Lovren,238,1,375,2019-05-12T14:00:00Z,True,11,19,0,0,94,50,44,57,34,23,37,27
Moreno,239,1,4,2018-08-12T12:30:00Z,True,11,18,0,0,0,0,0,0,0,0,0,0
Moreno,239,1,14,2018-08-20T19:00:00Z,False,11,6,0,0,3,3,0,3,0,3,0,0
Moreno,239,1,24,2018-08-25T16:30:00Z,True,11,2,0,0,6,3,3,3,3,0,3,3
Moreno,239,1,36,2018-09-01T11:30:00Z,False,11,10,0,0,9,6,3,6,3,3,3,0
Moreno,239,1,47,2018-09-15T11:30:00Z,False,11,16,0,0,12,6,6,9,3,6,3,3
Moreno,239,1,57,2018-09-22T14:00:00Z,True,11,15,0,0,15,6,9,5,2,3,10,3
Moreno,239,1,63,2018-09-29T16:30:00Z,False,11,5,0,0,18,9,9,16,9,7,2,0
Moreno,239,1,75,2018-10-07T15:30:00Z,True,11,12,0,0,19,9,10,19,12,7,0,2
Moreno,239,1,85,2018-10-20T16:30:00Z,False,11,9,0,0,20,10,10,3,1,2,17,9
Moreno,239,1,95,2018-10-27T14:00:00Z,True,11,4,90,2,23,10,13,5,4,1,18,9
Moreno,239,1,100,2018-11-03T17:30:00Z,False,11,0,0,0,26,13,13,22,12,10,4,1
Moreno,239,1,116,2018-11-11T12:00:00Z,True,11,8,0,0,27,13,14,5,4,1,22,12
Moreno,239,1,127,2018-11-24T15:00:00Z,False,11,17,0,0,30,16,14,20,12,8,10,2
Moreno,239,1,136,2018-12-02T16:15:00Z,True,11,7,0,0,33,16,17,22,16,6,11,10
Moreno,239,1,142,2018-12-05T19:45:00Z,False,11,3,64,2,36,19,17,9,4,5,27,13
Moreno,239,1,151,2018-12-08T12:30:00Z,False,11,1,0,0,39,19,20,23,14,9,16,6
Moreno,239,1,164,2018-12-16T16:00:00Z,True,11,13,0,0,42,19,23,26,15,11,16,8
Moreno,239,1,179,2018-12-21T20:00:00Z,False,11,19,0,0,45,22,23,25,14,11,20,9
Moreno,239,1,185,2018-12-26T15:00:00Z,True,11,14,0,0,48,22,26,17,7,10,31,12
Moreno,239,1,195,2018-12-29T17:30:00Z,True,11,0,0,0,51,25,26,38,23,15,13,10
Moreno,239,1,206,2019-01-03T20:00:00Z,False,11,12,0,0,54,28,26,47,27,20,7,-1
Moreno,239,1,210,2019-01-12T15:00:00Z,False,11,2,0,0,54,28,26,26,18,8,28,8
Moreno,239,1,224,2019-01-19T15:00:00Z,True,11,6,0,0,57,28,29,22,9,13,35,15
Moreno,239,1,236,2019-01-30T20:00:00Z,True,11,10,0,0,60,31,29,31,14,17,29,14
Moreno,239,1,249,2019-02-04T20:00:00Z,False,11,18,0,0,61,32,29,31,17,14,30,12
Moreno,239,1,254,2019-02-09T15:00:00Z,True,11,1,0,0,62,32,30,33,24,9,29,23
Moreno,239,1,267,2019-02-24T14:05:00Z,False,11,13,0,0,65,35,30,51,25,26,14,5
Moreno,239,1,276,2019-02-27T20:00:00Z,True,11,17,0,0,66,35,31,40,20,20,26,15
Moreno,239,1,283,2019-03-03T16:15:00Z,False,11,7,0,0,69,38,31,36,21,15,33,10
Moreno,239,1,296,2019-03-10T12:00:00Z,True,11,3,0,0,70,38,32,30,17,13,40,25
Moreno,239,1,304,2019-03-17T14:15:00Z,False,11,8,0,0,73,41,32,17,15,2,56,17
Moreno,239,1,317,2019-03-31T15:30:00Z,True,11,16,0,0,76,41,35,61,28,33,15,8
Moreno,239,1,326,2019-04-05T19:00:00Z,False,11,15,0,0,79,44,35,33,18,15,46,17
Moreno,239,1,335,2019-04-14T15:30:00Z,True,11,5,0,0,82,44,38,66,38,28,16,16
Moreno,239,1,342,2019-04-21T15:00:00Z,False,11,4,0,0,85,47,38,31,20,11,54,18
Moreno,239,1,355,2019-04-26T19:00:00Z,True,11,9,0,0,88,47,41,14,8,6,74,41
Moreno,239,1,367,2019-05-04T18:45:00Z,False,11,14,0,0,91,50,41,42,25,17,49,16
Moreno,239,1,375,2019-05-12T14:00:00Z,True,11,19,0,0,94,50,44,57,34,23,37,27
Clyne,240,1,4,2018-08-12T12:30:00Z,True,11,18,0,0,0,0,0,0,0,0,0,0
Clyne,240,1,14,2018-08-20T19:00:00Z,False,11,6,0,0,3,3,0,3,0,3,0,0
Clyne,240,1,24,2018-08-25T16:30:00Z,True,11,2,0,0,6,3,3,3,3,0,3,3
Clyne,240,1,36,2018-09-01T11:30:00Z,False,11,10,0,0,9,6,3,6,3,3,3,0
Clyne,240,1,47,2018-09-15T11:30:00Z,False,11,16,0,0,12,6,6,9,3,6,3,3
Clyne,240,1,57,2018-09-22T14:00:00Z,True,11,15,0,0,15,6,9,5,2,3,10,3
Clyne,240,1,63,2018-09-29T16:30:00Z,False,11,5,0,0,18,9,9,16,9,7,2,0
Clyne,240,1,75,2018-10-07T15:30:00Z,True,11,12,0,0,19,9,10,19,12,7,0,2
Clyne,240,1,85,2018-10-20T16:30:00Z,False,11,9,0,0,20,10,10,3,1,2,17,9
Clyne,240,1,95,2018-10-27T14:00:00Z,True,11,4,0,0,23,10,13,5,4,1,18,9
Clyne,240,1,100,2018-11-03T17:30:00Z,False,11,0,0,0,26,13,13,22,12,10,4,1
Clyne,240,1,116,2018-11-11T12:00:00Z,True,11,8,0,0,27,13,14,5,4,1,22,12
Clyne,240,1,127,2018-11-24T15:00:00Z,False,11,17,0,0,30,16,14,20,12,8,10,2
Clyne,240,1,136,2018-12-02T16:15:00Z,True,11,7,0,0,33,16,17,22,16,6,11,10
Clyne,240,1,142,2018-12-05T19:45:00Z,False,11,3,0,0,36,19,17,9,4,5,27,13
Clyne,240,1,151,2018-12-08T12:30:00Z,False,11,1,0,0,39,19,20,23,14,9,16,6
Clyne,240,1,164,2018-12-16T16:00:00Z,True,11,13,90,2,42,19,23,26,15,11,16,8
Clyne,240,1,179,2018-12-21T20:00:00Z,False,11,19,3,1,45,22,23,25,14,11,20,9
Clyne,240,1,185,2018-12-26T15:00:00Z,True,11,14,8,1,48,22,26,17,7,10,31,12
Clyne,240,1,195,2018-12-29T17:30:00Z,True,11,0,7,1,51,25,26,38,23,15,13,10
Clyne,240,1,206,2019-01-03T20:00:00Z,False,11,12,0,0,54,28,26,47,27,20,7,-1
Clyne,240,1,215,2019-01-13T14:15:00Z,False,1,7,90,1,27,18,9,27,18,9,0,-9
Clyne,240,1,221,2019-01-19T15:00:00Z,True,1,18,90,6,27,18,9,31,17,14,-4,4
Clyne,240,1,231,2019-01-30T19:45:00Z,True,1,5,90,6,30,21,9,47,25,22,-17,-1
Clyne,240,1,242,2019-02-02T17:30:00Z,False,1,4,90,0,33,24,9,19,14,5,14,-5
Clyne,240,1,254,2019-02-09T15:00:00Z,False,1,11,0,0,33,24,9,62,32,30,-29,-23
Clyne,240,1,261,2019-02-23T15:00:00Z,True,1,19,90,2,33,24,9,39,21,18,-6,6
Clyne,240,1,270,2019-02-27T19:45:00Z,False,1,0,90,0,34,25,9,53,35,18,-19,-26
Clyne,240,1,280,2019-03-02T15:00:00Z,True,1,12,82,2,34,25,9,68,42,26,-34,-1
Clyne,240,1,294,2019-03-09T15:00:00Z,False,1,9,46,1,34,25,9,14,8,6,20,1
Clyne,240,1,300,2019-03-16T15:00:00Z,True,1,14,90,1,37,25,12,34,22,12,3,13
Clyne,240,1,316,2019-03-30T15:00:00Z,False,1,10,90,1,38,26,12,41,20,21,-3,-8
Clyne,240,1,320,2019-04-06T14:00:00Z,True,1,3,45,-1,38,26,12,33,20,13,5,13
Clyne,240,1,330,2019-04-13T14:00:00Z,False,1,2,0,0,38,26,12,33,22,11,5,-10
Clyne,240,1,341,2019-04-20T14:00:00Z,True,1,8,0,0,41,26,15,20,18,2,21,24
Clyne,240,1,357,2019-04-27T14:00:00Z,False,1,15,71,1,41,26,15,37,21,16,4,-6
Clyne,240,1,361,2019-05-04T11:30:00Z,True,1,16,90,6,42,26,16,70,37,33,-28,-7
Clyne,240,1,372,2019-05-12T14:00:00Z,False,1,6,88,3,45,29,16,46,17,29,-1,-1
Gomez,241,1,4,2018-08-12T12:30:00Z,True,11,18,90,6,0,0,0,0,0,0,0,0
Gomez,241,1,14,2018-08-20T19:00:00Z,False,11,6,90,6,3,3,0,3,0,3,0,0
Gomez,241,1,24,2018-08-25T16:30:00Z,True,11,2,90,8,6,3,3,3,3,0,3,3
Gomez,241,1,36,2018-09-01T11:30:00Z,False,11,10,90,2,9,6,3,6,3,3,3,0
Gomez,241,1,47,2018-09-15T11:30:00Z,False,11,16,90,2,12,6,6,9,3,6,3,3
Gomez,241,1,57,2018-09-22T14:00:00Z,True,11,15,35,1,15,6,9,5,2,3,10,3
Gomez,241,1,63,2018-09-29T16:30:00Z,False,11,5,90,2,18,9,9,16,9,7,2,0
Gomez,241,1,75,2018-10-07T15:30:00Z,True,11,12,90,6,19,9,10,19,12,7,0,2
Gomez,241,1,85,2018-10-20T16:30:00Z,False,11,9,90,6,20,10,10,3,1,2,17,9
Gomez,241,1,95,2018-10-27T14:00:00Z,True,11,4,0,0,23,10,13,5,4,1,18,9
Gomez,241,1,100,2018-11-03T17:30:00Z,False,11,0,90,2,26,13,13,22,12,10,4,1
Gomez,241,1,116,2018-11-11T12:00:00Z,True,11,8,90,5,27,13,14,5,4,1,22,12
Gomez,241,1,127,2018-11-24T15:00:00Z,False,11,17,0,0,30,16,14,20,12,8,10,2
Gomez,241,1,136,2018-12-02T16:15:00Z,True,11,7,90,5,33,16,17,22,16,6,11,10
Gomez,241,1,142,2018-12-05T19:45:00Z,False,11,3,22,1,36,19,17,9,4,5,27,13
Gomez,241,1,151,2018-12-08T12:30:00Z,False,11,1,0,0,39,19,20,23,14,9,16,6
Gomez,241,1,164,2018-12-16T16:00:00Z,True,11,13,0,0,42,19,23,26,15,11,16,8
Gomez,241,1,179,2018-12-21T20:00:00Z,False,11,19,0,0,45,22,23,25,14,11,20,9
Gomez,241,1,185,2018-12-26T15:00:00Z,True,11,14,0,0,48,22,26,17,7,10,31,12
Gomez,241,1,195,2018-12-29T17:30:00Z,True,11,0,0,0,51,25,26,38,23,15,13,10
Gomez,241,1,206,2019-01-03T20:00:00Z,False,11,12,0,0,54,28,26,47,27,20,7,-1
Gomez,241,1,210,2019-01-12T15:00:00Z,False,11,2,0,0,54,28,26,26,18,8,28,8
Gomez,241,1,224,2019-01-19T15:00:00Z,True,11,6,0,0,57,28,29,22,9,13,35,15
Gomez,241,1,236,2019-01-30T20:00:00Z,True,11,10,0,0,60,31,29,31,14,17,29,14
Gomez,241,1,249,2019-02-04T20:00:00Z,False,11,18,0,0,61,32,29,31,17,14,30,12
Gomez,241,1,254,2019-02-09T15:00:00Z,True,11,1,0,0,62,32,30,33,24,9,29,23
Gomez,241,1,267,2019-02-24T14:05:00Z,False,11,13,0,0,65,35,30,51,25,26,14,5
Gomez,241,1,276,2019-02-27T20:00:00Z,True,11,17,0,0,66,35,31,40,20,20,26,15
Gomez,241,1,283,2019-03-03T16:15:00Z,False,11,7,0,0,69,38,31,36,21,15,33,10
Gomez,241,1,296,2019-03-10T12:00:00Z,True,11,3,0,0,70,38,32,30,17,13,40,25
Gomez,241,1,304,2019-03-17T14:15:00Z,False,11,8,0,0,73,41,32,17,15,2,56,17
Gomez,241,1,317,2019-03-31T15:30:00Z,True,11,16,0,0,76,41,35,61,28,33,15,8
Gomez,241,1,326,2019-04-05T19:00:00Z,False,11,15,0,0,79,44,35,33,18,15,46,17
Gomez,241,1,335,2019-04-14T15:30:00Z,True,11,5,0,0,82,44,38,66,38,28,16,16
Gomez,241,1,342,2019-04-21T15:00:00Z,False,11,4,4,1,85,47,38,31,20,11,54,18
Gomez,241,1,355,2019-04-26T19:00:00Z,True,11,9,2,1,88,47,41,14,8,6,74,41
Gomez,241,1,367,2019-05-04T18:45:00Z,False,11,14,0,0,91,50,41,42,25,17,49,16
Gomez,241,1,375,2019-05-12T14:00:00Z,True,11,19,6,1,94,50,44,57,34,23,37,27
Matip,242,1,4,2018-08-12T12:30:00Z,True,11,18,0,0,0,0,0,0,0,0,0,0
Matip,242,1,14,2018-08-20T19:00:00Z,False,11,6,0,0,3,3,0,3,0,3,0,0
Matip,242,1,24,2018-08-25T16:30:00Z,True,11,2,1,1,6,3,3,3,3,0,3,3
Matip,242,1,36,2018-09-01T11:30:00Z,False,11,10,1,1,9,6,3,6,3,3,3,0
Matip,242,1,47,2018-09-15T11:30:00Z,False,11,16,1,1,12,6,6,9,3,6,3,3
Matip,242,1,57,2018-09-22T14:00:00Z,True,11,15,90,15,15,6,9,5,2,3,10,3
Matip,242,1,63,2018-09-29T16:30:00Z,False,11,5,0,0,18,9,9,16,9,7,2,0
Matip,242,1,75,2018-10-07T15:30:00Z,True,11,12,0,0,19,9,10,19,12,7,0,2
Matip,242,1,85,2018-10-20T16:30:00Z,False,11,9,0,0,20,10,10,3,1,2,17,9
Matip,242,1,95,2018-10-27T14:00:00Z,True,11,4,0,0,23,10,13,5,4,1,18,9
Matip,242,1,100,2018-11-03T17:30:00Z,False,11,0,1,1,26,13,13,22,12,10,4,1
Matip,242,1,116,2018-11-11T12:00:00Z,True,11,8,0,0,27,13,14,5,4,1,22,12
Matip,242,1,127,2018-11-24T15:00:00Z,False,11,17,1,1,30,16,14,20,12,8,10,2
Matip,242,1,136,2018-12-02T16:15:00Z,True,11,7,0,0,33,16,17,22,16,6,11,10
Matip,242,1,142,2018-12-05T19:45:00Z,False,11,3,90,2,36,19,17,9,4,5,27,13
Matip,242,1,151,2018-12-08T12:30:00Z,False,11,1,90,6,39,19,20,23,14,9,16,6
Matip,242,1,164,2018-12-16T16:00:00Z,True,11,13,0,0,42,19,23,26,15,11,16,8
Matip,242,1,179,2018-12-21T20:00:00Z,False,11,19,0,0,45,22,23,25,14,11,20,9
Matip,242,1,185,2018-12-26T15:00:00Z,True,11,14,0,0,48,22,26,17,7,10,31,12
Matip,242,1,195,2018-12-29T17:30:00Z,True,11,0,0,0,51,25,26,38,23,15,13,10
Matip,242,1,206,2019-01-03T20:00:00Z,False,11,12,0,0,54,28,26,47,27,20,7,-1
Matip,242,1,210,2019-01-12T15:00:00Z,False,11,2,0,0,54,28,26,26,18,8,28,8
Matip,242,1,224,2019-01-19T15:00:00Z,True,11,6,90,1,57,28,29,22,9,13,35,15
Matip,242,1,236,2019-01-30T20:00:00Z,True,11,10,90,1,60,31,29,31,14,17,29,14
Matip,242,1,249,2019-02-04T20:00:00Z,False,11,18,90,1,61,32,29,31,17,14,30,12
Matip,242,1,254,2019-02-09T15:00:00Z,True,11,1,90,7,62,32,30,33,24,9,29,23
Matip,242,1,267,2019-02-24T14:05:00Z,False,11,13,90,6,65,35,30,51,25,26,14,5
Matip,242,1,276,2019-02-27T20:00:00Z,True,11,17,90,6,66,35,31,40,20,20,26,15
Matip,242,1,283,2019-03-03T16:15:00Z,False,11,7,90,7,69,38,31,36,21,15,33,10
Matip,242,1,296,2019-03-10T12:00:00Z,True,11,3,90,1,70,38,32,30,17,13,40,25
Matip,242,1,304,2019-03-17T14:15:00Z,False,11,8,90,2,73,41,32,17,15,2,56,17
Matip,242,1,317,2019-03-31T15:30:00Z,True,11,16,90,2,76,41,35,61,28,33,15,8
Matip,242,1,326,2019-04-05T19:00:00Z,False,11,15,90,2,79,44,35,33,18,15,46,17
Matip,242,1,335,2019-04-14T15:30:00Z,True,11,5,90,6,82,44,38,66,38,28,16,16
Matip,242,1,342,2019-04-21T15:00:00Z,False,11,4,90,6,85,47,38,31,20,11,54,18
Matip,242,1,355,2019-04-26T19:00:00Z,True,11,9,0,0,88,47,41,14,8,6,74,41
Matip,242,1,367,2019-05-04T18:45:00Z,False,11,14,0,0,91,50,41,42,25,17,49,16
Matip,242,1,375,2019-05-12T14:00:00Z,True,11,19,90,7,94,50,44,57,34,23,37,27
Klavan,243,1,4,2018-08-12T12:30:00Z,True,11,18,0,0,0,0,0,0,0,0,0,0
Klavan,243,1,14,2018-08-20T19:00:00Z,False,11,6,0,0,3,3,0,3,0,3,0,0
Klavan,243,1,24,2018-08-25T16:30:00Z,True,11,2,0,0,6,3,3,3,3,0,3,3
Klavan,243,1,36,2018-09-01T11:30:00Z,False,11,10,0,0,9,6,3,6,3,3,3,0
Klavan,243,1,47,2018-09-15T11:30:00Z,False,11,16,0,0,12,6,6,9,3,6,3,3
Klavan,243,1,57,2018-09-22T14:00:00Z,True,11,15,0,0,15,6,9,5,2,3,10,3
Klavan,243,1,63,2018-09-29T16:30:00Z,False,11,5,0,0,18,9,9,16,9,7,2,0
Klavan,243,1,75,2018-10-07T15:30:00Z,True,11,12,0,0,19,9,10,19,12,7,0,2
Klavan,243,1,85,2018-10-20T16:30:00Z,False,11,9,0,0,20,10,10,3,1,2,17,9
Klavan,243,1,95,2018-10-27T14:00:00Z,True,11,4,0,0,23,10,13,5,4,1,18,9
Klavan,243,1,100,2018-11-03T17:30:00Z,False,11,0,0,0,26,13,13,22,12,10,4,1
Klavan,243,1,116,2018-11-11T12:00:00Z,True,11,8,0,0,27,13,14,5,4,1,22,12
Klavan,243,1,127,2018-11-24T15:00:00Z,False,11,17,0,0,30,16,14,20,12,8,10,2
Klavan,243,1,136,2018-12-02T16:15:00Z,True,11,7,0,0,33,16,17,22,16,6,11,10
Klavan,243,1,142,2018-12-05T19:45:00Z,False,11,3,0,0,36,19,17,9,4,5,27,13
Klavan,243,1,151,2018-12-08T12:30:00Z,False,11,1,0,0,39,19,20,23,14,9,16,6
Klavan,243,1,164,2018-12-16T16:00:00Z,True,11,13,0,0,42,19,23,26,15,11,16,8
Klavan,243,1,179,2018-12-21T20:00:00Z,False,11,19,0,0,45,22,23,25,14,11,20,9
Klavan,243,1,185,2018-12-26T15:00:00Z,True,11,14,0,0,48,22,26,17,7,10,31,12
Klavan,243,1,195,2018-12-29T17:30:00Z,True,11,0,0,0,51,25,26,38,23,15,13,10
Klavan,243,1,206,2019-01-03T20:00:00Z,False,11,12,0,0,54,28,26,47,27,20,7,-1
Klavan,243,1,210,2019-01-12T15:00:00Z,False,11,2,0,0,54,28,26,26,18,8,28,8
Klavan,243,1,224,2019-01-19T15:00:00Z,True,11,6,0,0,57,28,29,22,9,13,35,15
Klavan,243,1,236,2019-01-30T20:00:00Z,True,11,10,0,0,60,31,29,31,14,17,29,14
Klavan,243,1,249,2019-02-04T20:00:00Z,False,11,18,0,0,61,32,29,31,17,14,30,12
Klavan,243,1,254,2019-02-09T15:00:00Z,True,11,1,0,0,62,32,30,33,24,9,29,23
Klavan,243,1,267,2019-02-24T14:05:00Z,False,11,13,0,0,65,35,30,51,25,26,14,5
Klavan,243,1,276,2019-02-27T20:00:00Z,True,11,17,0,0,66,35,31,40,20,20,26,15
Klavan,243,1,283,2019-03-03T16:15:00Z,False,11,7,0,0,69,38,31,36,21,15,33,10
Klavan,243,1,296,2019-03-10T12:00:00Z,True,11,3,0,0,70,38,32,30,17,13,40,25
Klavan,243,1,304,2019-03-17T14:15:00Z,False,11,8,0,0,73,41,32,17,15,2,56,17
Klavan,243,1,317,2019-03-31T15:30:00Z,True,11,16,0,0,76,41,35,61,28,33,15,8
Klavan,243,1,326,2019-04-05T19:00:00Z,False,11,15,0,0,79,44,35,33,18,15,46,17
Klavan,243,1,335,2019-04-14T15:30:00Z,True,11,5,0,0,82,44,38,66,38,28,16,16
Klavan,243,1,342,2019-04-21T15:00:00Z,False,11,4,0,0,85,47,38,31,20,11,54,18
Klavan,243,1,355,2019-04-26T19:00:00Z,True,11,9,0,0,88,47,41,14,8,6,74,41
Klavan,243,1,367,2019-05-04T18:45:00Z,False,11,14,0,0,91,50,41,42,25,17,49,16
Klavan,243,1,375,2019-05-12T14:00:00Z,True,11,19,0,0,94,50,44,57,34,23,37,27
Alexander-Arnold,244,1,4,2018-08-12T12:30:00Z,True,11,18,90,5,0,0,0,0,0,0,0,0
Alexander-Arnold,244,1,14,2018-08-20T19:00:00Z,False,11,6,90,5,3,3,0,3,0,3,0,0
Alexander-Arnold,244,1,24,2018-08-25T16:30:00Z,True,11,2,88,5,6,3,3,3,3,0,3,3
Alexander-Arnold,244,1,36,2018-09-01T11:30:00Z,False,11,10,88,2,9,6,3,6,3,3,3,0
Alexander-Arnold,244,1,47,2018-09-15T11:30:00Z,False,11,16,89,6,12,6,6,9,3,6,3,3
Alexander-Arnold,244,1,57,2018-09-22T14:00:00Z,True,11,15,90,11,15,6,9,5,2,3,10,3
Alexander-Arnold,244,1,63,2018-09-29T16:30:00Z,False,11,5,90,2,18,9,9,16,9,7,2,0
Alexander-Arnold,244,1,75,2018-10-07T15:30:00Z,True,11,12,0,0,19,9,10,19,12,7,0,2
Alexander-Arnold,244,1,85,2018-10-20T16:30:00Z,False,11,9,0,0,20,10,10,3,1,2,17,9
Alexander-Arnold,244,1,95,2018-10-27T14:00:00Z,True,11,4,90,2,23,10,13,5,4,1,18,9
Alexander-Arnold,244,1,100,2018-11-03T17:30:00Z,False,11,0,90,2,26,13,13,22,12,10,4,1
Alexander-Arnold,244,1,116,2018-11-11T12:00:00Z,True,11,8,90,11,27,13,14,5,4,1,22,12
Alexander-Arnold,244,1,127,2018-11-24T15:00:00Z,False,11,17,90,14,30,16,14,20,12,8,10,2
Alexander-Arnold,244,1,136,2018-12-02T16:15:00Z,True,11,7,90,6,33,16,17,22,16,6,11,10
Alexander-Arnold,244,1,142,2018-12-05T19:45:00Z,False,11,3,67,2,36,19,17,9,4,5,27,13
Alexander-Arnold,244,1,151,2018-12-08T12:30:00Z,False,11,1,0,0,39,19,20,23,14,9,16,6
Alexander-Arnold,244,1,164,2018-12-16T16:00:00Z,True,11,13,0,0,42,19,23,26,15,11,16,8
Alexander-Arnold,244,1,179,2018-12-21T20:00:00Z,False,11,19,0,0,45,22,23,25,14,11,20,9
Alexander-Arnold,244,1,185,2018-12-26T15:00:00Z,True,11,14,90,11,48,22,26,17,7,10,31,12
Alexander-Arnold,244,1,195,2018-12-29T17:30:00Z,True,11,0,90,2,51,25,26,38,23,15,13,10
Alexander-Arnold,244,1,206,2019-01-03T20:00:00Z,False,11,12,90,1,54,28,26,47,27,20,7,-1
Alexander-Arnold,244,1,210,2019-01-12T15:00:00Z,False,11,2,90,6,54,28,26,26,18,8,28,8
Alexander-Arnold,244,1,224,2019-01-19T15:00:00Z,True,11,6,0,0,57,28,29,22,9,13,35,15
Alexander-Arnold,244,1,236,2019-01-30T20:00:00Z,True,11,10,0,0,60,31,29,31,14,17,29,14
Alexander-Arnold,244,1,249,2019-02-04T20:00:00Z,False,11,18,0,0,61,32,29,31,17,14,30,12
Alexander-Arnold,244,1,254,2019-02-09T15:00:00Z,True,11,1,13,1,62,32,30,33,24,9,29,23
Alexander-Arnold,244,1,267,2019-02-24T14:05:00Z,False,11,13,0,0,65,35,30,51,25,26,14,5
Alexander-Arnold,244,1,276,2019-02-27T20:00:00Z,True,11,17,90,18,66,35,31,40,20,20,26,15
Alexander-Arnold,244,1,283,2019-03-03T16:15:00Z,False,11,7,90,9,69,38,31,36,21,15,33,10
Alexander-Arnold,244,1,296,2019-03-10T12:00:00Z,True,11,3,85,2,70,38,32,30,17,13,40,25
Alexander-Arnold,244,1,304,2019-03-17T14:15:00Z,False,11,8,90,2,73,41,32,17,15,2,56,17
Alexander-Arnold,244,1,317,2019-03-31T15:30:00Z,True,11,16,90,2,76,41,35,61,28,33,15,8
Alexander-Arnold,244,1,326,2019-04-05T19:00:00Z,False,11,15,58,4,79,44,35,33,18,15,46,17
Alexander-Arnold,244,1,335,2019-04-14T15:30:00Z,True,11,5,90,8,82,44,38,66,38,28,16,16
Alexander-Arnold,244,1,342,2019-04-21T15:00:00Z,False,11,4,85,11,85,47,38,31,20,11,54,18
Alexander-Arnold,244,1,355,2019-04-26T19:00:00Z,True,11,9,87,10,88,47,41,14,8,6,74,41
Alexander-Arnold,244,1,367,2019-05-04T18:45:00Z,False,11,14,90,10,91,50,41,42,25,17,49,16
Alexander-Arnold,244,1,375,2019-05-12T14:00:00Z,True,11,19,90,15,94,50,44,57,34,23,37,27
van Dijk,245,1,4,2018-08-12T12:30:00Z,True,11,18,90,6,0,0,0,0,0,0,0,0
van Dijk,245,1,14,2018-08-20T19:00:00Z,False,11,6,90,6,3,3,0,3,0,3,0,0
van Dijk,245,1,24,2018-08-25T16:30:00Z,True,11,2,90,8,6,3,3,3,3,0,3,3
van Dijk,245,1,36,2018-09-01T11:30:00Z,False,11,10,90,1,9,6,3,6,3,3,3,0
van Dijk,245,1,47,2018-09-15T11:30:00Z,False,11,16,90,2,12,6,6,9,3,6,3,3
van Dijk,245,1,57,2018-09-22T14:00:00Z,True,11,15,54,1,15,6,9,5,2,3,10,3
van Dijk,245,1,63,2018-09-29T16:30:00Z,False,11,5,90,2,18,9,9,16,9,7,2,0
van Dijk,245,1,75,2018-10-07T15:30:00Z,True,11,12,90,6,19,9,10,19,12,7,0,2
van Dijk,245,1,85,2018-10-20T16:30:00Z,False,11,9,90,8,20,10,10,3,1,2,17,9
van Dijk,245,1,95,2018-10-27T14:00:00Z,True,11,4,90,2,23,10,13,5,4,1,18,9
van Dijk,245,1,100,2018-11-03T17:30:00Z,False,11,0,90,2,26,13,13,22,12,10,4,1
van Dijk,245,1,116,2018-11-11T12:00:00Z,True,11,8,90,7,27,13,14,5,4,1,22,12
van Dijk,245,1,127,2018-11-24T15:00:00Z,False,11,17,90,6,30,16,14,20,12,8,10,2
van Dijk,245,1,136,2018-12-02T16:15:00Z,True,11,7,90,12,33,16,17,22,16,6,11,10
van Dijk,245,1,142,2018-12-05T19:45:00Z,False,11,3,90,5,36,19,17,9,4,5,27,13
van Dijk,245,1,151,2018-12-08T12:30:00Z,False,11,1,90,6,39,19,20,23,14,9,16,6
van Dijk,245,1,164,2018-12-16T16:00:00Z,True,11,13,90,2,42,19,23,26,15,11,16,8
van Dijk,245,1,179,2018-12-21T20:00:00Z,False,11,19,90,15,45,22,23,25,14,11,20,9
van Dijk,245,1,185,2018-12-26T15:00:00Z,True,11,14,90,6,48,22,26,17,7,10,31,12
van Dijk,245,1,195,2018-12-29T17:30:00Z,True,11,0,90,2,51,25,26,38,23,15,13,10
van Dijk,245,1,206,2019-01-03T20:00:00Z,False,11,12,90,1,54,28,26,47,27,20,7,-1
van Dijk,245,1,210,2019-01-12T15:00:00Z,False,11,2,90,7,54,28,26,26,18,8,28,8
van Dijk,245,1,224,2019-01-19T15:00:00Z,True,11,6,90,4,57,28,29,22,9,13,35,15
van Dijk,245,1,236,2019-01-30T20:00:00Z,True,11,10,90,2,60,31,29,31,14,17,29,14
van Dijk,245,1,249,2019-02-04T20:00:00Z,False,11,18,90,2,61,32,29,31,17,14,30,12
van Dijk,245,1,254,2019-02-09T15:00:00Z,True,11,1,90,6,62,32,30,33,24,9,29,23
van Dijk,245,1,267,2019-02-24T14:05:00Z,False,11,13,90,7,65,35,30,51,25,26,14,5
van Dijk,245,1,276,2019-02-27T20:00:00Z,True,11,17,90,20,66,35,31,40,20,20,26,15
van Dijk,245,1,283,2019-03-03T16:15:00Z,False,11,7,90,8,69,38,31,36,21,15,33,10
van Dijk,245,1,296,2019-03-10T12:00:00Z,True,11,3,90,1,70,38,32,30,17,13,40,25
van Dijk,245,1,304,2019-03-17T14:15:00Z,False,11,8,90,2,73,41,32,17,15,2,56,17
van Dijk,245,1,317,2019-03-31T15:30:00Z,True,11,16,90,2,76,41,35,61,28,33,15,8
van Dijk,245,1,326,2019-04-05T19:00:00Z,False,11,15,90,2,79,44,35,33,18,15,46,17
van Dijk,245,1,335,2019-04-14T15:30:00Z,True,11,5,90,12,82,44,38,66,38,28,16,16
van Dijk,245,1,342,2019-04-21T15:00:00Z,False,11,4,90,7,85,47,38,31,20,11,54,18
van Dijk,245,1,355,2019-04-26T19:00:00Z,True,11,9,90,6,88,47,41,14,8,6,74,41
van Dijk,245,1,367,2019-05-04T18:45:00Z,False,11,14,90,8,91,50,41,42,25,17,49,16
van Dijk,245,1,375,2019-05-12T14:00:00Z,True,11,19,90,6,94,50,44,57,34,23,37,27
Robertson,246,1,4,2018-08-12T12:30:00Z,True,11,18,90,11,0,0,0,0,0,0,0,0
Robertson,246,1,14,2018-08-20T19:00:00Z,False,11,6,90,7,3,3,0,3,0,3,0,0
Robertson,246,1,24,2018-08-25T16:30:00Z,True,11,2,90,9,6,3,3,3,3,0,3,3
Robertson,246,1,36,2018-09-01T11:30:00Z,False,11,10,90,5,9,6,3,6,3,3,3,0
Robertson,246,1,47,2018-09-15T11:30:00Z,False,11,16,90,2,12,6,6,9,3,6,3,3
Robertson,246,1,57,2018-09-22T14:00:00Z,True,11,15,90,7,15,6,9,5,2,3,10,3
Robertson,246,1,63,2018-09-29T16:30:00Z,False,11,5,90,2,18,9,9,16,9,7,2,0
Robertson,246,1,75,2018-10-07T15:30:00Z,True,11,12,90,6,19,9,10,19,12,7,0,2
Robertson,246,1,85,2018-10-20T16:30:00Z,False,11,9,90,8,20,10,10,3,1,2,17,9
Robertson,246,1,95,2018-10-27T14:00:00Z,True,11,4,0,0,23,10,13,5,4,1,18,9
Robertson,246,1,100,2018-11-03T17:30:00Z,False,11,0,90,2,26,13,13,22,12,10,4,1
Robertson,246,1,116,2018-11-11T12:00:00Z,True,11,8,90,12,27,13,14,5,4,1,22,12
Robertson,246,1,127,2018-11-24T15:00:00Z,False,11,17,90,7,30,16,14,20,12,8,10,2
Robertson,246,1,136,2018-12-02T16:15:00Z,True,11,7,90,6,33,16,17,22,16,6,11,10
Robertson,246,1,142,2018-12-05T19:45:00Z,False,11,3,0,0,36,19,17,9,4,5,27,13
Robertson,246,1,151,2018-12-08T12:30:00Z,False,11,1,90,11,39,19,20,23,14,9,16,6
Robertson,246,1,164,2018-12-16T16:00:00Z,True,11,13,90,2,42,19,23,26,15,11,16,8
Robertson,246,1,179,2018-12-21T20:00:00Z,False,11,19,90,6,45,22,23,25,14,11,20,9
Robertson,246,1,185,2018-12-26T15:00:00Z,True,11,14,81,6,48,22,26,17,7,10,31,12
Robertson,246,1,195,2018-12-29T17:30:00Z,True,11,0,82,1,51,25,26,38,23,15,13,10
Robertson,246,1,206,2019-01-03T20:00:00Z,False,11,12,90,5,54,28,26,47,27,20,7,-1
Robertson,246,1,210,2019-01-12T15:00:00Z,False,11,2,90,9,54,28,26,26,18,8,28,8
Robertson,246,1,224,2019-01-19T15:00:00Z,True,11,6,90,5,57,28,29,22,9,13,35,15
Robertson,246,1,236,2019-01-30T20:00:00Z,True,11,10,90,2,60,31,29,31,14,17,29,14
Robertson,246,1,249,2019-02-04T20:00:00Z,False,11,18,90,2,61,32,29,31,17,14,30,12
Robertson,246,1,254,2019-02-09T15:00:00Z,True,11,1,90,9,62,32,30,33,24,9,29,23
Robertson,246,1,267,2019-02-24T14:05:00Z,False,11,13,90,8,65,35,30,51,25,26,14,5
Robertson,246,1,276,2019-02-27T20:00:00Z,True,11,17,90,13,66,35,31,40,20,20,26,15
Robertson,246,1,283,2019-03-03T16:15:00Z,False,11,7,90,5,69,38,31,36,21,15,33,10
Robertson,246,1,296,2019-03-10T12:00:00Z,True,11,3,90,1,70,38,32,30,17,13,40,25
Robertson,246,1,304,2019-03-17T14:15:00Z,False,11,8,90,2,73,41,32,17,15,2,56,17
Robertson,246,1,317,2019-03-31T15:30:00Z,True,11,16,90,8,76,41,35,61,28,33,15,8
Robertson,246,1,326,2019-04-05T19:00:00Z,False,11,15,90,1,79,44,35,33,18,15,46,17
Robertson,246,1,335,2019-04-14T15:30:00Z,True,11,5,90,6,82,44,38,66,38,28,16,16
Robertson,246,1,342,2019-04-21T15:00:00Z,False,11,4,90,6,85,47,38,31,20,11,54,18
Robertson,246,1,355,2019-04-26T19:00:00Z,True,11,9,90,14,88,47,41,14,8,6,74,41
Robertson,246,1,367,2019-05-04T18:45:00Z,False,11,14,90,1,91,50,41,42,25,17,49,16
Robertson,246,1,375,2019-05-12T14:00:00Z,True,11,19,83,6,94,50,44,57,34,23,37,27
Chamberlain,247,2,4,2018-08-12T12:30:00Z,True,11,18,0,0,0,0,0,0,0,0,0,0
Chamberlain,247,2,14,2018-08-20T19:00:00Z,False,11,6,0,0,3,3,0,3,0,3,0,0
Chamberlain,247,2,24,2018-08-25T16:30:00Z,True,11,2,0,0,6,3,3,3,3,0,3,3
Chamberlain,247,2,36,2018-09-01T11:30:00Z,False,11,10,0,0,9,6,3,6,3,3,3,0
Chamberlain,247,2,47,2018-09-15T11:30:00Z,False,11,16,0,0,12,6,6,9,3,6,3,3
Chamberlain,247,2,57,2018-09-22T14:00:00Z,True,11,15,0,0,15,6,9,5,2,3,10,3
Chamberlain,247,2,63,2018-09-29T16:30:00Z,False,11,5,0,0,18,9,9,16,9,7,2,0
Chamberlain,247,2,75,2018-10-07T15:30:00Z,True,11,12,0,0,19,9,10,19,12,7,0,2
Chamberlain,247,2,85,2018-10-20T16:30:00Z,False,11,9,0,0,20,10,10,3,1,2,17,9
Chamberlain,247,2,95,2018-10-27T14:00:00Z,True,11,4,0,0,23,10,13,5,4,1,18,9
Chamberlain,247,2,100,2018-11-03T17:30:00Z,False,11,0,0,0,26,13,13,22,12,10,4,1
Chamberlain,247,2,116,2018-11-11T12:00:00Z,True,11,8,0,0,27,13,14,5,4,1,22,12
Chamberlain,247,2,127,2018-11-24T15:00:00Z,False,11,17,0,0,30,16,14,20,12,8,10,2
Chamberlain,247,2,136,2018-12-02T16:15:00Z,True,11,7,0,0,33,16,17,22,16,6,11,10
Chamberlain,247,2,142,2018-12-05T19:45:00Z,False,11,3,0,0,36,19,17,9,4,5,27,13
Chamberlain,247,2,151,2018-12-08T12:30:00Z,False,11,1,0,0,39,19,20,23,14,9,16,6
Chamberlain,247,2,164,2018-12-16T16:00:00Z,True,11,13,0,0,42,19,23,26,15,11,16,8
Chamberlain,247,2,179,2018-12-21T20:00:00Z,False,11,19,0,0,45,22,23,25,14,11,20,9
Chamberlain,247,2,185,2018-12-26T15:00:00Z,True,11,14,0,0,48,22,26,17,7,10,31,12
Chamberlain,247,2,195,2018-12-29T17:30:00Z,True,11,0,0,0,51,25,26,38,23,15,13,10
Chamberlain,247,2,206,2019-01-03T20:00:00Z,False,11,12,0,0,54,28,26,47,27,20,7,-1
Chamberlain,247,2,210,2019-01-12T15:00:00Z,False,11,2,0,0,54,28,26,26,18,8,28,8
Chamberlain,247,2,224,2019-01-19T15:00:00Z,True,11,6,0,0,57,28,29,22,9,13,35,15
Chamberlain,247,2,236,2019-01-30T20:00:00Z,True,11,10,0,0,60,31,29,31,14,17,29,14
Chamberlain,247,2,249,2019-02-04T20:00:00Z,False,11,18,0,0,61,32,29,31,17,14,30,12
Chamberlain,247,2,254,2019-02-09T15:00:00Z,True,11,1,0,0,62,32,30,33,24,9,29,23
Chamberlain,247,2,267,2019-02-24T14:05:00Z,False,11,13,0,0,65,35,30,51,25,26,14,5
Chamberlain,247,2,276,2019-02-27T20:00:00Z,True,11,17,0,0,66,35,31,40,20,20,26,15
Chamberlain,247,2,283,2019-03-03T16:15:00Z,False,11,7,0,0,69,38,31,36,21,15,33,10
Chamberlain,247,2,296,2019-03-10T12:00:00Z,True,11,3,0,0,70,38,32,30,17,13,40,25
Chamberlain,247,2,304,2019-03-17T14:15:00Z,False,11,8,0,0,73,41,32,17,15,2,56,17
Chamberlain,247,2,317,2019-03-31T15:30:00Z,True,11,16,0,0,76,41,35,61,28,33,15,8
Chamberlain,247,2,326,2019-04-05T19:00:00Z,False,11,15,0,0,79,44,35,33,18,15,46,17
Chamberlain,247,2,335,2019-04-14T15:30:00Z,True,11,5,0,0,82,44,38,66,38,28,16,16
Chamberlain,247,2,342,2019-04-21T15:00:00Z,False,11,4,0,0,85,47,38,31,20,11,54,18
Chamberlain,247,2,355,2019-04-26T19:00:00Z,True,11,9,17,1,88,47,41,14,8,6,74,41
Chamberlain,247,2,367,2019-05-04T18:45:00Z,False,11,14,0,0,91,50,41,42,25,17,49,16
Chamberlain,247,2,375,2019-05-12T14:00:00Z,True,11,19,2,1,94,50,44,57,34,23,37,27
Henderson,248,2,4,2018-08-12T12:30:00Z,True,11,18,21,1,0,0,0,0,0,0,0,0
Henderson,248,2,14,2018-08-20T19:00:00Z,False,11,6,23,1,3,3,0,3,0,3,0,0
Henderson,248,2,24,2018-08-25T16:30:00Z,True,11,2,23,1,6,3,3,3,3,0,3,3
Henderson,248,2,36,2018-09-01T11:30:00Z,False,11,10,70,2,9,6,3,6,3,3,3,0
Henderson,248,2,47,2018-09-15T11:30:00Z,False,11,16,16,1,12,6,6,9,3,6,3,3
Henderson,248,2,57,2018-09-22T14:00:00Z,True,11,15,90,3,15,6,9,5,2,3,10,3
Henderson,248,2,63,2018-09-29T16:30:00Z,False,11,5,77,2,18,9,9,16,9,7,2,0
Henderson,248,2,75,2018-10-07T15:30:00Z,True,11,12,90,3,19,9,10,19,12,7,0,2
Henderson,248,2,85,2018-10-20T16:30:00Z,False,11,9,45,1,20,10,10,3,1,2,17,9
Henderson,248,2,95,2018-10-27T14:00:00Z,True,11,4,0,0,23,10,13,5,4,1,18,9
Henderson,248,2,100,2018-11-03T17:30:00Z,False,11,0,0,0,26,13,13,22,12,10,4,1
Henderson,248,2,116,2018-11-11T12:00:00Z,True,11,8,21,1,27,13,14,5,4,1,22,12
Henderson,248,2,127,2018-11-24T15:00:00Z,False,11,17,81,0,30,16,14,20,12,8,10,2
Henderson,248,2,136,2018-12-02T16:15:00Z,True,11,7,0,0,33,16,17,22,16,6,11,10
Henderson,248,2,142,2018-12-05T19:45:00Z,False,11,3,90,2,36,19,17,9,4,5,27,13
Henderson,248,2,151,2018-12-08T12:30:00Z,False,11,1,9,1,39,19,20,23,14,9,16,6
Henderson,248,2,164,2018-12-16T16:00:00Z,True,11,13,6,1,42,19,23,26,15,11,16,8
Henderson,248,2,179,2018-12-21T20:00:00Z,False,11,19,90,3,45,22,23,25,14,11,20,9
Henderson,248,2,185,2018-12-26T15:00:00Z,True,11,14,90,3,48,22,26,17,7,10,31,12
Henderson,248,2,195,2018-12-29T17:30:00Z,True,11,0,28,1,51,25,26,38,23,15,13,10
Henderson,248,2,206,2019-01-03T20:00:00Z,False,11,12,90,2,54,28,26,47,27,20,7,-1
Henderson,248,2,210,2019-01-12T15:00:00Z,False,11,2,90,3,54,28,26,26,18,8,28,8
Henderson,248,2,224,2019-01-19T15:00:00Z,True,11,6,90,2,57,28,29,22,9,13,35,15
Henderson,248,2,236,2019-01-30T20:00:00Z,True,11,10,90,2,60,31,29,31,14,17,29,14
Henderson,248,2,249,2019-02-04T20:00:00Z,False,11,18,0,0,61,32,29,31,17,14,30,12
Henderson,248,2,254,2019-02-09T15:00:00Z,True,11,1,0,0,62,32,30,33,24,9,29,23
Henderson,248,2,267,2019-02-24T14:05:00Z,False,11,13,71,3,65,35,30,51,25,26,14,5
Henderson,248,2,276,2019-02-27T20:00:00Z,True,11,17,20,1,66,35,31,40,20,20,26,15
Henderson,248,2,283,2019-03-03T16:15:00Z,False,11,7,90,3,69,38,31,36,21,15,33,10
Henderson,248,2,296,2019-03-10T12:00:00Z,True,11,3,22,1,70,38,32,30,17,13,40,25
Henderson,248,2,304,2019-03-17T14:15:00Z,False,11,8,0,0,73,41,32,17,15,2,56,17
Henderson,248,2,317,2019-03-31T15:30:00Z,True,11,16,76,2,76,41,35,61,28,33,15,8
Henderson,248,2,326,2019-04-05T19:00:00Z,False,11,15,31,10,79,44,35,33,18,15,46,17
Henderson,248,2,335,2019-04-14T15:30:00Z,True,11,5,76,6,82,44,38,66,38,28,16,16
Henderson,248,2,342,2019-04-21T15:00:00Z,False,11,4,90,3,85,47,38,31,20,11,54,18
Henderson,248,2,355,2019-04-26T19:00:00Z,True,11,9,90,6,88,47,41,14,8,6,74,41
Henderson,248,2,367,2019-05-04T18:45:00Z,False,11,14,90,2,91,50,41,42,25,17,49,16
Henderson,248,2,375,2019-05-12T14:00:00Z,True,11,19,90,3,94,50,44,57,34,23,37,27
Lallana,249,2,4,2018-08-12T12:30:00Z,True,11,18,0,0,0,0,0,0,0,0,0,0
Lallana,249,2,14,2018-08-20T19:00:00Z,False,11,6,3,1,3,3,0,3,0,3,0,0
Lallana,249,2,24,2018-08-25T16:30:00Z,True,11,2,0,0,6,3,3,3,3,0,3,3
Lallana,249,2,36,2018-09-01T11:30:00Z,False,11,10,0,0,9,6,3,6,3,3,3,0
Lallana,249,2,47,2018-09-15T11:30:00Z,False,11,16,0,0,12,6,6,9,3,6,3,3
Lallana,249,2,57,2018-09-22T14:00:00Z,True,11,15,0,0,15,6,9,5,2,3,10,3
Lallana,249,2,63,2018-09-29T16:30:00Z,False,11,5,0,0,18,9,9,16,9,7,2,0
Lallana,249,2,75,2018-10-07T15:30:00Z,True,11,12,0,0,19,9,10,19,12,7,0,2
Lallana,249,2,85,2018-10-20T16:30:00Z,False,11,9,68,2,20,10,10,3,1,2,17,9
Lallana,249,2,95,2018-10-27T14:00:00Z,True,11,4,60,3,23,10,13,5,4,1,18,9
Lallana,249,2,100,2018-11-03T17:30:00Z,False,11,0,0,0,26,13,13,22,12,10,4,1
Lallana,249,2,116,2018-11-11T12:00:00Z,True,11,8,0,0,27,13,14,5,4,1,22,12
Lallana,249,2,127,2018-11-24T15:00:00Z,False,11,17,0,0,30,16,14,20,12,8,10,2
Lallana,249,2,136,2018-12-02T16:15:00Z,True,11,7,0,0,33,16,17,22,16,6,11,10
Lallana,249,2,142,2018-12-05T19:45:00Z,False,11,3,0,0,36,19,17,9,4,5,27,13
Lallana,249,2,151,2018-12-08T12:30:00Z,False,11,1,25,4,39,19,20,23,14,9,16,6
Lallana,249,2,164,2018-12-16T16:00:00Z,True,11,13,0,0,42,19,23,26,15,11,16,8
Lallana,249,2,179,2018-12-21T20:00:00Z,False,11,19,32,1,45,22,23,25,14,11,20,9
Lallana,249,2,185,2018-12-26T15:00:00Z,True,11,14,0,0,48,22,26,17,7,10,31,12
Lallana,249,2,195,2018-12-29T17:30:00Z,True,11,0,12,1,51,25,26,38,23,15,13,10
Lallana,249,2,206,2019-01-03T20:00:00Z,False,11,12,0,0,54,28,26,47,27,20,7,-1
Lallana,249,2,210,2019-01-12T15:00:00Z,False,11,2,0,0,54,28,26,26,18,8,28,8
Lallana,249,2,224,2019-01-19T15:00:00Z,True,11,6,3,1,57,28,29,22,9,13,35,15
Lallana,249,2,236,2019-01-30T20:00:00Z,True,11,10,24,1,60,31,29,31,14,17,29,14
Lallana,249,2,249,2019-02-04T20:00:00Z,False,11,18,68,2,61,32,29,31,17,14,30,12
Lallana,249,2,254,2019-02-09T15:00:00Z,True,11,1,0,0,62,32,30,33,24,9,29,23
Lallana,249,2,267,2019-02-24T14:05:00Z,False,11,13,0,0,65,35,30,51,25,26,14,5
Lallana,249,2,276,2019-02-27T20:00:00Z,True,11,17,12,1,66,35,31,40,20,20,26,15
Lallana,249,2,283,2019-03-03T16:15:00Z,False,11,7,6,1,69,38,31,36,21,15,33,10
Lallana,249,2,296,2019-03-10T12:00:00Z,True,11,3,76,2,70,38,32,30,17,13,40,25
Lallana,249,2,304,2019-03-17T14:15:00Z,False,11,8,71,3,73,41,32,17,15,2,56,17
Lallana,249,2,317,2019-03-31T15:30:00Z,True,11,16,0,0,76,41,35,61,28,33,15,8
Lallana,249,2,326,2019-04-05T19:00:00Z,False,11,15,0,0,79,44,35,33,18,15,46,17
Lallana,249,2,335,2019-04-14T15:30:00Z,True,11,5,0,0,82,44,38,66,38,28,16,16
Lallana,249,2,342,2019-04-21T15:00:00Z,False,11,4,0,0,85,47,38,31,20,11,54,18
Lallana,249,2,355,2019-04-26T19:00:00Z,True,11,9,0,0,88,47,41,14,8,6,74,41
Lallana,249,2,367,2019-05-04T18:45:00Z,False,11,14,0,0,91,50,41,42,25,17,49,16
Lallana,249,2,375,2019-05-12T14:00:00Z,True,11,19,0,0,94,50,44,57,34,23,37,27
Mane,250,2,4,2018-08-12T12:30:00Z,True,11,18,81,16,0,0,0,0,0,0,0,0
Mane,250,2,14,2018-08-20T19:00:00Z,False,11,6,90,10,3,3,0,3,0,3,0,0
Mane,250,2,24,2018-08-25T16:30:00Z,True,11,2,79,3,6,3,3,3,3,0,3,3
Mane,250,2,36,2018-09-01T11:30:00Z,False,11,10,90,10,9,6,3,6,3,3,3,0
Mane,250,2,47,2018-09-15T11:30:00Z,False,11,16,90,2,12,6,6,9,3,6,3,3
Mane,250,2,57,2018-09-22T14:00:00Z,True,11,15,90,3,15,6,9,5,2,3,10,3
Mane,250,2,63,2018-09-29T16:30:00Z,False,11,5,90,1,18,9,9,16,9,7,2,0
Mane,250,2,75,2018-10-07T15:30:00Z,True,11,12,90,3,19,9,10,19,12,7,0,2
Mane,250,2,85,2018-10-20T16:30:00Z,False,11,9,0,0,20,10,10,3,1,2,17,9
Mane,250,2,95,2018-10-27T14:00:00Z,True,11,4,90,15,23,10,13,5,4,1,18,9
Mane,250,2,100,2018-11-03T17:30:00Z,False,11,0,90,2,26,13,13,22,12,10,4,1
Mane,250,2,116,2018-11-11T12:00:00Z,True,11,8,90,3,27,13,14,5,4,1,22,12
Mane,250,2,127,2018-11-24T15:00:00Z,False,11,17,90,9,30,16,14,20,12,8,10,2
Mane,250,2,136,2018-12-02T16:15:00Z,True,11,7,90,3,33,16,17,22,16,6,11,10
Mane,250,2,142,2018-12-05T19:45:00Z,False,11,3,0,0,36,19,17,9,4,5,27,13
Mane,250,2,151,2018-12-08T12:30:00Z,False,11,1,25,1,39,19,20,23,14,9,16,6
Mane,250,2,164,2018-12-16T16:00:00Z,True,11,13,83,9,42,19,23,26,15,11,16,8
Mane,250,2,179,2018-12-21T20:00:00Z,False,11,19,86,3,45,22,23,25,14,11,20,9
Mane,250,2,185,2018-12-26T15:00:00Z,True,11,14,90,3,48,22,26,17,7,10,31,12
Mane,250,2,195,2018-12-29T17:30:00Z,True,11,0,61,7,51,25,26,38,23,15,13,10
Mane,250,2,206,2019-01-03T20:00:00Z,False,11,12,76,2,54,28,26,47,27,20,7,-1
Mane,250,2,210,2019-01-12T15:00:00Z,False,11,2,89,3,54,28,26,26,18,8,28,8
Mane,250,2,224,2019-01-19T15:00:00Z,True,11,6,90,7,57,28,29,22,9,13,35,15
Mane,250,2,236,2019-01-30T20:00:00Z,True,11,10,90,9,60,31,29,31,14,17,29,14
Mane,250,2,249,2019-02-04T20:00:00Z,False,11,18,90,8,61,32,29,31,17,14,30,12
Mane,250,2,254,2019-02-09T15:00:00Z,True,11,1,86,8,62,32,30,33,24,9,29,23
Mane,250,2,267,2019-02-24T14:05:00Z,False,11,13,90,3,65,35,30,51,25,26,14,5
Mane,250,2,276,2019-02-27T20:00:00Z,True,11,17,77,13,66,35,31,40,20,20,26,15
Mane,250,2,283,2019-03-03T16:15:00Z,False,11,7,83,3,69,38,31,36,21,15,33,10
Mane,250,2,296,2019-03-10T12:00:00Z,True,11,3,90,14,70,38,32,30,17,13,40,25
Mane,250,2,304,2019-03-17T14:15:00Z,False,11,8,90,13,73,41,32,17,15,2,56,17
Mane,250,2,317,2019-03-31T15:30:00Z,True,11,16,90,2,76,41,35,61,28,33,15,8
Mane,250,2,326,2019-04-05T19:00:00Z,False,11,15,90,1,79,44,35,33,18,15,46,17
Mane,250,2,335,2019-04-14T15:30:00Z,True,11,5,90,9,82,44,38,66,38,28,16,16
Mane,250,2,342,2019-04-21T15:00:00Z,False,11,4,90,3,85,47,38,31,20,11,54,18
Mane,250,2,355,2019-04-26T19:00:00Z,True,11,9,90,13,88,47,41,14,8,6,74,41
Mane,250,2,367,2019-05-04T18:45:00Z,False,11,14,90,2,91,50,41,42,25,17,49,16
Mane,250,2,375,2019-05-12T14:00:00Z,True,11,19,90,15,94,50,44,57,34,23,37,27
Wijnaldum,251,2,4,2018-08-12T12:30:00Z,True,11,18,90,3,0,0,0,0,0,0,0,0
Wijnaldum,251,2,14,2018-08-20T19:00:00Z,False,11,6,90,3,3,3,0,3,0,3,0,0
Wijnaldum,251,2,24,2018-08-25T16:30:00Z,True,11,2,90,3,6,3,3,3,3,0,3,3
Wijnaldum,251,2,36,2018-09-01T11:30:00Z,False,11,10,90,2,9,6,3,6,3,3,3,0
Wijnaldum,251,2,47,2018-09-15T11:30:00Z,False,11,16,90,9,12,6,6,9,3,6,3,3
Wijnaldum,251,2,57,2018-09-22T14:00:00Z,True,11,15,69,3,15,6,9,5,2,3,10,3
Wijnaldum,251,2,63,2018-09-29T16:30:00Z,False,11,5,90,2,18,9,9,16,9,7,2,0
Wijnaldum,251,2,75,2018-10-07T15:30:00Z,True,11,12,90,2,19,9,10,19,12,7,0,2
Wijnaldum,251,2,85,2018-10-20T16:30:00Z,False,11,9,45,1,20,10,10,3,1,2,17,9
Wijnaldum,251,2,95,2018-10-27T14:00:00Z,True,11,4,90,6,23,10,13,5,4,1,18,9
Wijnaldum,251,2,100,2018-11-03T17:30:00Z,False,11,0,90,2,26,13,13,22,12,10,4,1
Wijnaldum,251,2,116,2018-11-11T12:00:00Z,True,11,8,68,3,27,13,14,5,4,1,22,12
Wijnaldum,251,2,127,2018-11-24T15:00:00Z,False,11,17,90,3,30,16,14,20,12,8,10,2
Wijnaldum,251,2,136,2018-12-02T16:15:00Z,True,11,7,90,3,33,16,17,22,16,6,11,10
Wijnaldum,251,2,142,2018-12-05T19:45:00Z,False,11,3,0,0,36,19,17,9,4,5,27,13
Wijnaldum,251,2,151,2018-12-08T12:30:00Z,False,11,1,90,3,39,19,20,23,14,9,16,6
Wijnaldum,251,2,164,2018-12-16T16:00:00Z,True,11,13,90,2,42,19,23,26,15,11,16,8
Wijnaldum,251,2,179,2018-12-21T20:00:00Z,False,11,19,14,1,45,22,23,25,14,11,20,9
Wijnaldum,251,2,185,2018-12-26T15:00:00Z,True,11,14,61,3,48,22,26,17,7,10,31,12
Wijnaldum,251,2,195,2018-12-29T17:30:00Z,True,11,0,77,2,51,25,26,38,23,15,13,10
Wijnaldum,251,2,206,2019-01-03T20:00:00Z,False,11,12,85,1,54,28,26,47,27,20,7,-1
Wijnaldum,251,2,210,2019-01-12T15:00:00Z,False,11,2,90,3,54,28,26,26,18,8,28,8
Wijnaldum,251,2,224,2019-01-19T15:00:00Z,True,11,6,0,0,57,28,29,22,9,13,35,15
Wijnaldum,251,2,236,2019-01-30T20:00:00Z,True,11,10,90,2,60,31,29,31,14,17,29,14
Wijnaldum,251,2,249,2019-02-04T20:00:00Z,False,11,18,0,0,61,32,29,31,17,14,30,12
Wijnaldum,251,2,254,2019-02-09T15:00:00Z,True,11,1,76,11,62,32,30,33,24,9,29,23
Wijnaldum,251,2,267,2019-02-24T14:05:00Z,False,11,13,90,2,65,35,30,51,25,26,14,5
Wijnaldum,251,2,276,2019-02-27T20:00:00Z,True,11,17,83,3,66,35,31,40,20,20,26,15
Wijnaldum,251,2,283,2019-03-03T16:15:00Z,False,11,7,62,3,69,38,31,36,21,15,33,10
Wijnaldum,251,2,296,2019-03-10T12:00:00Z,True,11,3,67,2,70,38,32,30,17,13,40,25
Wijnaldum,251,2,304,2019-03-17T14:15:00Z,False,11,8,90,2,73,41,32,17,15,2,56,17
Wijnaldum,251,2,317,2019-03-31T15:30:00Z,True,11,16,90,2,76,41,35,61,28,33,15,8
Wijnaldum,251,2,326,2019-04-05T19:00:00Z,False,11,15,58,1,79,44,35,33,18,15,46,17
Wijnaldum,251,2,335,2019-04-14T15:30:00Z,True,11,5,24,1,82,44,38,66,38,28,16,16
Wijnaldum,251,2,342,2019-04-21T15:00:00Z,False,11,4,90,11,85,47,38,31,20,11,54,18
Wijnaldum,251,2,355,2019-04-26T19:00:00Z,True,11,9,72,3,88,47,41,14,8,6,74,41
Wijnaldum,251,2,367,2019-05-04T18:45:00Z,False,11,14,65,2,91,50,41,42,25,17,49,16
Wijnaldum,251,2,375,2019-05-12T14:00:00Z,True,11,19,87,3,94,50,44,57,34,23,37,27
Salah,252,2,4,2018-08-12T12:30:00Z,True,11,18,86,8,0,0,0,0,0,0,0,0
Salah,252,2,14,2018-08-20T19:00:00Z,False,11,6,90,9,3,3,0,3,0,3,0,0
Salah,252,2,24,2018-08-25T16:30:00Z,True,11,2,90,8,6,3,3,3,3,0,3,3
Salah,252,2,36,2018-09-01T11:30:00Z,False,11,10,70,2,9,6,3,6,3,3,3,0
Salah,252,2,47,2018-09-15T11:30:00Z,False,11,16,90,2,12,6,6,9,3,6,3,3
Salah,252,2,57,2018-09-22T14:00:00Z,True,11,15,90,8,15,6,9,5,2,3,10,3
Salah,252,2,63,2018-09-29T16:30:00Z,False,11,5,65,2,18,9,9,16,9,7,2,0
Salah,252,2,75,2018-10-07T15:30:00Z,True,11,12,90,3,19,9,10,19,12,7,0,2
Salah,252,2,85,2018-10-20T16:30:00Z,False,11,9,90,8,20,10,10,3,1,2,17,9
Salah,252,2,95,2018-10-27T14:00:00Z,True,11,4,90,15,23,10,13,5,4,1,18,9
Salah,252,2,100,2018-11-03T17:30:00Z,False,11,0,90,2,26,13,13,22,12,10,4,1
Salah,252,2,116,2018-11-11T12:00:00Z,True,11,8,90,8,27,13,14,5,4,1,22,12
Salah,252,2,127,2018-11-24T15:00:00Z,False,11,17,85,8,30,16,14,20,12,8,10,2
Salah,252,2,136,2018-12-02T16:15:00Z,True,11,7,74,3,33,16,17,22,16,6,11,10
Salah,252,2,142,2018-12-05T19:45:00Z,False,11,3,25,4,36,19,17,9,4,5,27,13
Salah,252,2,151,2018-12-08T12:30:00Z,False,11,1,90,21,39,19,20,23,14,9,16,6
Salah,252,2,164,2018-12-16T16:00:00Z,True,11,13,90,2,42,19,23,26,15,11,16,8
Salah,252,2,179,2018-12-21T20:00:00Z,False,11,19,90,12,45,22,23,25,14,11,20,9
Salah,252,2,185,2018-12-26T15:00:00Z,True,11,14,90,12,48,22,26,17,7,10,31,12
Salah,252,2,195,2018-12-29T17:30:00Z,True,11,0,90,12,51,25,26,38,23,15,13,10
Salah,252,2,206,2019-01-03T20:00:00Z,False,11,12,90,2,54,28,26,47,27,20,7,-1
Salah,252,2,210,2019-01-12T15:00:00Z,False,11,2,90,11,54,28,26,26,18,8,28,8
Salah,252,2,224,2019-01-19T15:00:00Z,True,11,6,90,15,57,28,29,22,9,13,35,15
Salah,252,2,236,2019-01-30T20:00:00Z,True,11,10,90,2,60,31,29,31,14,17,29,14
Salah,252,2,249,2019-02-04T20:00:00Z,False,11,18,90,2,61,32,29,31,17,14,30,12
Salah,252,2,254,2019-02-09T15:00:00Z,True,11,1,90,8,62,32,30,33,24,9,29,23
Salah,252,2,267,2019-02-24T14:05:00Z,False,11,13,78,3,65,35,30,51,25,26,14,5
Salah,252,2,276,2019-02-27T20:00:00Z,True,11,17,90,3,66,35,31,40,20,20,26,15
Salah,252,2,283,2019-03-03T16:15:00Z,False,11,7,90,3,69,38,31,36,21,15,33,10
Salah,252,2,296,2019-03-10T12:00:00Z,True,11,3,90,5,70,38,32,30,17,13,40,25
Salah,252,2,304,2019-03-17T14:15:00Z,False,11,8,90,2,73,41,32,17,15,2,56,17
Salah,252,2,317,2019-03-31T15:30:00Z,True,11,16,90,5,76,41,35,61,28,33,15,8
Salah,252,2,326,2019-04-05T19:00:00Z,False,11,15,90,6,79,44,35,33,18,15,46,17
Salah,252,2,335,2019-04-14T15:30:00Z,True,11,5,89,8,82,44,38,66,38,28,16,16
Salah,252,2,342,2019-04-21T15:00:00Z,False,11,4,90,6,85,47,38,31,20,11,54,18
Salah,252,2,355,2019-04-26T19:00:00Z,True,11,9,90,19,88,47,41,14,8,6,74,41
Salah,252,2,367,2019-05-04T18:45:00Z,False,11,14,72,7,91,50,41,42,25,17,49,16
Salah,252,2,375,2019-05-12T14:00:00Z,True,11,19,90,3,94,50,44,57,34,23,37,27
Milner,253,2,4,2018-08-12T12:30:00Z,True,11,18,90,6,0,0,0,0,0,0,0,0
Milner,253,2,14,2018-08-20T19:00:00Z,False,11,6,66,11,3,3,0,3,0,3,0,0
Milner,253,2,24,2018-08-25T16:30:00Z,True,11,2,90,3,6,3,3,3,3,0,3,3
Milner,253,2,36,2018-09-01T11:30:00Z,False,11,10,90,4,9,6,3,6,3,3,3,0
Milner,253,2,47,2018-09-15T11:30:00Z,False,11,16,90,2,12,6,6,9,3,6,3,3
Milner,253,2,57,2018-09-22T14:00:00Z,True,11,15,45,1,15,6,9,5,2,3,10,3
Milner,253,2,63,2018-09-29T16:30:00Z,False,11,5,85,1,18,9,9,16,9,7,2,0
Milner,253,2,75,2018-10-07T15:30:00Z,True,11,12,28,1,19,9,10,19,12,7,0,2
Milner,253,2,85,2018-10-20T16:30:00Z,False,11,9,76,3,20,10,10,3,1,2,17,9
Milner,253,2,95,2018-10-27T14:00:00Z,True,11,4,19,1,23,10,13,5,4,1,18,9
Milner,253,2,100,2018-11-03T17:30:00Z,False,11,0,90,10,26,13,13,22,12,10,4,1
Milner,253,2,116,2018-11-11T12:00:00Z,True,11,8,9,1,27,13,14,5,4,1,22,12
Milner,253,2,127,2018-11-24T15:00:00Z,False,11,17,16,1,30,16,14,20,12,8,10,2
Milner,253,2,136,2018-12-02T16:15:00Z,True,11,7,0,0,33,16,17,22,16,6,11,10
Milner,253,2,142,2018-12-05T19:45:00Z,False,11,3,90,10,36,19,17,9,4,5,27,13
Milner,253,2,151,2018-12-08T12:30:00Z,False,11,1,90,3,39,19,20,23,14,9,16,6
Milner,253,2,164,2018-12-16T16:00:00Z,True,11,13,0,0,42,19,23,26,15,11,16,8
Milner,253,2,179,2018-12-21T20:00:00Z,False,11,19,90,3,45,22,23,25,14,11,20,9
Milner,253,2,185,2018-12-26T15:00:00Z,True,11,14,0,0,48,22,26,17,7,10,31,12
Milner,253,2,195,2018-12-29T17:30:00Z,True,11,0,0,0,51,25,26,38,23,15,13,10
Milner,253,2,206,2019-01-03T20:00:00Z,False,11,12,56,1,54,28,26,47,27,20,7,-1
Milner,253,2,210,2019-01-12T15:00:00Z,False,11,2,18,1,54,28,26,26,18,8,28,8
Milner,253,2,224,2019-01-19T15:00:00Z,True,11,6,88,2,57,28,29,22,9,13,35,15
Milner,253,2,236,2019-01-30T20:00:00Z,True,11,10,0,0,60,31,29,31,14,17,29,14
Milner,253,2,249,2019-02-04T20:00:00Z,False,11,18,90,7,61,32,29,31,17,14,30,12
Milner,253,2,254,2019-02-09T15:00:00Z,True,11,1,90,6,62,32,30,33,24,9,29,23
Milner,253,2,267,2019-02-24T14:05:00Z,False,11,13,90,2,65,35,30,51,25,26,14,5
Milner,253,2,276,2019-02-27T20:00:00Z,True,11,17,69,3,66,35,31,40,20,20,26,15
Milner,253,2,283,2019-03-03T16:15:00Z,False,11,7,27,1,69,38,31,36,21,15,33,10
Milner,253,2,296,2019-03-10T12:00:00Z,True,11,3,0,0,70,38,32,30,17,13,40,25
Milner,253,2,304,2019-03-17T14:15:00Z,False,11,8,18,7,73,41,32,17,15,2,56,17
Milner,253,2,317,2019-03-31T15:30:00Z,True,11,16,76,2,76,41,35,61,28,33,15,8
Milner,253,2,326,2019-04-05T19:00:00Z,False,11,15,31,1,79,44,35,33,18,15,46,17
Milner,253,2,335,2019-04-14T15:30:00Z,True,11,5,13,1,82,44,38,66,38,28,16,16
Milner,253,2,342,2019-04-21T15:00:00Z,False,11,4,15,5,85,47,38,31,20,11,54,18
Milner,253,2,355,2019-04-26T19:00:00Z,True,11,9,0,0,88,47,41,14,8,6,74,41
Milner,253,2,367,2019-05-04T18:45:00Z,False,11,14,7,0,91,50,41,42,25,17,49,16
Milner,253,2,375,2019-05-12T14:00:00Z,True,11,19,26,1,94,50,44,57,34,23,37,27
Fabinho,254,2,4,2018-08-12T12:30:00Z,True,11,18,0,0,0,0,0,0,0,0,0,0
Fabinho,254,2,14,2018-08-20T19:00:00Z,False,11,6,0,0,3,3,0,3,0,3,0,0
Fabinho,254,2,24,2018-08-25T16:30:00Z,True,11,2,0,0,6,3,3,3,3,0,3,3
Fabinho,254,2,36,2018-09-01T11:30:00Z,False,11,10,0,0,9,6,3,6,3,3,3,0
Fabinho,254,2,47,2018-09-15T11:30:00Z,False,11,16,0,0,12,6,6,9,3,6,3,3
Fabinho,254,2,57,2018-09-22T14:00:00Z,True,11,15,0,0,15,6,9,5,2,3,10,3
Fabinho,254,2,63,2018-09-29T16:30:00Z,False,11,5,0,0,18,9,9,16,9,7,2,0
Fabinho,254,2,75,2018-10-07T15:30:00Z,True,11,12,0,0,19,9,10,19,12,7,0,2
Fabinho,254,2,85,2018-10-20T16:30:00Z,False,11,9,21,1,20,10,10,3,1,2,17,9
Fabinho,254,2,95,2018-10-27T14:00:00Z,True,11,4,90,2,23,10,13,5,4,1,18,9
Fabinho,254,2,100,2018-11-03T17:30:00Z,False,11,0,90,1,26,13,13,22,12,10,4,1
Fabinho,254,2,116,2018-11-11T12:00:00Z,True,11,8,90,3,27,13,14,5,4,1,22,12
Fabinho,254,2,127,2018-11-24T15:00:00Z,False,11,17,4,1,30,16,14,20,12,8,10,2
Fabinho,254,2,136,2018-12-02T16:15:00Z,True,11,7,90,2,33,16,17,22,16,6,11,10
Fabinho,254,2,142,2018-12-05T19:45:00Z,False,11,3,0,0,36,19,17,9,4,5,27,13
Fabinho,254,2,151,2018-12-08T12:30:00Z,False,11,1,90,2,39,19,20,23,14,9,16,6
Fabinho,254,2,164,2018-12-16T16:00:00Z,True,11,13,90,5,42,19,23,26,15,11,16,8
Fabinho,254,2,179,2018-12-21T20:00:00Z,False,11,19,90,6,45,22,23,25,14,11,20,9
Fabinho,254,2,185,2018-12-26T15:00:00Z,True,11,14,28,6,48,22,26,17,7,10,31,12
Fabinho,254,2,195,2018-12-29T17:30:00Z,True,11,0,90,2,51,25,26,38,23,15,13,10
Fabinho,254,2,206,2019-01-03T20:00:00Z,False,11,12,33,1,54,28,26,47,27,20,7,-1
Fabinho,254,2,210,2019-01-12T15:00:00Z,False,11,2,90,3,54,28,26,26,18,8,28,8
Fabinho,254,2,224,2019-01-19T15:00:00Z,True,11,6,86,2,57,28,29,22,9,13,35,15
Fabinho,254,2,236,2019-01-30T20:00:00Z,True,11,10,23,1,60,31,29,31,14,17,29,14
Fabinho,254,2,249,2019-02-04T20:00:00Z,False,11,18,90,2,61,32,29,31,17,14,30,12
Fabinho,254,2,254,2019-02-09T15:00:00Z,True,11,1,90,3,62,32,30,33,24,9,29,23
Fabinho,254,2,267,2019-02-24T14:05:00Z,False,11,13,90,3,65,35,30,51,25,26,14,5
Fabinho,254,2,276,2019-02-27T20:00:00Z,True,11,17,90,3,66,35,31,40,20,20,26,15
Fabinho,254,2,283,2019-03-03T16:15:00Z,False,11,7,90,2,69,38,31,36,21,15,33,10
Fabinho,254,2,296,2019-03-10T12:00:00Z,True,11,3,90,1,70,38,32,30,17,13,40,25
Fabinho,254,2,304,2019-03-17T14:15:00Z,False,11,8,90,1,73,41,32,17,15,2,56,17
Fabinho,254,2,317,2019-03-31T15:30:00Z,True,11,16,13,1,76,41,35,61,28,33,15,8
Fabinho,254,2,326,2019-04-05T19:00:00Z,False,11,15,90,2,79,44,35,33,18,15,46,17
Fabinho,254,2,335,2019-04-14T15:30:00Z,True,11,5,90,3,82,44,38,66,38,28,16,16
Fabinho,254,2,342,2019-04-21T15:00:00Z,False,11,4,3,1,85,47,38,31,20,11,54,18
Fabinho,254,2,355,2019-04-26T19:00:00Z,True,11,9,0,0,88,47,41,14,8,6,74,41
Fabinho,254,2,367,2019-05-04T18:45:00Z,False,11,14,90,2,91,50,41,42,25,17,49,16
Fabinho,254,2,375,2019-05-12T14:00:00Z,True,11,19,90,3,94,50,44,57,34,23,37,27
Keita,255,2,4,2018-08-12T12:30:00Z,True,11,18,90,3,0,0,0,0,0,0,0,0
Keita,255,2,14,2018-08-20T19:00:00Z,False,11,6,86,3,3,3,0,3,0,3,0,0
Keita,255,2,24,2018-08-25T16:30:00Z,True,11,2,66,3,6,3,3,3,3,0,3,3
Keita,255,2,36,2018-09-01T11:30:00Z,False,11,10,19,1,9,6,3,6,3,3,3,0
Keita,255,2,47,2018-09-15T11:30:00Z,False,11,16,82,3,12,6,6,9,3,6,3,3
Keita,255,2,57,2018-09-22T14:00:00Z,True,11,15,20,1,15,6,9,5,2,3,10,3
Keita,255,2,63,2018-09-29T16:30:00Z,False,11,5,12,1,18,9,9,16,9,7,2,0
Keita,255,2,75,2018-10-07T15:30:00Z,True,11,12,61,3,19,9,10,19,12,7,0,2
Keita,255,2,85,2018-10-20T16:30:00Z,False,11,9,0,0,20,10,10,3,1,2,17,9
Keita,255,2,95,2018-10-27T14:00:00Z,True,11,4,0,0,23,10,13,5,4,1,18,9
Keita,255,2,100,2018-11-03T17:30:00Z,False,11,0,0,0,26,13,13,22,12,10,4,1
Keita,255,2,116,2018-11-11T12:00:00Z,True,11,8,1,1,27,13,14,5,4,1,22,12
Keita,255,2,127,2018-11-24T15:00:00Z,False,11,17,0,0,30,16,14,20,12,8,10,2
Keita,255,2,136,2018-12-02T16:15:00Z,True,11,7,19,1,33,16,17,22,16,6,11,10
Keita,255,2,142,2018-12-05T19:45:00Z,False,11,3,90,2,36,19,17,9,4,5,27,13
Keita,255,2,151,2018-12-08T12:30:00Z,False,11,1,64,3,39,19,20,23,14,9,16,6
Keita,255,2,164,2018-12-16T16:00:00Z,True,11,13,69,2,42,19,23,26,15,11,16,8
Keita,255,2,179,2018-12-21T20:00:00Z,False,11,19,57,1,45,22,23,25,14,11,20,9
Keita,255,2,185,2018-12-26T15:00:00Z,True,11,14,0,0,48,22,26,17,7,10,31,12
Keita,255,2,195,2018-12-29T17:30:00Z,True,11,0,0,0,51,25,26,38,23,15,13,10
Keita,255,2,206,2019-01-03T20:00:00Z,False,11,12,0,0,54,28,26,47,27,20,7,-1
Keita,255,2,210,2019-01-12T15:00:00Z,False,11,2,1,1,54,28,26,26,18,8,28,8
Keita,255,2,224,2019-01-19T15:00:00Z,True,11,6,71,5,57,28,29,22,9,13,35,15
Keita,255,2,236,2019-01-30T20:00:00Z,True,11,10,66,2,60,31,29,31,14,17,29,14
Keita,255,2,249,2019-02-04T20:00:00Z,False,11,18,90,2,61,32,29,31,17,14,30,12
Keita,255,2,254,2019-02-09T15:00:00Z,True,11,1,90,3,62,32,30,33,24,9,29,23
Keita,255,2,267,2019-02-24T14:05:00Z,False,11,13,0,0,65,35,30,51,25,26,14,5
Keita,255,2,276,2019-02-27T20:00:00Z,True,11,17,6,1,66,35,31,40,20,20,26,15
Keita,255,2,283,2019-03-03T16:15:00Z,False,11,7,0,0,69,38,31,36,21,15,33,10
Keita,255,2,296,2019-03-10T12:00:00Z,True,11,3,13,1,70,38,32,30,17,13,40,25
Keita,255,2,304,2019-03-17T14:15:00Z,False,11,8,0,0,73,41,32,17,15,2,56,17
Keita,255,2,317,2019-03-31T15:30:00Z,True,11,16,0,0,76,41,35,61,28,33,15,8
Keita,255,2,326,2019-04-05T19:00:00Z,False,11,15,87,10,79,44,35,33,18,15,46,17
Keita,255,2,335,2019-04-14T15:30:00Z,True,11,5,65,3,82,44,38,66,38,28,16,16
Keita,255,2,342,2019-04-21T15:00:00Z,False,11,4,70,3,85,47,38,31,20,11,54,18
Keita,255,2,355,2019-04-26T19:00:00Z,True,11,9,90,8,88,47,41,14,8,6,74,41
Keita,255,2,367,2019-05-04T18:45:00Z,False,11,14,0,0,91,50,41,42,25,17,49,16
Keita,255,2,375,2019-05-12T14:00:00Z,True,11,19,0,0,94,50,44,57,34,23,37,27
Firmino,256,3,4,2018-08-12T12:30:00Z,True,11,18,68,5,0,0,0,0,0,0,0,0
Firmino,256,3,14,2018-08-20T19:00:00Z,False,11,6,90,2,3,3,0,3,0,3,0,0
Firmino,256,3,24,2018-08-25T16:30:00Z,True,11,2,90,5,6,3,3,3,3,0,3,3
Firmino,256,3,36,2018-09-01T11:30:00Z,False,11,10,90,7,9,6,3,6,3,3,3,0
Firmino,256,3,47,2018-09-15T11:30:00Z,False,11,16,73,9,12,6,6,9,3,6,3,3
Firmino,256,3,57,2018-09-22T14:00:00Z,True,11,15,90,2,15,6,9,5,2,3,10,3
Firmino,256,3,63,2018-09-29T16:30:00Z,False,11,5,90,2,18,9,9,16,9,7,2,0
Firmino,256,3,75,2018-10-07T15:30:00Z,True,11,12,71,2,19,9,10,19,12,7,0,2
Firmino,256,3,85,2018-10-20T16:30:00Z,False,11,9,13,1,20,10,10,3,1,2,17,9
Firmino,256,3,95,2018-10-27T14:00:00Z,True,11,4,70,2,23,10,13,5,4,1,18,9
Firmino,256,3,100,2018-11-03T17:30:00Z,False,11,0,79,2,26,13,13,22,12,10,4,1
Firmino,256,3,116,2018-11-11T12:00:00Z,True,11,8,90,2,27,13,14,5,4,1,22,12
Firmino,256,3,127,2018-11-24T15:00:00Z,False,11,17,90,12,30,16,14,20,12,8,10,2
Firmino,256,3,136,2018-12-02T16:15:00Z,True,11,7,83,2,33,16,17,22,16,6,11,10
Firmino,256,3,142,2018-12-05T19:45:00Z,False,11,3,24,7,36,19,17,9,4,5,27,13
Firmino,256,3,151,2018-12-08T12:30:00Z,False,11,1,80,9,39,19,20,23,14,9,16,6
Firmino,256,3,164,2018-12-16T16:00:00Z,True,11,13,90,2,42,19,23,26,15,11,16,8
Firmino,256,3,179,2018-12-21T20:00:00Z,False,11,19,75,2,45,22,23,25,14,11,20,9
Firmino,256,3,185,2018-12-26T15:00:00Z,True,11,14,68,2,48,22,26,17,7,10,31,12
Firmino,256,3,195,2018-12-29T17:30:00Z,True,11,0,90,17,51,25,26,38,23,15,13,10
Firmino,256,3,206,2019-01-03T20:00:00Z,False,11,12,90,8,54,28,26,47,27,20,7,-1
Firmino,256,3,210,2019-01-12T15:00:00Z,False,11,2,90,2,54,28,26,26,18,8,28,8
Firmino,256,3,224,2019-01-19T15:00:00Z,True,11,6,90,8,57,28,29,22,9,13,35,15
Firmino,256,3,236,2019-01-30T20:00:00Z,True,11,10,81,2,60,31,29,31,14,17,29,14
Firmino,256,3,249,2019-02-04T20:00:00Z,False,11,18,74,2,61,32,29,31,17,14,30,12
Firmino,256,3,254,2019-02-09T15:00:00Z,True,11,1,89,5,62,32,30,33,24,9,29,23
Firmino,256,3,267,2019-02-24T14:05:00Z,False,11,13,30,1,65,35,30,51,25,26,14,5
Firmino,256,3,276,2019-02-27T20:00:00Z,True,11,17,0,0,66,35,31,40,20,20,26,15
Firmino,256,3,283,2019-03-03T16:15:00Z,False,11,7,27,1,69,38,31,36,21,15,33,10
Firmino,256,3,296,2019-03-10T12:00:00Z,True,11,3,90,13,70,38,32,30,17,13,40,25
Firmino,256,3,304,2019-03-17T14:15:00Z,False,11,8,71,5,73,41,32,17,15,2,56,17
Firmino,256,3,317,2019-03-31T15:30:00Z,True,11,16,90,8,76,41,35,61,28,33,15,8
Firmino,256,3,326,2019-04-05T19:00:00Z,False,11,15,90,7,79,44,35,33,18,15,46,17
Firmino,256,3,335,2019-04-14T15:30:00Z,True,11,5,90,2,82,44,38,66,38,28,16,16
Firmino,256,3,342,2019-04-21T15:00:00Z,False,11,4,90,2,85,47,38,31,20,11,54,18
Firmino,256,3,355,2019-04-26T19:00:00Z,True,11,9,0,0,88,47,41,14,8,6,74,41
Firmino,256,3,367,2019-05-04T18:45:00Z,False,11,14,0,0,91,50,41,42,25,17,49,16
Firmino,256,3,375,2019-05-12T14:00:00Z,True,11,19,0,0,94,50,44,57,34,23,37,27
Ings,257,3,7,2018-08-12T12:30:00Z,True,15,3,34,1,0,0,0,0,0,0,0,0
Ings,257,3,15,2018-08-18T14:00:00Z,False,15,7,90,7,1,1,0,1,0,1,0,0
Ings,257,3,27,2018-08-25T14:00:00Z,True,15,10,68,2,1,1,0,3,3,0,-2,1
Ings,257,3,34,2018-09-01T14:00:00Z,False,15,6,77,8,1,1,0,3,0,3,-2,0
Ings,257,3,46,2018-09-17T19:00:00Z,True,15,2,83,7,4,1,3,4,4,0,0,1
Ings,257,3,57,2018-09-22T14:00:00Z,False,15,11,0,0,5,2,3,15,6,9,-10,-3
Ings,257,3,69,2018-09-29T14:00:00Z,False,15,19,90,2,5,2,3,9,5,4,-4,-2
Ings,257,3,77,2018-10-07T13:15:00Z,True,15,5,90,1,5,2,3,17,10,7,-12,-5
Ings,257,3,81,2018-10-20T14:00:00Z,False,15,1,78,2,5,2,3,16,10,6,-11,-7
Ings,257,3,97,2018-10-27T14:00:00Z,True,15,14,90,2,6,2,4,2,0,2,4,0
Ings,257,3,106,2018-11-04T15:00:00Z,False,15,12,81,6,7,3,4,26,15,11,-19,-11
Ings,257,3,119,2018-11-10T15:00:00Z,True,15,17,39,6,7,3,4,19,12,7,-12,-4
Ings,257,3,124,2018-11-24T15:00:00Z,False,15,8,0,0,8,4,4,5,4,1,3,0
Ings,257,3,139,2018-12-01T17:30:00Z,True,15,13,0,0,8,4,4,21,11,10,-13,-6
Ings,257,3,149,2018-12-05T20:00:00Z,False,15,16,0,0,9,5,4,30,9,21,-21,-5
Ings,257,3,153,2018-12-08T15:00:00Z,False,15,4,0,0,9,5,4,11,10,1,-2,-6
Ings,257,3,166,2018-12-16T13:30:00Z,True,15,0,70,13,9,5,4,34,20,14,-25,-9
Ings,257,3,175,2018-12-22T15:00:00Z,False,15,9,64,8,12,8,4,10,5,5,2,-1
Ings,257,3,187,2018-12-27T19:45:00Z,True,15,18,61,2,15,8,7,24,13,11,-9,-3
Ings,257,3,197,2018-12-30T14:15:00Z,True,15,12,0,0,15,8,7,44,27,17,-29,-9
Ings,257,3,203,2019-01-02T19:45:00Z,False,15,5,45,1,15,8,7,43,21,22,-28,-14
Ings,257,3,216,2019-01-12T15:00:00Z,False,15,10,0,0,16,8,8,31,14,17,-15,-6
Ings,257,3,227,2019-01-19T15:00:00Z,True,15,7,73,2,19,8,11,30,21,9,-11,-1
Ings,257,3,238,2019-01-30T19:45:00Z,True,15,6,90,2,22,11,11,22,9,13,0,-2
Ings,257,3,241,2019-02-02T15:00:00Z,False,15,3,26,1,23,12,11,23,13,10,0,-2
Ings,257,3,256,2019-02-09T15:00:00Z,True,15,4,0,0,24,12,12,22,17,5,2,7
Ings,257,3,260,2019-02-24T14:05:00Z,False,15,0,0,0,24,12,12,50,32,18,-26,-20
Ings,257,3,279,2019-02-27T19:45:00Z,True,15,8,0,0,24,12,12,17,15,2,7,10
Ings,257,3,285,2019-03-02T15:00:00Z,False,15,13,0,0,27,15,12,55,26,29,-28,-14
Ings,257,3,299,2019-03-09T15:00:00Z,True,15,16,0,0,27,15,12,61,28,33,-34,-18
Ings,257,3,311,2019-03-30T15:00:00Z,False,15,2,66,2,30,18,12,33,22,11,-3,-10
Ings,257,3,326,2019-04-05T19:00:00Z,True,15,11,0,0,33,18,15,79,44,35,-46,-17
Ings,257,3,337,2019-04-13T14:00:00Z,True,15,19,60,5,33,18,15,47,27,20,-14,-2
Ings,257,3,347,2019-04-20T16:30:00Z,False,15,14,75,2,36,21,15,38,22,16,-2,-7
Ings,257,3,307,2019-04-23T18:45:00Z,False,15,17,0,0,36,21,15,49,26,23,-13,-11
Ings,257,3,357,2019-04-27T14:00:00Z,True,15,1,80,2,37,21,16,41,26,15,-4,6
Ings,257,3,368,2019-05-04T14:00:00Z,False,15,18,45,1,38,22,16,46,28,18,-8,-12
Ings,257,3,377,2019-05-12T14:00:00Z,True,15,9,75,5,38,22,16,15,9,6,23,16
Solanke,258,3,4,2018-08-12T12:30:00Z,True,11,18,0,0,0,0,0,0,0,0,0,0
Solanke,258,3,14,2018-08-20T19:00:00Z,False,11,6,0,0,3,3,0,3,0,3,0,0
Solanke,258,3,24,2018-08-25T16:30:00Z,True,11,2,0,0,6,3,3,3,3,0,3,3
Solanke,258,3,36,2018-09-01T11:30:00Z,False,11,10,0,0,9,6,3,6,3,3,3,0
Solanke,258,3,47,2018-09-15T11:30:00Z,False,11,16,0,0,12,6,6,9,3,6,3,3
Solanke,258,3,57,2018-09-22T14:00:00Z,True,11,15,0,0,15,6,9,5,2,3,10,3
Solanke,258,3,63,2018-09-29T16:30:00Z,False,11,5,0,0,18,9,9,16,9,7,2,0
Solanke,258,3,75,2018-10-07T15:30:00Z,True,11,12,0,0,19,9,10,19,12,7,0,2
Solanke,258,3,85,2018-10-20T16:30:00Z,False,11,9,0,0,20,10,10,3,1,2,17,9
Solanke,258,3,95,2018-10-27T14:00:00Z,True,11,4,0,0,23,10,13,5,4,1,18,9
Solanke,258,3,100,2018-11-03T17:30:00Z,False,11,0,0,0,26,13,13,22,12,10,4,1
Solanke,258,3,116,2018-11-11T12:00:00Z,True,11,8,0,0,27,13,14,5,4,1,22,12
Solanke,258,3,127,2018-11-24T15:00:00Z,False,11,17,0,0,30,16,14,20,12,8,10,2
Solanke,258,3,136,2018-12-02T16:15:00Z,True,11,7,0,0,33,16,17,22,16,6,11,10
Solanke,258,3,142,2018-12-05T19:45:00Z,False,11,3,0,0,36,19,17,9,4,5,27,13
Solanke,258,3,151,2018-12-08T12:30:00Z,False,11,1,0,0,39,19,20,23,14,9,16,6
Solanke,258,3,164,2018-12-16T16:00:00Z,True,11,13,0,0,42,19,23,26,15,11,16,8
Solanke,258,3,179,2018-12-21T20:00:00Z,False,11,19,0,0,45,22,23,25,14,11,20,9
Solanke,258,3,185,2018-12-26T15:00:00Z,True,11,14,0,0,48,22,26,17,7,10,31,12
Solanke,258,3,195,2018-12-29T17:30:00Z,True,11,0,0,0,51,25,26,38,23,15,13,10
Solanke,258,3,206,2019-01-03T20:00:00Z,False,11,12,0,0,54,28,26,47,27,20,7,-1
Solanke,258,3,215,2019-01-13T14:15:00Z,False,1,7,0,0,27,18,9,27,18,9,0,-9
Solanke,258,3,221,2019-01-19T15:00:00Z,True,1,18,0,0,27,18,9,31,17,14,-4,4
Solanke,258,3,231,2019-01-30T19:45:00Z,True,1,5,0,0,30,21,9,47,25,22,-17,-1
Solanke,258,3,242,2019-02-02T17:30:00Z,False,1,4,61,2,33,24,9,19,14,5,14,-5
Solanke,258,3,254,2019-02-09T15:00:00Z,False,1,11,31,1,33,24,9,62,32,30,-29,-23
Solanke,258,3,261,2019-02-23T15:00:00Z,True,1,19,90,2,33,24,9,39,21,18,-6,6
Solanke,258,3,270,2019-02-27T19:45:00Z,False,1,0,0,0,34,25,9,53,35,18,-19,-26
Solanke,258,3,280,2019-03-02T15:00:00Z,True,1,12,0,0,34,25,9,68,42,26,-34,-1
Solanke,258,3,294,2019-03-09T15:00:00Z,False,1,9,25,1,34,25,9,14,8,6,20,1
Solanke,258,3,300,2019-03-16T15:00:00Z,True,1,14,15,4,37,25,12,34,22,12,3,13
Solanke,258,3,316,2019-03-30T15:00:00Z,False,1,10,26,1,38,26,12,41,20,21,-3,-8
Solanke,258,3,320,2019-04-06T14:00:00Z,True,1,3,31,1,38,26,12,33,20,13,5,13
Solanke,258,3,330,2019-04-13T14:00:00Z,False,1,2,14,1,38,26,12,33,22,11,5,-10
Solanke,258,3,341,2019-04-20T14:00:00Z,True,1,8,29,1,41,26,15,20,18,2,21,24
Solanke,258,3,357,2019-04-27T14:00:00Z,False,1,15,18,1,41,26,15,37,21,16,4,-6
Solanke,258,3,361,2019-05-04T11:30:00Z,True,1,16,0,0,42,26,16,70,37,33,-28,-7
Solanke,258,3,372,2019-05-12T14:00:00Z,False,1,6,0,0,45,29,16,46,17,29,-1,-1
Ederson,259,0,0,2018-08-12T15:00:00Z,False,12,0,90,8,0,0,0,0,0,0,0,0
Ederson,259,0,17,2018-08-19T12:30:00Z,True,12,9,90,5,3,0,3,0,0,0,3,0
Ederson,259,0,29,2018-08-25T11:30:00Z,False,12,19,90,2,6,3,3,1,1,0,5,2
Ederson,259,0,37,2018-09-01T16:30:00Z,True,12,14,90,2,7,3,4,1,0,1,6,2
Ederson,259,0,44,2018-09-15T14:00:00Z,True,12,8,90,7,10,6,4,4,3,1,6,5
Ederson,259,0,53,2018-09-22T14:00:00Z,False,12,4,90,6,13,9,4,2,1,1,11,3
Ederson,259,0,66,2018-09-29T14:00:00Z,True,12,2,90,6,16,9,7,5,4,1,11,8
Ederson,259,0,75,2018-10-07T15:30:00Z,False,12,11,90,7,19,12,7,19,9,10,0,-2
Ederson,259,0,86,2018-10-20T14:00:00Z,True,12,3,90,6,20,12,8,8,4,4,12,8
Ederson,259,0,98,2018-10-29T20:00:00Z,False,12,16,90,8,23,15,8,21,6,15,2,2
Ederson,259,0,106,2018-11-04T15:00:00Z,True,12,15,90,3,26,15,11,7,3,4,19,11
Ederson,259,0,117,2018-11-11T16:30:00Z,True,12,13,90,2,29,18,11,20,10,10,9,8
Ederson,259,0,128,2018-11-24T15:00:00Z,False,12,18,90,6,32,21,11,12,7,5,20,4
Ederson,259,0,137,2018-12-01T15:00:00Z,True,12,1,90,2,35,21,14,20,11,9,15,12
Ederson,259,0,145,2018-12-04T20:00:00Z,False,12,17,90,2,38,24,14,20,12,8,18,2
Ederson,259,0,154,2018-12-08T17:30:00Z,False,12,5,90,2,41,24,17,31,18,13,10,-1
Ederson,259,0,165,2018-12-15T12:30:00Z,True,12,7,90,2,41,24,17,24,18,6,17,18
Ederson,259,0,176,2018-12-22T15:00:00Z,True,12,6,90,1,44,27,17,15,8,7,29,20
Ederson,259,0,184,2018-12-26T15:00:00Z,False,12,10,90,2,44,27,17,25,11,14,19,6
Ederson,259,0,197,2018-12-30T14:15:00Z,False,12,15,90,3,44,27,17,15,8,7,29,9
Ederson,259,0,206,2019-01-03T20:00:00Z,True,12,11,90,2,47,27,20,54,28,26,-7,1
Ederson,259,0,217,2019-01-14T20:00:00Z,True,12,19,90,6,50,30,20,29,14,15,21,15
Ederson,259,0,223,2019-01-20T13:30:00Z,False,12,9,90,6,53,33,20,11,5,6,42,15
Ederson,259,0,237,2019-01-29T20:00:00Z,False,12,14,90,1,56,33,23,21,10,11,35,13
Ederson,259,0,247,2019-02-03T16:30:00Z,True,12,0,90,2,56,33,23,47,32,15,9,18
Ederson,259,0,265,2019-02-06T19:45:00Z,False,12,7,90,6,59,36,23,33,21,12,26,2
Ederson,259,0,255,2019-02-10T16:00:00Z,True,12,5,90,7,62,36,26,50,28,22,12,14
Ederson,259,0,277,2019-02-27T20:00:00Z,True,12,18,90,6,65,39,26,36,21,15,29,24
Ederson,259,0,280,2019-03-02T15:00:00Z,False,12,1,90,6,68,42,26,34,25,9,34,1
Ederson,259,0,297,2019-03-09T17:30:00Z,True,12,17,90,2,71,42,29,43,23,20,28,22
Ederson,259,0,315,2019-03-30T12:30:00Z,False,12,8,90,6,74,45,29,17,15,2,57,14
Ederson,259,0,324,2019-04-03T18:45:00Z,True,12,4,90,6,77,45,32,28,20,8,49,37
Ederson,259,0,332,2019-04-14T13:05:00Z,False,12,6,90,2,80,48,32,39,16,23,41,16
Ederson,259,0,346,2019-04-20T11:30:00Z,True,12,16,90,9,83,48,35,67,34,33,16,15
Ederson,259,0,305,2019-04-24T19:00:00Z,False,12,13,90,6,86,51,35,64,35,29,22,0
Ederson,259,0,351,2019-04-28T13:05:00Z,False,12,3,90,6,89,51,38,40,23,17,49,15
Ederson,259,0,366,2019-05-06T19:00:00Z,True,12,10,90,6,92,51,41,51,26,25,41,26
Ederson,259,0,370,2019-05-12T14:00:00Z,False,12,2,90,2,95,54,41,36,23,13,59,18
Bravo,260,0,0,2018-08-12T15:00:00Z,False,12,0,0,0,0,0,0,0,0,0,0,0
Bravo,260,0,17,2018-08-19T12:30:00Z,True,12,9,0,0,3,0,3,0,0,0,3,0
Bravo,260,0,29,2018-08-25T11:30:00Z,False,12,19,0,0,6,3,3,1,1,0,5,2
Bravo,260,0,37,2018-09-01T16:30:00Z,True,12,14,0,0,7,3,4,1,0,1,6,2
Bravo,260,0,44,2018-09-15T14:00:00Z,True,12,8,0,0,10,6,4,4,3,1,6,5
Bravo,260,0,53,2018-09-22T14:00:00Z,False,12,4,0,0,13,9,4,2,1,1,11,3
Bravo,260,0,66,2018-09-29T14:00:00Z,True,12,2,0,0,16,9,7,5,4,1,11,8
Bravo,260,0,75,2018-10-07T15:30:00Z,False,12,11,0,0,19,12,7,19,9,10,0,-2
Bravo,260,0,86,2018-10-20T14:00:00Z,True,12,3,0,0,20,12,8,8,4,4,12,8
Bravo,260,0,98,2018-10-29T20:00:00Z,False,12,16,0,0,23,15,8,21,6,15,2,2
Bravo,260,0,106,2018-11-04T15:00:00Z,True,12,15,0,0,26,15,11,7,3,4,19,11
Bravo,260,0,117,2018-11-11T16:30:00Z,True,12,13,0,0,29,18,11,20,10,10,9,8
Bravo,260,0,128,2018-11-24T15:00:00Z,False,12,18,0,0,32,21,11,12,7,5,20,4
Bravo,260,0,137,2018-12-01T15:00:00Z,True,12,1,0,0,35,21,14,20,11,9,15,12
Bravo,260,0,145,2018-12-04T20:00:00Z,False,12,17,0,0,38,24,14,20,12,8,18,2
Bravo,260,0,154,2018-12-08T17:30:00Z,False,12,5,0,0,41,24,17,31,18,13,10,-1
Bravo,260,0,165,2018-12-15T12:30:00Z,True,12,7,0,0,41,24,17,24,18,6,17,18
Bravo,260,0,176,2018-12-22T15:00:00Z,True,12,6,0,0,44,27,17,15,8,7,29,20
Bravo,260,0,184,2018-12-26T15:00:00Z,False,12,10,0,0,44,27,17,25,11,14,19,6
Bravo,260,0,197,2018-12-30T14:15:00Z,False,12,15,0,0,44,27,17,15,8,7,29,9
Bravo,260,0,206,2019-01-03T20:00:00Z,True,12,11,0,0,47,27,20,54,28,26,-7,1
Bravo,260,0,217,2019-01-14T20:00:00Z,True,12,19,0,0,50,30,20,29,14,15,21,15
Bravo,260,0,223,2019-01-20T13:30:00Z,False,12,9,0,0,53,33,20,11,5,6,42,15
Bravo,260,0,237,2019-01-29T20:00:00Z,False,12,14,0,0,56,33,23,21,10,11,35,13
Bravo,260,0,247,2019-02-03T16:30:00Z,True,12,0,0,0,56,33,23,47,32,15,9,18
Bravo,260,0,265,2019-02-06T19:45:00Z,False,12,7,0,0,59,36,23,33,21,12,26,2
Bravo,260,0,255,2019-02-10T16:00:00Z,True,12,5,0,0,62,36,26,50,28,22,12,14
Bravo,260,0,277,2019-02-27T20:00:00Z,True,12,18,0,0,65,39,26,36,21,15,29,24
Bravo,260,0,280,2019-03-02T15:00:00Z,False,12,1,0,0,68,42,26,34,25,9,34,1
Bravo,260,0,297,2019-03-09T17:30:00Z,True,12,17,0,0,71,42,29,43,23,20,28,22
Bravo,260,0,315,2019-03-30T12:30:00Z,False,12,8,0,0,74,45,29,17,15,2,57,14
Bravo,260,0,324,2019-04-03T18:45:00Z,True,12,4,0,0,77,45,32,28,20,8,49,37
Bravo,260,0,332,2019-04-14T13:05:00Z,False,12,6,0,0,80,48,32,39,16,23,41,16
Bravo,260,0,346,2019-04-20T11:30:00Z,True,12,16,0,0,83,48,35,67,34,33,16,15
Bravo,260,0,305,2019-04-24T19:00:00Z,False,12,13,0,0,86,51,35,64,35,29,22,0
Bravo,260,0,351,2019-04-28T13:05:00Z,False,12,3,0,0,89,51,38,40,23,17,49,15
Bravo,260,0,366,2019-05-06T19:00:00Z,True,12,10,0,0,92,51,41,51,26,25,41,26
Bravo,260,0,370,2019-05-12T14:00:00Z,False,12,2,0,0,95,54,41,36,23,13,59,18
Stones,261,1,0,2018-08-12T15:00:00Z,False,12,0,90,8,0,0,0,0,0,0,0,0
Stones,261,1,17,2018-08-19T12:30:00Z,True,12,9,90,2,3,0,3,0,0,0,3,0
Stones,261,1,29,2018-08-25T11:30:00Z,False,12,19,0,0,6,3,3,1,1,0,5,2
Stones,261,1,37,2018-09-01T16:30:00Z,True,12,14,90,2,7,3,4,1,0,1,6,2
Stones,261,1,44,2018-09-15T14:00:00Z,True,12,8,0,0,10,6,4,4,3,1,6,5
Stones,261,1,53,2018-09-22T14:00:00Z,False,12,4,16,1,13,9,4,2,1,1,11,3
Stones,261,1,66,2018-09-29T14:00:00Z,True,12,2,0,0,16,9,7,5,4,1,11,8
Stones,261,1,75,2018-10-07T15:30:00Z,False,12,11,90,8,19,12,7,19,9,10,0,-2
Stones,261,1,86,2018-10-20T14:00:00Z,True,12,3,90,6,20,12,8,8,4,4,12,8
Stones,261,1,98,2018-10-29T20:00:00Z,False,12,16,90,7,23,15,8,21,6,15,2,2
Stones,261,1,106,2018-11-04T15:00:00Z,True,12,15,67,2,26,15,11,7,3,4,19,11
Stones,261,1,117,2018-11-11T16:30:00Z,True,12,13,90,2,29,18,11,20,10,10,9,8
Stones,261,1,128,2018-11-24T15:00:00Z,False,12,18,0,0,32,21,11,12,7,5,20,4
Stones,261,1,137,2018-12-01T15:00:00Z,True,12,1,0,0,35,21,14,20,11,9,15,12
Stones,261,1,145,2018-12-04T20:00:00Z,False,12,17,90,2,38,24,14,20,12,8,18,2
Stones,261,1,154,2018-12-08T17:30:00Z,False,12,5,90,1,41,24,17,31,18,13,10,-1
Stones,261,1,165,2018-12-15T12:30:00Z,True,12,7,0,0,41,24,17,24,18,6,17,18
Stones,261,1,176,2018-12-22T15:00:00Z,True,12,6,90,1,44,27,17,15,8,7,29,20
Stones,261,1,184,2018-12-26T15:00:00Z,False,12,10,90,0,44,27,17,25,11,14,19,6
Stones,261,1,197,2018-12-30T14:15:00Z,False,12,15,0,0,44,27,17,15,8,7,29,9
Stones,261,1,206,2019-01-03T20:00:00Z,True,12,11,90,2,47,27,20,54,28,26,-7,1
Stones,261,1,217,2019-01-14T20:00:00Z,True,12,19,90,8,50,30,20,29,14,15,21,15
Stones,261,1,223,2019-01-20T13:30:00Z,False,12,9,0,0,53,33,20,11,5,6,42,15
Stones,261,1,237,2019-01-29T20:00:00Z,False,12,14,90,1,56,33,23,21,10,11,35,13
Stones,261,1,247,2019-02-03T16:30:00Z,True,12,0,0,0,56,33,23,47,32,15,9,18
Stones,261,1,265,2019-02-06T19:45:00Z,False,12,7,90,6,59,36,23,33,21,12,26,2
Stones,261,1,255,2019-02-10T16:00:00Z,True,12,5,90,6,62,36,26,50,28,22,12,14
Stones,261,1,277,2019-02-27T20:00:00Z,True,12,18,0,0,65,39,26,36,21,15,29,24
Stones,261,1,280,2019-03-02T15:00:00Z,False,12,1,47,1,68,42,26,34,25,9,34,1
Stones,261,1,297,2019-03-09T17:30:00Z,True,12,17,0,0,71,42,29,43,23,20,28,22
Stones,261,1,315,2019-03-30T12:30:00Z,False,12,8,0,0,74,45,29,17,15,2,57,14
Stones,261,1,324,2019-04-03T18:45:00Z,True,12,4,90,6,77,45,32,28,20,8,49,37
Stones,261,1,332,2019-04-14T13:05:00Z,False,12,6,3,1,80,48,32,39,16,23,41,16
Stones,261,1,346,2019-04-20T11:30:00Z,True,12,16,90,8,83,48,35,67,34,33,16,15
Stones,261,1,305,2019-04-24T19:00:00Z,False,12,13,0,0,86,51,35,64,35,29,22,0
Stones,261,1,351,2019-04-28T13:05:00Z,False,12,3,7,1,89,51,38,40,23,17,49,15
Stones,261,1,366,2019-05-06T19:00:00Z,True,12,10,1,1,92,51,41,51,26,25,41,26
Stones,261,1,370,2019-05-12T14:00:00Z,False,12,2,0,0,95,54,41,36,23,13,59,18
Kompany,262,1,0,2018-08-12T15:00:00Z,False,12,0,0,0,0,0,0,0,0,0,0,0
Kompany,262,1,17,2018-08-19T12:30:00Z,True,12,9,90,2,3,0,3,0,0,0,3,0
Kompany,262,1,29,2018-08-25T11:30:00Z,False,12,19,90,1,6,3,3,1,1,0,5,2
Kompany,262,1,37,2018-09-01T16:30:00Z,True,12,14,1,1,7,3,4,1,0,1,6,2
Kompany,262,1,44,2018-09-15T14:00:00Z,True,12,8,0,0,10,6,4,4,3,1,6,5
Kompany,262,1,53,2018-09-22T14:00:00Z,False,12,4,0,0,13,9,4,2,1,1,11,3
Kompany,262,1,66,2018-09-29T14:00:00Z,True,12,2,0,0,16,9,7,5,4,1,11,8
Kompany,262,1,75,2018-10-07T15:30:00Z,False,12,11,0,0,19,12,7,19,9,10,0,-2
Kompany,262,1,86,2018-10-20T14:00:00Z,True,12,3,90,5,20,12,8,8,4,4,12,8
Kompany,262,1,98,2018-10-29T20:00:00Z,False,12,16,1,1,23,15,8,21,6,15,2,2
Kompany,262,1,106,2018-11-04T15:00:00Z,True,12,15,22,1,26,15,11,7,3,4,19,11
Kompany,262,1,117,2018-11-11T16:30:00Z,True,12,13,0,0,29,18,11,20,10,10,9,8
Kompany,262,1,128,2018-11-24T15:00:00Z,False,12,18,0,0,32,21,11,12,7,5,20,4
Kompany,262,1,137,2018-12-01T15:00:00Z,True,12,1,0,0,35,21,14,20,11,9,15,12
Kompany,262,1,145,2018-12-04T20:00:00Z,False,12,17,82,8,38,24,14,20,12,8,18,2
Kompany,262,1,154,2018-12-08T17:30:00Z,False,12,5,0,0,41,24,17,31,18,13,10,-1
Kompany,262,1,165,2018-12-15T12:30:00Z,True,12,7,0,0,41,24,17,24,18,6,17,18
Kompany,262,1,176,2018-12-22T15:00:00Z,True,12,6,0,0,44,27,17,15,8,7,29,20
Kompany,262,1,184,2018-12-26T15:00:00Z,False,12,10,0,0,44,27,17,25,11,14,19,6
Kompany,262,1,197,2018-12-30T14:15:00Z,False,12,15,90,1,44,27,17,15,8,7,29,9
Kompany,262,1,206,2019-01-03T20:00:00Z,True,12,11,87,1,47,27,20,54,28,26,-7,1
Kompany,262,1,217,2019-01-14T20:00:00Z,True,12,19,0,0,50,30,20,29,14,15,21,15
Kompany,262,1,223,2019-01-20T13:30:00Z,False,12,9,0,0,53,33,20,11,5,6,42,15
Kompany,262,1,237,2019-01-29T20:00:00Z,False,12,14,0,0,56,33,23,21,10,11,35,13
Kompany,262,1,247,2019-02-03T16:30:00Z,True,12,0,0,0,56,33,23,47,32,15,9,18
Kompany,262,1,265,2019-02-06T19:45:00Z,False,12,7,0,0,59,36,23,33,21,12,26,2
Kompany,262,1,255,2019-02-10T16:00:00Z,True,12,5,0,0,62,36,26,50,28,22,12,14
Kompany,262,1,277,2019-02-27T20:00:00Z,True,12,18,90,6,65,39,26,36,21,15,29,24
Kompany,262,1,280,2019-03-02T15:00:00Z,False,12,1,42,1,68,42,26,34,25,9,34,1
Kompany,262,1,297,2019-03-09T17:30:00Z,True,12,17,90,2,71,42,29,43,23,20,28,22
Kompany,262,1,315,2019-03-30T12:30:00Z,False,12,8,0,0,74,45,29,17,15,2,57,14
Kompany,262,1,324,2019-04-03T18:45:00Z,True,12,4,0,0,77,45,32,28,20,8,49,37
Kompany,262,1,332,2019-04-14T13:05:00Z,False,12,6,90,2,80,48,32,39,16,23,41,16
Kompany,262,1,346,2019-04-20T11:30:00Z,True,12,16,0,0,83,48,35,67,34,33,16,15
Kompany,262,1,305,2019-04-24T19:00:00Z,False,12,13,90,5,86,51,35,64,35,29,22,0
Kompany,262,1,351,2019-04-28T13:05:00Z,False,12,3,90,6,89,51,38,40,23,17,49,15
Kompany,262,1,366,2019-05-06T19:00:00Z,True,12,10,90,13,92,51,41,51,26,25,41,26
Kompany,262,1,370,2019-05-12T14:00:00Z,False,12,2,85,2,95,54,41,36,23,13,59,18
Otamendi,263,1,0,2018-08-12T15:00:00Z,False,12,0,0,0,0,0,0,0,0,0,0,0
Otamendi,263,1,17,2018-08-19T12:30:00Z,True,12,9,0,0,3,0,3,0,0,0,3,0
Otamendi,263,1,29,2018-08-25T11:30:00Z,False,12,19,0,0,6,3,3,1,1,0,5,2
Otamendi,263,1,37,2018-09-01T16:30:00Z,True,12,14,0,0,7,3,4,1,0,1,6,2
Otamendi,263,1,44,2018-09-15T14:00:00Z,True,12,8,90,6,10,6,4,4,3,1,6,5
Otamendi,263,1,53,2018-09-22T14:00:00Z,False,12,4,90,6,13,9,4,2,1,1,11,3
Otamendi,263,1,66,2018-09-29T14:00:00Z,True,12,2,90,6,16,9,7,5,4,1,11,8
Otamendi,263,1,75,2018-10-07T15:30:00Z,False,12,11,0,0,19,12,7,19,9,10,0,-2
Otamendi,263,1,86,2018-10-20T14:00:00Z,True,12,3,0,0,20,12,8,8,4,4,12,8
Otamendi,263,1,98,2018-10-29T20:00:00Z,False,12,16,0,0,23,15,8,21,6,15,2,2
Otamendi,263,1,106,2018-11-04T15:00:00Z,True,12,15,0,0,26,15,11,7,3,4,19,11
Otamendi,263,1,117,2018-11-11T16:30:00Z,True,12,13,0,0,29,18,11,20,10,10,9,8
Otamendi,263,1,128,2018-11-24T15:00:00Z,False,12,18,90,6,32,21,11,12,7,5,20,4
Otamendi,263,1,137,2018-12-01T15:00:00Z,True,12,1,90,2,35,21,14,20,11,9,15,12
Otamendi,263,1,145,2018-12-04T20:00:00Z,False,12,17,7,1,38,24,14,20,12,8,18,2
Otamendi,263,1,154,2018-12-08T17:30:00Z,False,12,5,0,0,41,24,17,31,18,13,10,-1
Otamendi,263,1,165,2018-12-15T12:30:00Z,True,12,7,90,2,41,24,17,24,18,6,17,18
Otamendi,263,1,176,2018-12-22T15:00:00Z,True,12,6,49,0,44,27,17,15,8,7,29,20
Otamendi,263,1,184,2018-12-26T15:00:00Z,False,12,10,0,0,44,27,17,25,11,14,19,6
Otamendi,263,1,197,2018-12-30T14:15:00Z,False,12,15,0,0,44,27,17,15,8,7,29,9
Otamendi,263,1,206,2019-01-03T20:00:00Z,True,12,11,2,1,47,27,20,54,28,26,-7,1
Otamendi,263,1,217,2019-01-14T20:00:00Z,True,12,19,0,0,50,30,20,29,14,15,21,15
Otamendi,263,1,223,2019-01-20T13:30:00Z,False,12,9,90,6,53,33,20,11,5,6,42,15
Otamendi,263,1,237,2019-01-29T20:00:00Z,False,12,14,0,0,56,33,23,21,10,11,35,13
Otamendi,263,1,247,2019-02-03T16:30:00Z,True,12,0,90,2,56,33,23,47,32,15,9,18
Otamendi,263,1,265,2019-02-06T19:45:00Z,False,12,7,90,7,59,36,23,33,21,12,26,2
Otamendi,263,1,255,2019-02-10T16:00:00Z,True,12,5,0,0,62,36,26,50,28,22,12,14
Otamendi,263,1,277,2019-02-27T20:00:00Z,True,12,18,90,7,65,39,26,36,21,15,29,24
Otamendi,263,1,280,2019-03-02T15:00:00Z,False,12,1,90,8,68,42,26,34,25,9,34,1
Otamendi,263,1,297,2019-03-09T17:30:00Z,True,12,17,90,2,71,42,29,43,23,20,28,22
Otamendi,263,1,315,2019-03-30T12:30:00Z,False,12,8,90,6,74,45,29,17,15,2,57,14
Otamendi,263,1,324,2019-04-03T18:45:00Z,True,12,4,0,0,77,45,32,28,20,8,49,37
Otamendi,263,1,332,2019-04-14T13:05:00Z,False,12,6,0,0,80,48,32,39,16,23,41,16
Otamendi,263,1,346,2019-04-20T11:30:00Z,True,12,16,0,0,83,48,35,67,34,33,16,15
Otamendi,263,1,305,2019-04-24T19:00:00Z,False,12,13,0,0,86,51,35,64,35,29,22,0
Otamendi,263,1,351,2019-04-28T13:05:00Z,False,12,3,1,1,89,51,38,40,23,17,49,15
Otamendi,263,1,366,2019-05-06T19:00:00Z,True,12,10,0,0,92,51,41,51,26,25,41,26
Otamendi,263,1,370,2019-05-12T14:00:00Z,False,12,2,4,1,95,54,41,36,23,13,59,18
Walker,264,1,0,2018-08-12T15:00:00Z,False,12,0,90,7,0,0,0,0,0,0,0,0
Walker,264,1,17,2018-08-19T12:30:00Z,True,12,9,0,0,3,0,3,0,0,0,3,0
Walker,264,1,29,2018-08-25T11:30:00Z,False,12,19,90,2,6,3,3,1,1,0,5,2
Walker,264,1,37,2018-09-01T16:30:00Z,True,12,14,90,10,7,3,4,1,0,1,6,2
Walker,264,1,44,2018-09-15T14:00:00Z,True,12,8,90,6,10,6,4,4,3,1,6,5
Walker,264,1,53,2018-09-22T14:00:00Z,False,12,4,90,6,13,9,4,2,1,1,11,3
Walker,264,1,66,2018-09-29T14:00:00Z,True,12,2,90,7,16,9,7,5,4,1,11,8
Walker,264,1,75,2018-10-07T15:30:00Z,False,12,11,90,6,19,12,7,19,9,10,0,-2
Walker,264,1,86,2018-10-20T14:00:00Z,True,12,3,0,0,20,12,8,8,4,4,12,8
Walker,264,1,98,2018-10-29T20:00:00Z,False,12,16,90,6,23,15,8,21,6,15,2,2
Walker,264,1,106,2018-11-04T15:00:00Z,True,12,15,90,2,26,15,11,7,3,4,19,11
Walker,264,1,117,2018-11-11T16:30:00Z,True,12,13,90,2,29,18,11,20,10,10,9,8
Walker,264,1,128,2018-11-24T15:00:00Z,False,12,18,90,6,32,21,11,12,7,5,20,4
Walker,264,1,137,2018-12-01T15:00:00Z,True,12,1,0,0,35,21,14,20,11,9,15,12
Walker,264,1,145,2018-12-04T20:00:00Z,False,12,17,90,2,38,24,14,20,12,8,18,2
Walker,264,1,154,2018-12-08T17:30:00Z,False,12,5,90,1,41,24,17,31,18,13,10,-1
Walker,264,1,165,2018-12-15T12:30:00Z,True,12,7,90,2,41,24,17,24,18,6,17,18
Walker,264,1,176,2018-12-22T15:00:00Z,True,12,6,90,1,44,27,17,15,8,7,29,20
Walker,264,1,184,2018-12-26T15:00:00Z,False,12,10,0,0,44,27,17,25,11,14,19,6
Walker,264,1,197,2018-12-30T14:15:00Z,False,12,15,4,1,44,27,17,15,8,7,29,9
Walker,264,1,206,2019-01-03T20:00:00Z,True,12,11,4,1,47,27,20,54,28,26,-7,1
Walker,264,1,217,2019-01-14T20:00:00Z,True,12,19,90,6,50,30,20,29,14,15,21,15
Walker,264,1,223,2019-01-20T13:30:00Z,False,12,9,90,8,53,33,20,11,5,6,42,15
Walker,264,1,237,2019-01-29T20:00:00Z,False,12,14,90,1,56,33,23,21,10,11,35,13
Walker,264,1,247,2019-02-03T16:30:00Z,True,12,0,90,2,56,33,23,47,32,15,9,18
Walker,264,1,265,2019-02-06T19:45:00Z,False,12,7,90,8,59,36,23,33,21,12,26,2
Walker,264,1,255,2019-02-10T16:00:00Z,True,12,5,90,6,62,36,26,50,28,22,12,14
Walker,264,1,277,2019-02-27T20:00:00Z,True,12,18,0,0,65,39,26,36,21,15,29,24
Walker,264,1,280,2019-03-02T15:00:00Z,False,12,1,90,5,68,42,26,34,25,9,34,1
Walker,264,1,297,2019-03-09T17:30:00Z,True,12,17,90,1,71,42,29,43,23,20,28,22
Walker,264,1,315,2019-03-30T12:30:00Z,False,12,8,90,6,74,45,29,17,15,2,57,14
Walker,264,1,324,2019-04-03T18:45:00Z,True,12,4,71,6,77,45,32,28,20,8,49,37
Walker,264,1,332,2019-04-14T13:05:00Z,False,12,6,90,2,80,48,32,39,16,23,41,16
Walker,264,1,346,2019-04-20T11:30:00Z,True,12,16,90,6,83,48,35,67,34,33,16,15
Walker,264,1,305,2019-04-24T19:00:00Z,False,12,13,90,7,86,51,35,64,35,29,22,0
Walker,264,1,351,2019-04-28T13:05:00Z,False,12,3,90,9,89,51,38,40,23,17,49,15
Walker,264,1,366,2019-05-06T19:00:00Z,True,12,10,90,7,92,51,41,51,26,25,41,26
Walker,264,1,370,2019-05-12T14:00:00Z,False,12,2,87,2,95,54,41,36,23,13,59,18
Danilo,265,1,0,2018-08-12T15:00:00Z,False,12,0,0,0,0,0,0,0,0,0,0,0
Danilo,265,1,17,2018-08-19T12:30:00Z,True,12,9,0,0,3,0,3,0,0,0,3,0
Danilo,265,1,29,2018-08-25T11:30:00Z,False,12,19,0,0,6,3,3,1,1,0,5,2
Danilo,265,1,37,2018-09-01T16:30:00Z,True,12,14,0,0,7,3,4,1,0,1,6,2
Danilo,265,1,44,2018-09-15T14:00:00Z,True,12,8,0,0,10,6,4,4,3,1,6,5
Danilo,265,1,53,2018-09-22T14:00:00Z,False,12,4,0,0,13,9,4,2,1,1,11,3
Danilo,265,1,66,2018-09-29T14:00:00Z,True,12,2,0,0,16,9,7,5,4,1,11,8
Danilo,265,1,75,2018-10-07T15:30:00Z,False,12,11,0,0,19,12,7,19,9,10,0,-2
Danilo,265,1,86,2018-10-20T14:00:00Z,True,12,3,0,0,20,12,8,8,4,4,12,8
Danilo,265,1,98,2018-10-29T20:00:00Z,False,12,16,0,0,23,15,8,21,6,15,2,2
Danilo,265,1,106,2018-11-04T15:00:00Z,True,12,15,0,0,26,15,11,7,3,4,19,11
Danilo,265,1,117,2018-11-11T16:30:00Z,True,12,13,0,0,29,18,11,20,10,10,9,8
Danilo,265,1,128,2018-11-24T15:00:00Z,False,12,18,0,0,32,21,11,12,7,5,20,4
Danilo,265,1,137,2018-12-01T15:00:00Z,True,12,1,90,2,35,21,14,20,11,9,15,12
Danilo,265,1,145,2018-12-04T20:00:00Z,False,12,17,0,0,38,24,14,20,12,8,18,2
Danilo,265,1,154,2018-12-08T17:30:00Z,False,12,5,0,0,41,24,17,31,18,13,10,-1
Danilo,265,1,165,2018-12-15T12:30:00Z,True,12,7,0,0,41,24,17,24,18,6,17,18
Danilo,265,1,176,2018-12-22T15:00:00Z,True,12,6,0,0,44,27,17,15,8,7,29,20
Danilo,265,1,184,2018-12-26T15:00:00Z,False,12,10,90,1,44,27,17,25,11,14,19,6
Danilo,265,1,197,2018-12-30T14:15:00Z,False,12,15,90,1,44,27,17,15,8,7,29,9
Danilo,265,1,206,2019-01-03T20:00:00Z,True,12,11,90,2,47,27,20,54,28,26,-7,1
Danilo,265,1,217,2019-01-14T20:00:00Z,True,12,19,90,6,50,30,20,29,14,15,21,15
Danilo,265,1,223,2019-01-20T13:30:00Z,False,12,9,90,15,53,33,20,11,5,6,42,15
Danilo,265,1,237,2019-01-29T20:00:00Z,False,12,14,82,1,56,33,23,21,10,11,35,13
Danilo,265,1,247,2019-02-03T16:30:00Z,True,12,0,0,0,56,33,23,47,32,15,9,18
Danilo,265,1,265,2019-02-06T19:45:00Z,False,12,7,0,0,59,36,23,33,21,12,26,2
Danilo,265,1,255,2019-02-10T16:00:00Z,True,12,5,0,0,62,36,26,50,28,22,12,14
Danilo,265,1,277,2019-02-27T20:00:00Z,True,12,18,90,8,65,39,26,36,21,15,29,24
Danilo,265,1,280,2019-03-02T15:00:00Z,False,12,1,0,0,68,42,26,34,25,9,34,1
Danilo,265,1,297,2019-03-09T17:30:00Z,True,12,17,0,0,71,42,29,43,23,20,28,22
Danilo,265,1,315,2019-03-30T12:30:00Z,False,12,8,0,0,74,45,29,17,15,2,57,14
Danilo,265,1,324,2019-04-03T18:45:00Z,True,12,4,90,8,77,45,32,28,20,8,49,37
Danilo,265,1,332,2019-04-14T13:05:00Z,False,12,6,0,0,80,48,32,39,16,23,41,16
Danilo,265,1,346,2019-04-20T11:30:00Z,True,12,16,0,0,83,48,35,67,34,33,16,15
Danilo,265,1,305,2019-04-24T19:00:00Z,False,12,13,1,1,86,51,35,64,35,29,22,0
Danilo,265,1,351,2019-04-28T13:05:00Z,False,12,3,0,0,89,51,38,40,23,17,49,15
Danilo,265,1,366,2019-05-06T19:00:00Z,True,12,10,0,0,92,51,41,51,26,25,41,26
Danilo,265,1,370,2019-05-12T14:00:00Z,False,12,2,2,1,95,54,41,36,23,13,59,18
Mendy,266,1,0,2018-08-12T15:00:00Z,False,12,0,90,15,0,0,0,0,0,0,0,0
Mendy,266,1,17,2018-08-19T12:30:00Z,True,12,9,90,8,3,0,3,0,0,0,3,0
Mendy,266,1,29,2018-08-25T11:30:00Z,False,12,19,90,4,6,3,3,1,1,0,5,2
Mendy,266,1,37,2018-09-01T16:30:00Z,True,12,14,90,5,7,3,4,1,0,1,6,2
Mendy,266,1,44,2018-09-15T14:00:00Z,True,12,8,0,0,10,6,4,4,3,1,6,5
Mendy,266,1,53,2018-09-22T14:00:00Z,False,12,4,0,0,13,9,4,2,1,1,11,3
Mendy,266,1,66,2018-09-29T14:00:00Z,True,12,2,0,0,16,9,7,5,4,1,11,8
Mendy,266,1,75,2018-10-07T15:30:00Z,False,12,11,90,5,19,12,7,19,9,10,0,-2
Mendy,266,1,86,2018-10-20T14:00:00Z,True,12,3,90,10,20,12,8,8,4,4,12,8
Mendy,266,1,98,2018-10-29T20:00:00Z,False,12,16,90,6,23,15,8,21,6,15,2,2
Mendy,266,1,106,2018-11-04T15:00:00Z,True,12,15,90,2,26,15,11,7,3,4,19,11
Mendy,266,1,117,2018-11-11T16:30:00Z,True,12,13,90,2,29,18,11,20,10,10,9,8
Mendy,266,1,128,2018-11-24T15:00:00Z,False,12,18,0,0,32,21,11,12,7,5,20,4
Mendy,266,1,137,2018-12-01T15:00:00Z,True,12,1,0,0,35,21,14,20,11,9,15,12
Mendy,266,1,145,2018-12-04T20:00:00Z,False,12,17,0,0,38,24,14,20,12,8,18,2
Mendy,266,1,154,2018-12-08T17:30:00Z,False,12,5,0,0,41,24,17,31,18,13,10,-1
Mendy,266,1,165,2018-12-15T12:30:00Z,True,12,7,0,0,41,24,17,24,18,6,17,18
Mendy,266,1,176,2018-12-22T15:00:00Z,True,12,6,0,0,44,27,17,15,8,7,29,20
Mendy,266,1,184,2018-12-26T15:00:00Z,False,12,10,0,0,44,27,17,25,11,14,19,6
Mendy,266,1,197,2018-12-30T14:15:00Z,False,12,15,0,0,44,27,17,15,8,7,29,9
Mendy,266,1,206,2019-01-03T20:00:00Z,True,12,11,0,0,47,27,20,54,28,26,-7,1
Mendy,266,1,217,2019-01-14T20:00:00Z,True,12,19,0,0,50,30,20,29,14,15,21,15
Mendy,266,1,223,2019-01-20T13:30:00Z,False,12,9,0,0,53,33,20,11,5,6,42,15
Mendy,266,1,237,2019-01-29T20:00:00Z,False,12,14,0,0,56,33,23,21,10,11,35,13
Mendy,266,1,247,2019-02-03T16:30:00Z,True,12,0,0,0,56,33,23,47,32,15,9,18
Mendy,266,1,265,2019-02-06T19:45:00Z,False,12,7,0,0,59,36,23,33,21,12,26,2
Mendy,266,1,255,2019-02-10T16:00:00Z,True,12,5,0,0,62,36,26,50,28,22,12,14
Mendy,266,1,277,2019-02-27T20:00:00Z,True,12,18,0,0,65,39,26,36,21,15,29,24
Mendy,266,1,280,2019-03-02T15:00:00Z,False,12,1,0,0,68,42,26,34,25,9,34,1
Mendy,266,1,297,2019-03-09T17:30:00Z,True,12,17,0,0,71,42,29,43,23,20,28,22
Mendy,266,1,315,2019-03-30T12:30:00Z,False,12,8,0,0,74,45,29,17,15,2,57,14
Mendy,266,1,324,2019-04-03T18:45:00Z,True,12,4,0,0,77,45,32,28,20,8,49,37
Mendy,266,1,332,2019-04-14T13:05:00Z,False,12,6,90,2,80,48,32,39,16,23,41,16
Mendy,266,1,346,2019-04-20T11:30:00Z,True,12,16,0,0,83,48,35,67,34,33,16,15
Mendy,266,1,305,2019-04-24T19:00:00Z,False,12,13,0,0,86,51,35,64,35,29,22,0
Mendy,266,1,351,2019-04-28T13:05:00Z,False,12,3,0,0,89,51,38,40,23,17,49,15
Mendy,266,1,366,2019-05-06T19:00:00Z,True,12,10,0,0,92,51,41,51,26,25,41,26
Mendy,266,1,370,2019-05-12T14:00:00Z,False,12,2,0,0,95,54,41,36,23,13,59,18
Laporte,267,1,0,2018-08-12T15:00:00Z,False,12,0,90,6,0,0,0,0,0,0,0,0
Laporte,267,1,17,2018-08-19T12:30:00Z,True,12,9,90,2,3,0,3,0,0,0,3,0
Laporte,267,1,29,2018-08-25T11:30:00Z,False,12,19,90,8,6,3,3,1,1,0,5,2
Laporte,267,1,37,2018-09-01T16:30:00Z,True,12,14,90,2,7,3,4,1,0,1,6,2
Laporte,267,1,44,2018-09-15T14:00:00Z,True,12,8,90,6,10,6,4,4,3,1,6,5
Laporte,267,1,53,2018-09-22T14:00:00Z,False,12,4,90,6,13,9,4,2,1,1,11,3
Laporte,267,1,66,2018-09-29T14:00:00Z,True,12,2,90,6,16,9,7,5,4,1,11,8
Laporte,267,1,75,2018-10-07T15:30:00Z,False,12,11,90,6,19,12,7,19,9,10,0,-2
Laporte,267,1,86,2018-10-20T14:00:00Z,True,12,3,90,6,20,12,8,8,4,4,12,8
Laporte,267,1,98,2018-10-29T20:00:00Z,False,12,16,90,6,23,15,8,21,6,15,2,2
Laporte,267,1,106,2018-11-04T15:00:00Z,True,12,15,90,2,26,15,11,7,3,4,19,11
Laporte,267,1,117,2018-11-11T16:30:00Z,True,12,13,90,2,29,18,11,20,10,10,9,8
Laporte,267,1,128,2018-11-24T15:00:00Z,False,12,18,90,6,32,21,11,12,7,5,20,4
Laporte,267,1,137,2018-12-01T15:00:00Z,True,12,1,90,2,35,21,14,20,11,9,15,12
Laporte,267,1,145,2018-12-04T20:00:00Z,False,12,17,1,1,38,24,14,20,12,8,18,2
Laporte,267,1,154,2018-12-08T17:30:00Z,False,12,5,90,1,41,24,17,31,18,13,10,-1
Laporte,267,1,165,2018-12-15T12:30:00Z,True,12,7,90,2,41,24,17,24,18,6,17,18
Laporte,267,1,176,2018-12-22T15:00:00Z,True,12,6,90,1,44,27,17,15,8,7,29,20
Laporte,267,1,184,2018-12-26T15:00:00Z,False,12,10,90,1,44,27,17,25,11,14,19,6
Laporte,267,1,197,2018-12-30T14:15:00Z,False,12,15,90,2,44,27,17,15,8,7,29,9
Laporte,267,1,206,2019-01-03T20:00:00Z,True,12,11,85,1,47,27,20,54,28,26,-7,1
Laporte,267,1,217,2019-01-14T20:00:00Z,True,12,19,90,6,50,30,20,29,14,15,21,15
Laporte,267,1,223,2019-01-20T13:30:00Z,False,12,9,90,6,53,33,20,11,5,6,42,15
Laporte,267,1,237,2019-01-29T20:00:00Z,False,12,14,90,0,56,33,23,21,10,11,35,13
Laporte,267,1,247,2019-02-03T16:30:00Z,True,12,0,90,5,56,33,23,47,32,15,9,18
Laporte,267,1,265,2019-02-06T19:45:00Z,False,12,7,90,15,59,36,23,33,21,12,26,2
Laporte,267,1,255,2019-02-10T16:00:00Z,True,12,5,90,6,62,36,26,50,28,22,12,14
Laporte,267,1,277,2019-02-27T20:00:00Z,True,12,18,0,0,65,39,26,36,21,15,29,24
Laporte,267,1,280,2019-03-02T15:00:00Z,False,12,1,0,0,68,42,26,34,25,9,34,1
Laporte,267,1,297,2019-03-09T17:30:00Z,True,12,17,0,0,71,42,29,43,23,20,28,22
Laporte,267,1,315,2019-03-30T12:30:00Z,False,12,8,90,7,74,45,29,17,15,2,57,14
Laporte,267,1,324,2019-04-03T18:45:00Z,True,12,4,90,11,77,45,32,28,20,8,49,37
Laporte,267,1,332,2019-04-14T13:05:00Z,False,12,6,90,2,80,48,32,39,16,23,41,16
Laporte,267,1,346,2019-04-20T11:30:00Z,True,12,16,90,6,83,48,35,67,34,33,16,15
Laporte,267,1,305,2019-04-24T19:00:00Z,False,12,13,90,9,86,51,35,64,35,29,22,0
Laporte,267,1,351,2019-04-28T13:05:00Z,False,12,3,90,9,89,51,38,40,23,17,49,15
Laporte,267,1,366,2019-05-06T19:00:00Z,True,12,10,90,12,92,51,41,51,26,25,41,26
Laporte,267,1,370,2019-05-12T14:00:00Z,False,12,2,90,8,95,54,41,36,23,13,59,18
Delph,268,1,0,2018-08-12T15:00:00Z,False,12,0,0,0,0,0,0,0,0,0,0,0
Delph,268,1,17,2018-08-19T12:30:00Z,True,12,9,0,0,3,0,3,0,0,0,3,0
Delph,268,1,29,2018-08-25T11:30:00Z,False,12,19,0,0,6,3,3,1,1,0,5,2
Delph,268,1,37,2018-09-01T16:30:00Z,True,12,14,0,0,7,3,4,1,0,1,6,2
Delph,268,1,44,2018-09-15T14:00:00Z,True,12,8,66,8,10,6,4,4,3,1,6,5
Delph,268,1,53,2018-09-22T14:00:00Z,False,12,4,90,6,13,9,4,2,1,1,11,3
Delph,268,1,66,2018-09-29T14:00:00Z,True,12,2,0,0,16,9,7,5,4,1,11,8
Delph,268,1,75,2018-10-07T15:30:00Z,False,12,11,0,0,19,12,7,19,9,10,0,-2
Delph,268,1,86,2018-10-20T14:00:00Z,True,12,3,0,0,20,12,8,8,4,4,12,8
Delph,268,1,98,2018-10-29T20:00:00Z,False,12,16,0,0,23,15,8,21,6,15,2,2
Delph,268,1,106,2018-11-04T15:00:00Z,True,12,15,11,1,26,15,11,7,3,4,19,11
Delph,268,1,117,2018-11-11T16:30:00Z,True,12,13,0,0,29,18,11,20,10,10,9,8
Delph,268,1,128,2018-11-24T15:00:00Z,False,12,18,90,6,32,21,11,12,7,5,20,4
Delph,268,1,137,2018-12-01T15:00:00Z,True,12,1,36,1,35,21,14,20,11,9,15,12
Delph,268,1,145,2018-12-04T20:00:00Z,False,12,17,90,2,38,24,14,20,12,8,18,2
Delph,268,1,154,2018-12-08T17:30:00Z,False,12,5,90,1,41,24,17,31,18,13,10,-1
Delph,268,1,165,2018-12-15T12:30:00Z,True,12,7,90,1,41,24,17,24,18,6,17,18
Delph,268,1,176,2018-12-22T15:00:00Z,True,12,6,61,4,44,27,17,15,8,7,29,20
Delph,268,1,184,2018-12-26T15:00:00Z,False,12,10,88,-2,44,27,17,25,11,14,19,6
Delph,268,1,197,2018-12-30T14:15:00Z,False,12,15,0,0,44,27,17,15,8,7,29,9
Delph,268,1,206,2019-01-03T20:00:00Z,True,12,11,0,0,47,27,20,54,28,26,-7,1
Delph,268,1,217,2019-01-14T20:00:00Z,True,12,19,0,0,50,30,20,29,14,15,21,15
Delph,268,1,223,2019-01-20T13:30:00Z,False,12,9,10,1,53,33,20,11,5,6,42,15
Delph,268,1,237,2019-01-29T20:00:00Z,False,12,14,0,0,56,33,23,21,10,11,35,13
Delph,268,1,247,2019-02-03T16:30:00Z,True,12,0,0,0,56,33,23,47,32,15,9,18
Delph,268,1,265,2019-02-06T19:45:00Z,False,12,7,0,0,59,36,23,33,21,12,26,2
Delph,268,1,255,2019-02-10T16:00:00Z,True,12,5,0,0,62,36,26,50,28,22,12,14
Delph,268,1,277,2019-02-27T20:00:00Z,True,12,18,0,0,65,39,26,36,21,15,29,24
Delph,268,1,280,2019-03-02T15:00:00Z,False,12,1,0,0,68,42,26,34,25,9,34,1
Delph,268,1,297,2019-03-09T17:30:00Z,True,12,17,0,0,71,42,29,43,23,20,28,22
Delph,268,1,315,2019-03-30T12:30:00Z,False,12,8,0,0,74,45,29,17,15,2,57,14
Delph,268,1,324,2019-04-03T18:45:00Z,True,12,4,0,0,77,45,32,28,20,8,49,37
Delph,268,1,332,2019-04-14T13:05:00Z,False,12,6,0,0,80,48,32,39,16,23,41,16
Delph,268,1,346,2019-04-20T11:30:00Z,True,12,16,0,0,83,48,35,67,34,33,16,15
Delph,268,1,305,2019-04-24T19:00:00Z,False,12,13,0,0,86,51,35,64,35,29,22,0
Delph,268,1,351,2019-04-28T13:05:00Z,False,12,3,0,0,89,51,38,40,23,17,49,15
Delph,268,1,366,2019-05-06T19:00:00Z,True,12,10,0,0,92,51,41,51,26,25,41,26
Delph,268,1,370,2019-05-12T14:00:00Z,False,12,2,0,0,95,54,41,36,23,13,59,18
Sterling,269,2,0,2018-08-12T15:00:00Z,False,12,0,86,7,0,0,0,0,0,0,0,0
Sterling,269,2,17,2018-08-19T12:30:00Z,True,12,9,0,0,3,0,3,0,0,0,3,0
Sterling,269,2,29,2018-08-25T11:30:00Z,False,12,19,84,2,6,3,3,1,1,0,5,2
Sterling,269,2,37,2018-09-01T16:30:00Z,True,12,14,90,10,7,3,4,1,0,1,6,2
Sterling,269,2,44,2018-09-15T14:00:00Z,True,12,8,73,8,10,6,4,4,3,1,6,5
Sterling,269,2,53,2018-09-22T14:00:00Z,False,12,4,90,6,13,9,4,2,1,1,11,3
Sterling,269,2,66,2018-09-29T14:00:00Z,True,12,2,90,14,16,9,7,5,4,1,11,8
Sterling,269,2,75,2018-10-07T15:30:00Z,False,12,11,75,3,19,12,7,19,9,10,0,-2
Sterling,269,2,86,2018-10-20T14:00:00Z,True,12,3,0,0,20,12,8,8,4,4,12,8
Sterling,269,2,98,2018-10-29T20:00:00Z,False,12,16,90,6,23,15,8,21,6,15,2,2
Sterling,269,2,106,2018-11-04T15:00:00Z,True,12,15,90,21,26,15,11,7,3,4,19,11
Sterling,269,2,117,2018-11-11T16:30:00Z,True,12,13,90,2,29,18,11,20,10,10,9,8
Sterling,269,2,128,2018-11-24T15:00:00Z,False,12,18,73,16,32,21,11,12,7,5,20,4
Sterling,269,2,137,2018-12-01T15:00:00Z,True,12,1,90,9,35,21,14,20,11,9,15,12
Sterling,269,2,145,2018-12-04T20:00:00Z,False,12,17,0,0,38,24,14,20,12,8,18,2
Sterling,269,2,154,2018-12-08T17:30:00Z,False,12,5,90,2,41,24,17,31,18,13,10,-1
Sterling,269,2,165,2018-12-15T12:30:00Z,True,12,7,24,6,41,24,17,24,18,6,17,18
Sterling,269,2,176,2018-12-22T15:00:00Z,True,12,6,68,2,44,27,17,15,8,7,29,20
Sterling,269,2,184,2018-12-26T15:00:00Z,False,12,10,90,2,44,27,17,25,11,14,19,6
Sterling,269,2,197,2018-12-30T14:15:00Z,False,12,15,90,6,44,27,17,15,8,7,29,9
Sterling,269,2,206,2019-01-03T20:00:00Z,True,12,11,90,5,47,27,20,54,28,26,-7,1
Sterling,269,2,217,2019-01-14T20:00:00Z,True,12,19,90,6,50,30,20,29,14,15,21,15
Sterling,269,2,223,2019-01-20T13:30:00Z,False,12,9,90,10,53,33,20,11,5,6,42,15
Sterling,269,2,237,2019-01-29T20:00:00Z,False,12,14,90,1,56,33,23,21,10,11,35,13
Sterling,269,2,247,2019-02-03T16:30:00Z,True,12,0,90,10,56,33,23,47,32,15,9,18
Sterling,269,2,265,2019-02-06T19:45:00Z,False,12,7,31,1,59,36,23,33,21,12,26,2
Sterling,269,2,255,2019-02-10T16:00:00Z,True,12,5,90,18,62,36,26,50,28,22,12,14
Sterling,269,2,277,2019-02-27T20:00:00Z,True,12,18,35,1,65,39,26,36,21,15,29,24
Sterling,269,2,280,2019-03-02T15:00:00Z,False,12,1,90,3,68,42,26,34,25,9,34,1
Sterling,269,2,297,2019-03-09T17:30:00Z,True,12,17,64,21,71,42,29,43,23,20,28,22
Sterling,269,2,315,2019-03-30T12:30:00Z,False,12,8,87,3,74,45,29,17,15,2,57,14
Sterling,269,2,324,2019-04-03T18:45:00Z,True,12,4,0,0,77,45,32,28,20,8,49,37
Sterling,269,2,332,2019-04-14T13:05:00Z,False,12,6,90,14,80,48,32,39,16,23,41,16
Sterling,269,2,346,2019-04-20T11:30:00Z,True,12,16,90,2,83,48,35,67,34,33,16,15
Sterling,269,2,305,2019-04-24T19:00:00Z,False,12,13,90,6,86,51,35,64,35,29,22,0
Sterling,269,2,351,2019-04-28T13:05:00Z,False,12,3,90,3,89,51,38,40,23,17,49,15
Sterling,269,2,366,2019-05-06T19:00:00Z,True,12,10,90,3,92,51,41,51,26,25,41,26
Sterling,269,2,370,2019-05-12T14:00:00Z,False,12,2,90,5,95,54,41,36,23,13,59,18
David Silva,270,2,0,2018-08-12T15:00:00Z,False,12,0,0,0,0,0,0,0,0,0,0,0
David Silva,270,2,17,2018-08-19T12:30:00Z,True,12,9,63,9,3,0,3,0,0,0,3,0
David Silva,270,2,29,2018-08-25T11:30:00Z,False,12,19,90,1,6,3,3,1,1,0,5,2
David Silva,270,2,37,2018-09-01T16:30:00Z,True,12,14,89,2,7,3,4,1,0,1,6,2
David Silva,270,2,44,2018-09-15T14:00:00Z,True,12,8,90,11,10,6,4,4,3,1,6,5
David Silva,270,2,53,2018-09-22T14:00:00Z,False,12,4,0,0,13,9,4,2,1,1,11,3
David Silva,270,2,66,2018-09-29T14:00:00Z,True,12,2,87,3,16,9,7,5,4,1,11,8
David Silva,270,2,75,2018-10-07T15:30:00Z,False,12,11,90,3,19,12,7,19,9,10,0,-2
David Silva,270,2,86,2018-10-20T14:00:00Z,True,12,3,74,9,20,12,8,8,4,4,12,8
David Silva,270,2,98,2018-10-29T20:00:00Z,False,12,16,88,3,23,15,8,21,6,15,2,2
David Silva,270,2,106,2018-11-04T15:00:00Z,True,12,15,71,7,26,15,11,7,3,4,19,11
David Silva,270,2,117,2018-11-11T16:30:00Z,True,12,13,90,9,29,18,11,20,10,10,9,8
David Silva,270,2,128,2018-11-24T15:00:00Z,False,12,18,90,9,32,21,11,12,7,5,20,4
David Silva,270,2,137,2018-12-01T15:00:00Z,True,12,1,13,1,35,21,14,20,11,9,15,12
David Silva,270,2,145,2018-12-04T20:00:00Z,False,12,17,72,3,38,24,14,20,12,8,18,2
David Silva,270,2,154,2018-12-08T17:30:00Z,False,12,5,67,2,41,24,17,31,18,13,10,-1
David Silva,270,2,165,2018-12-15T12:30:00Z,True,12,7,0,0,41,24,17,24,18,6,17,18
David Silva,270,2,176,2018-12-22T15:00:00Z,True,12,6,0,0,44,27,17,15,8,7,29,20
David Silva,270,2,184,2018-12-26T15:00:00Z,False,12,10,20,1,44,27,17,25,11,14,19,6
David Silva,270,2,197,2018-12-30T14:15:00Z,False,12,15,90,10,44,27,17,15,8,7,29,9
David Silva,270,2,206,2019-01-03T20:00:00Z,True,12,11,64,2,47,27,20,54,28,26,-7,1
David Silva,270,2,217,2019-01-14T20:00:00Z,True,12,19,61,3,50,30,20,29,14,15,21,15
David Silva,270,2,223,2019-01-20T13:30:00Z,False,12,9,31,1,53,33,20,11,5,6,42,15
David Silva,270,2,237,2019-01-29T20:00:00Z,False,12,14,90,5,56,33,23,21,10,11,35,13
David Silva,270,2,247,2019-02-03T16:30:00Z,True,12,0,90,2,56,33,23,47,32,15,9,18
David Silva,270,2,265,2019-02-06T19:45:00Z,False,12,7,88,6,59,36,23,33,21,12,26,2
David Silva,270,2,255,2019-02-10T16:00:00Z,True,12,5,15,1,62,36,26,50,28,22,12,14
David Silva,270,2,277,2019-02-27T20:00:00Z,True,12,18,90,3,65,39,26,36,21,15,29,24
David Silva,270,2,280,2019-03-02T15:00:00Z,False,12,1,90,7,68,42,26,34,25,9,34,1
David Silva,270,2,297,2019-03-09T17:30:00Z,True,12,17,90,6,71,42,29,43,23,20,28,22
David Silva,270,2,315,2019-03-30T12:30:00Z,False,12,8,90,3,74,45,29,17,15,2,57,14
David Silva,270,2,324,2019-04-03T18:45:00Z,True,12,4,0,0,77,45,32,28,20,8,49,37
David Silva,270,2,332,2019-04-14T13:05:00Z,False,12,6,64,3,80,48,32,39,16,23,41,16
David Silva,270,2,346,2019-04-20T11:30:00Z,True,12,16,5,1,83,48,35,67,34,33,16,15
David Silva,270,2,305,2019-04-24T19:00:00Z,False,12,13,90,3,86,51,35,64,35,29,22,0
David Silva,270,2,351,2019-04-28T13:05:00Z,False,12,3,90,3,89,51,38,40,23,17,49,15
David Silva,270,2,366,2019-05-06T19:00:00Z,True,12,10,90,2,92,51,41,51,26,25,41,26
David Silva,270,2,370,2019-05-12T14:00:00Z,False,12,2,77,9,95,54,41,36,23,13,59,18
Fernandinho,271,2,0,2018-08-12T15:00:00Z,False,12,0,90,3,0,0,0,0,0,0,0,0
Fernandinho,271,2,17,2018-08-19T12:30:00Z,True,12,9,90,2,3,0,3,0,0,0,3,0
Fernandinho,271,2,29,2018-08-25T11:30:00Z,False,12,19,90,2,6,3,3,1,1,0,5,2
Fernandinho,271,2,37,2018-09-01T16:30:00Z,True,12,14,90,2,7,3,4,1,0,1,6,2
Fernandinho,271,2,44,2018-09-15T14:00:00Z,True,12,8,90,6,10,6,4,4,3,1,6,5
Fernandinho,271,2,53,2018-09-22T14:00:00Z,False,12,4,73,2,13,9,4,2,1,1,11,3
Fernandinho,271,2,66,2018-09-29T14:00:00Z,True,12,2,90,3,16,9,7,5,4,1,11,8
Fernandinho,271,2,75,2018-10-07T15:30:00Z,False,12,11,90,3,19,12,7,19,9,10,0,-2
Fernandinho,271,2,86,2018-10-20T14:00:00Z,True,12,3,90,14,20,12,8,8,4,4,12,8
Fernandinho,271,2,98,2018-10-29T20:00:00Z,False,12,16,90,2,23,15,8,21,6,15,2,2
Fernandinho,271,2,106,2018-11-04T15:00:00Z,True,12,15,78,2,26,15,11,7,3,4,19,11
Fernandinho,271,2,117,2018-11-11T16:30:00Z,True,12,13,90,2,29,18,11,20,10,10,9,8
Fernandinho,271,2,128,2018-11-24T15:00:00Z,False,12,18,90,3,32,21,11,12,7,5,20,4
Fernandinho,271,2,137,2018-12-01T15:00:00Z,True,12,1,90,2,35,21,14,20,11,9,15,12
Fernandinho,271,2,145,2018-12-04T20:00:00Z,False,12,17,90,2,38,24,14,20,12,8,18,2
Fernandinho,271,2,154,2018-12-08T17:30:00Z,False,12,5,90,2,41,24,17,31,18,13,10,-1
Fernandinho,271,2,165,2018-12-15T12:30:00Z,True,12,7,90,6,41,24,17,24,18,6,17,18
Fernandinho,271,2,176,2018-12-22T15:00:00Z,True,12,6,0,0,44,27,17,15,8,7,29,20
Fernandinho,271,2,184,2018-12-26T15:00:00Z,False,12,10,0,0,44,27,17,25,11,14,19,6
Fernandinho,271,2,197,2018-12-30T14:15:00Z,False,12,15,85,2,44,27,17,15,8,7,29,9
Fernandinho,271,2,206,2019-01-03T20:00:00Z,True,12,11,90,2,47,27,20,54,28,26,-7,1
Fernandinho,271,2,217,2019-01-14T20:00:00Z,True,12,19,90,2,50,30,20,29,14,15,21,15
Fernandinho,271,2,223,2019-01-20T13:30:00Z,False,12,9,58,0,53,33,20,11,5,6,42,15
Fernandinho,271,2,237,2019-01-29T20:00:00Z,False,12,14,90,2,56,33,23,21,10,11,35,13
Fernandinho,271,2,247,2019-02-03T16:30:00Z,True,12,0,90,2,56,33,23,47,32,15,9,18
Fernandinho,271,2,265,2019-02-06T19:45:00Z,False,12,7,90,2,59,36,23,33,21,12,26,2
Fernandinho,271,2,255,2019-02-10T16:00:00Z,True,12,5,74,3,62,36,26,50,28,22,12,14
Fernandinho,271,2,277,2019-02-27T20:00:00Z,True,12,18,0,0,65,39,26,36,21,15,29,24
Fernandinho,271,2,280,2019-03-02T15:00:00Z,False,12,1,0,0,68,42,26,34,25,9,34,1
Fernandinho,271,2,297,2019-03-09T17:30:00Z,True,12,17,0,0,71,42,29,43,23,20,28,22
Fernandinho,271,2,315,2019-03-30T12:30:00Z,False,12,8,15,1,74,45,29,17,15,2,57,14
Fernandinho,271,2,324,2019-04-03T18:45:00Z,True,12,4,90,3,77,45,32,28,20,8,49,37
Fernandinho,271,2,332,2019-04-14T13:05:00Z,False,12,6,0,0,80,48,32,39,16,23,41,16
Fernandinho,271,2,346,2019-04-20T11:30:00Z,True,12,16,52,1,83,48,35,67,34,33,16,15
Fernandinho,271,2,305,2019-04-24T19:00:00Z,False,12,13,50,1,86,51,35,64,35,29,22,0
Fernandinho,271,2,351,2019-04-28T13:05:00Z,False,12,3,0,0,89,51,38,40,23,17,49,15
Fernandinho,271,2,366,2019-05-06T19:00:00Z,True,12,10,0,0,92,51,41,51,26,25,41,26
Fernandinho,271,2,370,2019-05-12T14:00:00Z,False,12,2,0,0,95,54,41,36,23,13,59,18
De Bruyne,272,2,0,2018-08-12T15:00:00Z,False,12,0,30,0,0,0,0,0,0,0,0,0
De Bruyne,272,2,17,2018-08-19T12:30:00Z,True,12,9,0,0,3,0,3,0,0,0,3,0
De Bruyne,272,2,29,2018-08-25T11:30:00Z,False,12,19,0,0,6,3,3,1,1,0,5,2
De Bruyne,272,2,37,2018-09-01T16:30:00Z,True,12,14,0,0,7,3,4,1,0,1,6,2
De Bruyne,272,2,44,2018-09-15T14:00:00Z,True,12,8,0,0,10,6,4,4,3,1,6,5
De Bruyne,272,2,53,2018-09-22T14:00:00Z,False,12,4,0,0,13,9,4,2,1,1,11,3
De Bruyne,272,2,66,2018-09-29T14:00:00Z,True,12,2,0,0,16,9,7,5,4,1,11,8
De Bruyne,272,2,75,2018-10-07T15:30:00Z,False,12,11,0,0,19,12,7,19,9,10,0,-2
De Bruyne,272,2,86,2018-10-20T14:00:00Z,True,12,3,32,1,20,12,8,8,4,4,12,8
De Bruyne,272,2,98,2018-10-29T20:00:00Z,False,12,16,19,1,23,15,8,21,6,15,2,2
De Bruyne,272,2,106,2018-11-04T15:00:00Z,True,12,15,0,0,26,15,11,7,3,4,19,11
De Bruyne,272,2,117,2018-11-11T16:30:00Z,True,12,13,0,0,29,18,11,20,10,10,9,8
De Bruyne,272,2,128,2018-11-24T15:00:00Z,False,12,18,0,0,32,21,11,12,7,5,20,4
De Bruyne,272,2,137,2018-12-01T15:00:00Z,True,12,1,0,0,35,21,14,20,11,9,15,12
De Bruyne,272,2,145,2018-12-04T20:00:00Z,False,12,17,0,0,38,24,14,20,12,8,18,2
De Bruyne,272,2,154,2018-12-08T17:30:00Z,False,12,5,0,0,41,24,17,31,18,13,10,-1
De Bruyne,272,2,165,2018-12-15T12:30:00Z,True,12,7,15,1,41,24,17,24,18,6,17,18
De Bruyne,272,2,176,2018-12-22T15:00:00Z,True,12,6,28,8,44,27,17,15,8,7,29,20
De Bruyne,272,2,184,2018-12-26T15:00:00Z,False,12,10,69,2,44,27,17,25,11,14,19,6
De Bruyne,272,2,197,2018-12-30T14:15:00Z,False,12,15,0,0,44,27,17,15,8,7,29,9
De Bruyne,272,2,206,2019-01-03T20:00:00Z,True,12,11,0,0,47,27,20,54,28,26,-7,1
De Bruyne,272,2,217,2019-01-14T20:00:00Z,True,12,19,28,4,50,30,20,29,14,15,21,15
De Bruyne,272,2,223,2019-01-20T13:30:00Z,False,12,9,90,3,53,33,20,11,5,6,42,15
De Bruyne,272,2,237,2019-01-29T20:00:00Z,False,12,14,64,2,56,33,23,21,10,11,35,13
De Bruyne,272,2,247,2019-02-03T16:30:00Z,True,12,0,87,2,56,33,23,47,32,15,9,18
De Bruyne,272,2,265,2019-02-06T19:45:00Z,False,12,7,1,1,59,36,23,33,21,12,26,2
De Bruyne,272,2,255,2019-02-10T16:00:00Z,True,12,5,67,3,62,36,26,50,28,22,12,14
De Bruyne,272,2,277,2019-02-27T20:00:00Z,True,12,18,90,3,65,39,26,36,21,15,29,24
De Bruyne,272,2,280,2019-03-02T15:00:00Z,False,12,1,45,1,68,42,26,34,25,9,34,1
De Bruyne,272,2,297,2019-03-09T17:30:00Z,True,12,17,0,0,71,42,29,43,23,20,28,22
De Bruyne,272,2,315,2019-03-30T12:30:00Z,False,12,8,74,3,74,45,29,17,15,2,57,14
De Bruyne,272,2,324,2019-04-03T18:45:00Z,True,12,4,90,11,77,45,32,28,20,8,49,37
De Bruyne,272,2,332,2019-04-14T13:05:00Z,False,12,6,90,11,80,48,32,39,16,23,41,16
De Bruyne,272,2,346,2019-04-20T11:30:00Z,True,12,16,37,1,83,48,35,67,34,33,16,15
De Bruyne,272,2,305,2019-04-24T19:00:00Z,False,12,13,0,0,86,51,35,64,35,29,22,0
De Bruyne,272,2,351,2019-04-28T13:05:00Z,False,12,3,0,0,89,51,38,40,23,17,49,15
De Bruyne,272,2,366,2019-05-06T19:00:00Z,True,12,10,0,0,92,51,41,51,26,25,41,26
De Bruyne,272,2,370,2019-05-12T14:00:00Z,False,12,2,12,1,95,54,41,36,23,13,59,18
Gundogan,273,2,0,2018-08-12T15:00:00Z,False,12,0,90,3,0,0,0,0,0,0,0,0
Gundogan,273,2,17,2018-08-19T12:30:00Z,True,12,9,81,2,3,0,3,0,0,0,3,0
Gundogan,273,2,29,2018-08-25T11:30:00Z,False,12,19,76,8,6,3,3,1,1,0,5,2
Gundogan,273,2,37,2018-09-01T16:30:00Z,True,12,14,14,1,7,3,4,1,0,1,6,2
Gundogan,273,2,44,2018-09-15T14:00:00Z,True,12,8,23,1,10,6,4,4,3,1,6,5
Gundogan,273,2,53,2018-09-22T14:00:00Z,False,12,4,68,13,13,9,4,2,1,1,11,3
Gundogan,273,2,66,2018-09-29T14:00:00Z,True,12,2,0,0,16,9,7,5,4,1,11,8
Gundogan,273,2,75,2018-10-07T15:30:00Z,False,12,11,0,0,19,12,7,19,9,10,0,-2
Gundogan,273,2,86,2018-10-20T14:00:00Z,True,12,3,0,0,20,12,8,8,4,4,12,8
Gundogan,273,2,98,2018-10-29T20:00:00Z,False,12,16,0,0,23,15,8,21,6,15,2,2
Gundogan,273,2,106,2018-11-04T15:00:00Z,True,12,15,0,0,26,15,11,7,3,4,19,11
Gundogan,273,2,117,2018-11-11T16:30:00Z,True,12,13,15,6,29,18,11,20,10,10,9,8
Gundogan,273,2,128,2018-11-24T15:00:00Z,False,12,18,68,3,32,21,11,12,7,5,20,4
Gundogan,273,2,137,2018-12-01T15:00:00Z,True,12,1,90,10,35,21,14,20,11,9,15,12
Gundogan,273,2,145,2018-12-04T20:00:00Z,False,12,17,17,1,38,24,14,20,12,8,18,2
Gundogan,273,2,154,2018-12-08T17:30:00Z,False,12,5,22,1,41,24,17,31,18,13,10,-1
Gundogan,273,2,165,2018-12-15T12:30:00Z,True,12,7,90,2,41,24,17,24,18,6,17,18
Gundogan,273,2,176,2018-12-22T15:00:00Z,True,12,6,90,7,44,27,17,15,8,7,29,20
Gundogan,273,2,184,2018-12-26T15:00:00Z,False,12,10,90,2,44,27,17,25,11,14,19,6
Gundogan,273,2,197,2018-12-30T14:15:00Z,False,12,15,0,0,44,27,17,15,8,7,29,9
Gundogan,273,2,206,2019-01-03T20:00:00Z,True,12,11,25,1,47,27,20,54,28,26,-7,1
Gundogan,273,2,217,2019-01-14T20:00:00Z,True,12,19,16,1,50,30,20,29,14,15,21,15
Gundogan,273,2,223,2019-01-20T13:30:00Z,False,12,9,79,3,53,33,20,11,5,6,42,15
Gundogan,273,2,237,2019-01-29T20:00:00Z,False,12,14,7,1,56,33,23,21,10,11,35,13
Gundogan,273,2,247,2019-02-03T16:30:00Z,True,12,0,90,1,56,33,23,47,32,15,9,18
Gundogan,273,2,265,2019-02-06T19:45:00Z,False,12,7,90,3,59,36,23,33,21,12,26,2
Gundogan,273,2,255,2019-02-10T16:00:00Z,True,12,5,90,7,62,36,26,50,28,22,12,14
Gundogan,273,2,277,2019-02-27T20:00:00Z,True,12,18,90,3,65,39,26,36,21,15,29,24
Gundogan,273,2,280,2019-03-02T15:00:00Z,False,12,1,90,3,68,42,26,34,25,9,34,1
Gundogan,273,2,297,2019-03-09T17:30:00Z,True,12,17,90,2,71,42,29,43,23,20,28,22
Gundogan,273,2,315,2019-03-30T12:30:00Z,False,12,8,90,3,74,45,29,17,15,2,57,14
Gundogan,273,2,324,2019-04-03T18:45:00Z,True,12,4,0,0,77,45,32,28,20,8,49,37
Gundogan,273,2,332,2019-04-14T13:05:00Z,False,12,6,90,2,80,48,32,39,16,23,41,16
Gundogan,273,2,346,2019-04-20T11:30:00Z,True,12,16,90,3,83,48,35,67,34,33,16,15
Gundogan,273,2,305,2019-04-24T19:00:00Z,False,12,13,88,6,86,51,35,64,35,29,22,0
Gundogan,273,2,351,2019-04-28T13:05:00Z,False,12,3,90,2,89,51,38,40,23,17,49,15
Gundogan,273,2,366,2019-05-06T19:00:00Z,True,12,10,90,3,92,51,41,51,26,25,41,26
Gundogan,273,2,370,2019-05-12T14:00:00Z,False,12,2,90,9,95,54,41,36,23,13,59,18
Sane,274,2,0,2018-08-12T15:00:00Z,False,12,0,3,1,0,0,0,0,0,0,0,0
Sane,274,2,17,2018-08-19T12:30:00Z,True,12,9,14,4,3,0,3,0,0,0,3,0
Sane,274,2,29,2018-08-25T11:30:00Z,False,12,19,13,1,6,3,3,1,1,0,5,2
Sane,274,2,37,2018-09-01T16:30:00Z,True,12,14,0,0,7,3,4,1,0,1,6,2
Sane,274,2,44,2018-09-15T14:00:00Z,True,12,8,90,9,10,6,4,4,3,1,6,5
Sane,274,2,53,2018-09-22T14:00:00Z,False,12,4,90,6,13,9,4,2,1,1,11,3
Sane,274,2,66,2018-09-29T14:00:00Z,True,12,2,70,6,16,9,7,5,4,1,11,8
Sane,274,2,75,2018-10-07T15:30:00Z,False,12,11,14,1,19,12,7,19,9,10,0,-2
Sane,274,2,86,2018-10-20T14:00:00Z,True,12,3,90,7,20,12,8,8,4,4,12,8
Sane,274,2,98,2018-10-29T20:00:00Z,False,12,16,0,0,23,15,8,21,6,15,2,2
Sane,274,2,106,2018-11-04T15:00:00Z,True,12,15,90,14,26,15,11,7,3,4,19,11
Sane,274,2,117,2018-11-11T16:30:00Z,True,12,13,28,1,29,18,11,20,10,10,9,8
Sane,274,2,128,2018-11-24T15:00:00Z,False,12,18,90,19,32,21,11,12,7,5,20,4
Sane,274,2,137,2018-12-01T15:00:00Z,True,12,1,90,5,35,21,14,20,11,9,15,12
Sane,274,2,145,2018-12-04T20:00:00Z,False,12,17,90,7,38,24,14,20,12,8,18,2
Sane,274,2,154,2018-12-08T17:30:00Z,False,12,5,52,1,41,24,17,31,18,13,10,-1
Sane,274,2,165,2018-12-15T12:30:00Z,True,12,7,65,10,41,24,17,24,18,6,17,18
Sane,274,2,176,2018-12-22T15:00:00Z,True,12,6,90,2,44,27,17,15,8,7,29,20
Sane,274,2,184,2018-12-26T15:00:00Z,False,12,10,90,2,44,27,17,25,11,14,19,6
Sane,274,2,197,2018-12-30T14:15:00Z,False,12,15,6,1,44,27,17,15,8,7,29,9
Sane,274,2,206,2019-01-03T20:00:00Z,True,12,11,90,10,47,27,20,54,28,26,-7,1
Sane,274,2,217,2019-01-14T20:00:00Z,True,12,19,73,8,50,30,20,29,14,15,21,15
Sane,274,2,223,2019-01-20T13:30:00Z,False,12,9,71,12,53,33,20,11,5,6,42,15
Sane,274,2,237,2019-01-29T20:00:00Z,False,12,14,72,2,56,33,23,21,10,11,35,13
Sane,274,2,247,2019-02-03T16:30:00Z,True,12,0,0,0,56,33,23,47,32,15,9,18
Sane,274,2,265,2019-02-06T19:45:00Z,False,12,7,58,1,59,36,23,33,21,12,26,2
Sane,274,2,255,2019-02-10T16:00:00Z,True,12,5,0,0,62,36,26,50,28,22,12,14
Sane,274,2,277,2019-02-27T20:00:00Z,True,12,18,56,1,65,39,26,36,21,15,29,24
Sane,274,2,280,2019-03-02T15:00:00Z,False,12,1,0,0,68,42,26,34,25,9,34,1
Sane,274,2,297,2019-03-09T17:30:00Z,True,12,17,26,1,71,42,29,43,23,20,28,22
Sane,274,2,315,2019-03-30T12:30:00Z,False,12,8,0,0,74,45,29,17,15,2,57,14
Sane,274,2,324,2019-04-03T18:45:00Z,True,12,4,90,8,77,45,32,28,20,8,49,37
Sane,274,2,332,2019-04-14T13:05:00Z,False,12,6,86,5,80,48,32,39,16,23,41,16
Sane,274,2,346,2019-04-20T11:30:00Z,True,12,16,24,1,83,48,35,67,34,33,16,15
Sane,274,2,305,2019-04-24T19:00:00Z,False,12,13,39,6,86,51,35,64,35,29,22,0
Sane,274,2,351,2019-04-28T13:05:00Z,False,12,3,63,3,89,51,38,40,23,17,49,15
Sane,274,2,366,2019-05-06T19:00:00Z,True,12,10,34,1,92,51,41,51,26,25,41,26
Sane,274,2,370,2019-05-12T14:00:00Z,False,12,2,0,0,95,54,41,36,23,13,59,18
Bernardo Silva,275,2,0,2018-08-12T15:00:00Z,False,12,0,90,8,0,0,0,0,0,0,0,0
Bernardo Silva,275,2,17,2018-08-19T12:30:00Z,True,12,9,90,2,3,0,3,0,0,0,3,0
Bernardo Silva,275,2,29,2018-08-25T11:30:00Z,False,12,19,61,2,6,3,3,1,1,0,5,2
Bernardo Silva,275,2,37,2018-09-01T16:30:00Z,True,12,14,32,1,7,3,4,1,0,1,6,2
Bernardo Silva,275,2,44,2018-09-15T14:00:00Z,True,12,8,90,3,10,6,4,4,3,1,6,5
Bernardo Silva,275,2,53,2018-09-22T14:00:00Z,False,12,4,90,14,13,9,4,2,1,1,11,3
Bernardo Silva,275,2,66,2018-09-29T14:00:00Z,True,12,2,90,3,16,9,7,5,4,1,11,8
Bernardo Silva,275,2,75,2018-10-07T15:30:00Z,False,12,11,90,2,19,12,7,19,9,10,0,-2
Bernardo Silva,275,2,86,2018-10-20T14:00:00Z,True,12,3,57,6,20,12,8,8,4,4,12,8
Bernardo Silva,275,2,98,2018-10-29T20:00:00Z,False,12,16,90,3,23,15,8,21,6,15,2,2
Bernardo Silva,275,2,106,2018-11-04T15:00:00Z,True,12,15,90,2,26,15,11,7,3,4,19,11
Bernardo Silva,275,2,117,2018-11-11T16:30:00Z,True,12,13,90,10,29,18,11,20,10,10,9,8
Bernardo Silva,275,2,128,2018-11-24T15:00:00Z,False,12,18,0,0,32,21,11,12,7,5,20,4
Bernardo Silva,275,2,137,2018-12-01T15:00:00Z,True,12,1,86,8,35,21,14,20,11,9,15,12
Bernardo Silva,275,2,145,2018-12-04T20:00:00Z,False,12,17,90,2,38,24,14,20,12,8,18,2
Bernardo Silva,275,2,154,2018-12-08T17:30:00Z,False,12,5,90,2,41,24,17,31,18,13,10,-1
Bernardo Silva,275,2,165,2018-12-15T12:30:00Z,True,12,7,90,2,41,24,17,24,18,6,17,18
Bernardo Silva,275,2,176,2018-12-22T15:00:00Z,True,12,6,90,5,44,27,17,15,8,7,29,20
Bernardo Silva,275,2,184,2018-12-26T15:00:00Z,False,12,10,82,9,44,27,17,25,11,14,19,6
Bernardo Silva,275,2,197,2018-12-30T14:15:00Z,False,12,15,90,7,44,27,17,15,8,7,29,9
Bernardo Silva,275,2,206,2019-01-03T20:00:00Z,True,12,11,90,4,47,27,20,54,28,26,-7,1
Bernardo Silva,275,2,217,2019-01-14T20:00:00Z,True,12,19,90,3,50,30,20,29,14,15,21,15
Bernardo Silva,275,2,223,2019-01-20T13:30:00Z,False,12,9,18,1,53,33,20,11,5,6,42,15
Bernardo Silva,275,2,237,2019-01-29T20:00:00Z,False,12,14,25,1,56,33,23,21,10,11,35,13
Bernardo Silva,275,2,247,2019-02-03T16:30:00Z,True,12,0,90,2,56,33,23,47,32,15,9,18
Bernardo Silva,275,2,265,2019-02-06T19:45:00Z,False,12,7,90,3,59,36,23,33,21,12,26,2
Bernardo Silva,275,2,255,2019-02-10T16:00:00Z,True,12,5,90,3,62,36,26,50,28,22,12,14
Bernardo Silva,275,2,277,2019-02-27T20:00:00Z,True,12,18,33,4,65,39,26,36,21,15,29,24
Bernardo Silva,275,2,280,2019-03-02T15:00:00Z,False,12,1,90,3,68,42,26,34,25,9,34,1
Bernardo Silva,275,2,297,2019-03-09T17:30:00Z,True,12,17,90,2,71,42,29,43,23,20,28,22
Bernardo Silva,275,2,315,2019-03-30T12:30:00Z,False,12,8,90,14,74,45,29,17,15,2,57,14
Bernardo Silva,275,2,324,2019-04-03T18:45:00Z,True,12,4,0,0,77,45,32,28,20,8,49,37
Bernardo Silva,275,2,332,2019-04-14T13:05:00Z,False,12,6,25,1,80,48,32,39,16,23,41,16
Bernardo Silva,275,2,346,2019-04-20T11:30:00Z,True,12,16,90,3,83,48,35,67,34,33,16,15
Bernardo Silva,275,2,305,2019-04-24T19:00:00Z,False,12,13,90,11,86,51,35,64,35,29,22,0
Bernardo Silva,275,2,351,2019-04-28T13:05:00Z,False,12,3,90,3,89,51,38,40,23,17,49,15
Bernardo Silva,275,2,366,2019-05-06T19:00:00Z,True,12,10,90,3,92,51,41,51,26,25,41,26
Bernardo Silva,275,2,370,2019-05-12T14:00:00Z,False,12,2,90,2,95,54,41,36,23,13,59,18
Foden,276,2,0,2018-08-12T15:00:00Z,False,12,0,0,0,0,0,0,0,0,0,0,0
Foden,276,2,17,2018-08-19T12:30:00Z,True,12,9,8,1,3,0,3,0,0,0,3,0
Foden,276,2,29,2018-08-25T11:30:00Z,False,12,19,0,0,6,3,3,1,1,0,5,2
Foden,276,2,37,2018-09-01T16:30:00Z,True,12,14,0,0,7,3,4,1,0,1,6,2
Foden,276,2,44,2018-09-15T14:00:00Z,True,12,8,0,0,10,6,4,4,3,1,6,5
Foden,276,2,53,2018-09-22T14:00:00Z,False,12,4,21,1,13,9,4,2,1,1,11,3
Foden,276,2,66,2018-09-29T14:00:00Z,True,12,2,2,1,16,9,7,5,4,1,11,8
Foden,276,2,75,2018-10-07T15:30:00Z,False,12,11,0,0,19,12,7,19,9,10,0,-2
Foden,276,2,86,2018-10-20T14:00:00Z,True,12,3,15,1,20,12,8,8,4,4,12,8
Foden,276,2,98,2018-10-29T20:00:00Z,False,12,16,0,0,23,15,8,21,6,15,2,2
Foden,276,2,106,2018-11-04T15:00:00Z,True,12,15,18,1,26,15,11,7,3,4,19,11
Foden,276,2,117,2018-11-11T16:30:00Z,True,12,13,1,1,29,18,11,20,10,10,9,8
Foden,276,2,128,2018-11-24T15:00:00Z,False,12,18,21,1,32,21,11,12,7,5,20,4
Foden,276,2,137,2018-12-01T15:00:00Z,True,12,1,0,0,35,21,14,20,11,9,15,12
Foden,276,2,145,2018-12-04T20:00:00Z,False,12,17,0,0,38,24,14,20,12,8,18,2
Foden,276,2,154,2018-12-08T17:30:00Z,False,12,5,6,1,41,24,17,31,18,13,10,-1
Foden,276,2,165,2018-12-15T12:30:00Z,True,12,7,0,0,41,24,17,24,18,6,17,18
Foden,276,2,176,2018-12-22T15:00:00Z,True,12,6,0,0,44,27,17,15,8,7,29,20
Foden,276,2,184,2018-12-26T15:00:00Z,False,12,10,0,0,44,27,17,25,11,14,19,6
Foden,276,2,197,2018-12-30T14:15:00Z,False,12,15,0,0,44,27,17,15,8,7,29,9
Foden,276,2,206,2019-01-03T20:00:00Z,True,12,11,0,0,47,27,20,54,28,26,-7,1
Foden,276,2,217,2019-01-14T20:00:00Z,True,12,19,0,0,50,30,20,29,14,15,21,15
Foden,276,2,223,2019-01-20T13:30:00Z,False,12,9,0,0,53,33,20,11,5,6,42,15
Foden,276,2,237,2019-01-29T20:00:00Z,False,12,14,0,0,56,33,23,21,10,11,35,13
Foden,276,2,247,2019-02-03T16:30:00Z,True,12,0,0,0,56,33,23,47,32,15,9,18
Foden,276,2,265,2019-02-06T19:45:00Z,False,12,7,0,0,59,36,23,33,21,12,26,2
Foden,276,2,255,2019-02-10T16:00:00Z,True,12,5,0,0,62,36,26,50,28,22,12,14
Foden,276,2,277,2019-02-27T20:00:00Z,True,12,18,5,1,65,39,26,36,21,15,29,24
Foden,276,2,280,2019-03-02T15:00:00Z,False,12,1,0,0,68,42,26,34,25,9,34,1
Foden,276,2,297,2019-03-09T17:30:00Z,True,12,17,1,1,71,42,29,43,23,20,28,22
Foden,276,2,315,2019-03-30T12:30:00Z,False,12,8,0,0,74,45,29,17,15,2,57,14
Foden,276,2,324,2019-04-03T18:45:00Z,True,12,4,90,3,77,45,32,28,20,8,49,37
Foden,276,2,332,2019-04-14T13:05:00Z,False,12,6,0,0,80,48,32,39,16,23,41,16
Foden,276,2,346,2019-04-20T11:30:00Z,True,12,16,84,11,83,48,35,67,34,33,16,15
Foden,276,2,305,2019-04-24T19:00:00Z,False,12,13,0,0,86,51,35,64,35,29,22,0
Foden,276,2,351,2019-04-28T13:05:00Z,False,12,3,0,0,89,51,38,40,23,17,49,15
Foden,276,2,366,2019-05-06T19:00:00Z,True,12,10,56,1,92,51,41,51,26,25,41,26
Foden,276,2,370,2019-05-12T14:00:00Z,False,12,2,0,0,95,54,41,36,23,13,59,18
Diaz,277,2,0,2018-08-12T15:00:00Z,False,12,0,0,0,0,0,0,0,0,0,0,0
Diaz,277,2,17,2018-08-19T12:30:00Z,True,12,9,0,0,3,0,3,0,0,0,3,0
Diaz,277,2,29,2018-08-25T11:30:00Z,False,12,19,0,0,6,3,3,1,1,0,5,2
Diaz,277,2,37,2018-09-01T16:30:00Z,True,12,14,0,0,7,3,4,1,0,1,6,2
Diaz,277,2,44,2018-09-15T14:00:00Z,True,12,8,0,0,10,6,4,4,3,1,6,5
Diaz,277,2,53,2018-09-22T14:00:00Z,False,12,4,0,0,13,9,4,2,1,1,11,3
Diaz,277,2,66,2018-09-29T14:00:00Z,True,12,2,0,0,16,9,7,5,4,1,11,8
Diaz,277,2,75,2018-10-07T15:30:00Z,False,12,11,0,0,19,12,7,19,9,10,0,-2
Diaz,277,2,86,2018-10-20T14:00:00Z,True,12,3,0,0,20,12,8,8,4,4,12,8
Diaz,277,2,98,2018-10-29T20:00:00Z,False,12,16,0,0,23,15,8,21,6,15,2,2
Diaz,277,2,106,2018-11-04T15:00:00Z,True,12,15,0,0,26,15,11,7,3,4,19,11
Diaz,277,2,117,2018-11-11T16:30:00Z,True,12,13,0,0,29,18,11,20,10,10,9,8
Diaz,277,2,128,2018-11-24T15:00:00Z,False,12,18,0,0,32,21,11,12,7,5,20,4
Diaz,277,2,137,2018-12-01T15:00:00Z,True,12,1,0,0,35,21,14,20,11,9,15,12
Diaz,277,2,145,2018-12-04T20:00:00Z,False,12,17,0,0,38,24,14,20,12,8,18,2
Diaz,277,2,154,2018-12-08T17:30:00Z,False,12,5,0,0,41,24,17,31,18,13,10,-1
Diaz,277,2,165,2018-12-15T12:30:00Z,True,12,7,0,0,41,24,17,24,18,6,17,18
Diaz,277,2,176,2018-12-22T15:00:00Z,True,12,6,0,0,44,27,17,15,8,7,29,20
Diaz,277,2,184,2018-12-26T15:00:00Z,False,12,10,0,0,44,27,17,25,11,14,19,6
Diaz,277,2,197,2018-12-30T14:15:00Z,False,12,15,0,0,44,27,17,15,8,7,29,9
Diaz,277,2,206,2019-01-03T20:00:00Z,True,12,11,0,0,47,27,20,54,28,26,-7,1
Diaz,277,2,217,2019-01-14T20:00:00Z,True,12,19,0,0,50,30,20,29,14,15,21,15
Diaz,277,2,223,2019-01-20T13:30:00Z,False,12,9,0,0,53,33,20,11,5,6,42,15
Diaz,277,2,237,2019-01-29T20:00:00Z,False,12,14,0,0,56,33,23,21,10,11,35,13
Diaz,277,2,247,2019-02-03T16:30:00Z,True,12,0,0,0,56,33,23,47,32,15,9,18
Diaz,277,2,265,2019-02-06T19:45:00Z,False,12,7,0,0,59,36,23,33,21,12,26,2
Diaz,277,2,255,2019-02-10T16:00:00Z,True,12,5,0,0,62,36,26,50,28,22,12,14
Diaz,277,2,277,2019-02-27T20:00:00Z,True,12,18,0,0,65,39,26,36,21,15,29,24
Diaz,277,2,280,2019-03-02T15:00:00Z,False,12,1,0,0,68,42,26,34,25,9,34,1
Diaz,277,2,297,2019-03-09T17:30:00Z,True,12,17,0,0,71,42,29,43,23,20,28,22
Diaz,277,2,315,2019-03-30T12:30:00Z,False,12,8,0,0,74,45,29,17,15,2,57,14
Diaz,277,2,324,2019-04-03T18:45:00Z,True,12,4,0,0,77,45,32,28,20,8,49,37
Diaz,277,2,332,2019-04-14T13:05:00Z,False,12,6,0,0,80,48,32,39,16,23,41,16
Diaz,277,2,346,2019-04-20T11:30:00Z,True,12,16,0,0,83,48,35,67,34,33,16,15
Diaz,277,2,305,2019-04-24T19:00:00Z,False,12,13,0,0,86,51,35,64,35,29,22,0
Diaz,277,2,351,2019-04-28T13:05:00Z,False,12,3,0,0,89,51,38,40,23,17,49,15
Diaz,277,2,366,2019-05-06T19:00:00Z,True,12,10,0,0,92,51,41,51,26,25,41,26
Diaz,277,2,370,2019-05-12T14:00:00Z,False,12,2,0,0,95,54,41,36,23,13,59,18
Zinchenko,278,2,0,2018-08-12T15:00:00Z,False,12,0,0,0,0,0,0,0,0,0,0,0
Zinchenko,278,2,17,2018-08-19T12:30:00Z,True,12,9,0,0,3,0,3,0,0,0,3,0
Zinchenko,278,2,29,2018-08-25T11:30:00Z,False,12,19,0,0,6,3,3,1,1,0,5,2
Zinchenko,278,2,37,2018-09-01T16:30:00Z,True,12,14,0,0,7,3,4,1,0,1,6,2
Zinchenko,278,2,44,2018-09-15T14:00:00Z,True,12,8,0,0,10,6,4,4,3,1,6,5
Zinchenko,278,2,53,2018-09-22T14:00:00Z,False,12,4,0,0,13,9,4,2,1,1,11,3
Zinchenko,278,2,66,2018-09-29T14:00:00Z,True,12,2,90,3,16,9,7,5,4,1,11,8
Zinchenko,278,2,75,2018-10-07T15:30:00Z,False,12,11,0,0,19,12,7,19,9,10,0,-2
Zinchenko,278,2,86,2018-10-20T14:00:00Z,True,12,3,0,0,20,12,8,8,4,4,12,8
Zinchenko,278,2,98,2018-10-29T20:00:00Z,False,12,16,0,0,23,15,8,21,6,15,2,2
Zinchenko,278,2,106,2018-11-04T15:00:00Z,True,12,15,0,0,26,15,11,7,3,4,19,11
Zinchenko,278,2,117,2018-11-11T16:30:00Z,True,12,13,0,0,29,18,11,20,10,10,9,8
Zinchenko,278,2,128,2018-11-24T15:00:00Z,False,12,18,0,0,32,21,11,12,7,5,20,4
Zinchenko,278,2,137,2018-12-01T15:00:00Z,True,12,1,53,1,35,21,14,20,11,9,15,12
Zinchenko,278,2,145,2018-12-04T20:00:00Z,False,12,17,0,0,38,24,14,20,12,8,18,2
Zinchenko,278,2,154,2018-12-08T17:30:00Z,False,12,5,0,0,41,24,17,31,18,13,10,-1
Zinchenko,278,2,165,2018-12-15T12:30:00Z,True,12,7,0,0,41,24,17,24,18,6,17,18
Zinchenko,278,2,176,2018-12-22T15:00:00Z,True,12,6,0,0,44,27,17,15,8,7,29,20
Zinchenko,278,2,184,2018-12-26T15:00:00Z,False,12,10,0,0,44,27,17,25,11,14,19,6
Zinchenko,278,2,197,2018-12-30T14:15:00Z,False,12,15,90,5,44,27,17,15,8,7,29,9
Zinchenko,278,2,206,2019-01-03T20:00:00Z,True,12,11,0,0,47,27,20,54,28,26,-7,1
Zinchenko,278,2,217,2019-01-14T20:00:00Z,True,12,19,0,0,50,30,20,29,14,15,21,15
Zinchenko,278,2,223,2019-01-20T13:30:00Z,False,12,9,0,0,53,33,20,11,5,6,42,15
Zinchenko,278,2,237,2019-01-29T20:00:00Z,False,12,14,0,0,56,33,23,21,10,11,35,13
Zinchenko,278,2,247,2019-02-03T16:30:00Z,True,12,0,0,0,56,33,23,47,32,15,9,18
Zinchenko,278,2,265,2019-02-06T19:45:00Z,False,12,7,0,0,59,36,23,33,21,12,26,2
Zinchenko,278,2,255,2019-02-10T16:00:00Z,True,12,5,90,10,62,36,26,50,28,22,12,14
Zinchenko,278,2,277,2019-02-27T20:00:00Z,True,12,18,90,3,65,39,26,36,21,15,29,24
Zinchenko,278,2,280,2019-03-02T15:00:00Z,False,12,1,90,3,68,42,26,34,25,9,34,1
Zinchenko,278,2,297,2019-03-09T17:30:00Z,True,12,17,90,2,71,42,29,43,23,20,28,22
Zinchenko,278,2,315,2019-03-30T12:30:00Z,False,12,8,90,3,74,45,29,17,15,2,57,14
Zinchenko,278,2,324,2019-04-03T18:45:00Z,True,12,4,18,1,77,45,32,28,20,8,49,37
Zinchenko,278,2,332,2019-04-14T13:05:00Z,False,12,6,0,0,80,48,32,39,16,23,41,16
Zinchenko,278,2,346,2019-04-20T11:30:00Z,True,12,16,90,3,83,48,35,67,34,33,16,15
Zinchenko,278,2,305,2019-04-24T19:00:00Z,False,12,13,90,2,86,51,35,64,35,29,22,0
Zinchenko,278,2,351,2019-04-28T13:05:00Z,False,12,3,90,3,89,51,38,40,23,17,49,15
Zinchenko,278,2,366,2019-05-06T19:00:00Z,True,12,10,90,3,92,51,41,51,26,25,41,26
Zinchenko,278,2,370,2019-05-12T14:00:00Z,False,12,2,90,2,95,54,41,36,23,13,59,18
Aguero,279,3,0,2018-08-12T15:00:00Z,False,12,0,78,2,0,0,0,0,0,0,0,0
Aguero,279,3,17,2018-08-19T12:30:00Z,True,12,9,75,20,3,0,3,0,0,0,3,0
Aguero,279,3,29,2018-08-25T11:30:00Z,False,12,19,90,2,6,3,3,1,1,0,5,2
Aguero,279,3,37,2018-09-01T16:30:00Z,True,12,14,90,6,7,3,4,1,0,1,6,2
Aguero,279,3,44,2018-09-15T14:00:00Z,True,12,8,53,7,10,6,4,4,3,1,6,5
Aguero,279,3,53,2018-09-22T14:00:00Z,False,12,4,60,6,13,9,4,2,1,1,11,3
Aguero,279,3,66,2018-09-29T14:00:00Z,True,12,2,65,8,16,9,7,5,4,1,11,8
Aguero,279,3,75,2018-10-07T15:30:00Z,False,12,11,65,1,19,12,7,19,9,10,0,-2
Aguero,279,3,86,2018-10-20T14:00:00Z,True,12,3,65,6,20,12,8,8,4,4,12,8
Aguero,279,3,98,2018-10-29T20:00:00Z,False,12,16,70,2,23,15,8,21,6,15,2,2
Aguero,279,3,106,2018-11-04T15:00:00Z,True,12,15,90,13,26,15,11,7,3,4,19,11
Aguero,279,3,117,2018-11-11T16:30:00Z,True,12,13,74,7,29,18,11,20,10,10,9,8
Aguero,279,3,128,2018-11-24T15:00:00Z,False,12,18,80,2,32,21,11,12,7,5,20,4
Aguero,279,3,137,2018-12-01T15:00:00Z,True,12,1,0,0,35,21,14,20,11,9,15,12
Aguero,279,3,145,2018-12-04T20:00:00Z,False,12,17,0,0,38,24,14,20,12,8,18,2
Aguero,279,3,154,2018-12-08T17:30:00Z,False,12,5,0,0,41,24,17,31,18,13,10,-1
Aguero,279,3,165,2018-12-15T12:30:00Z,True,12,7,0,0,41,24,17,24,18,6,17,18
Aguero,279,3,176,2018-12-22T15:00:00Z,True,12,6,40,1,44,27,17,15,8,7,29,20
Aguero,279,3,184,2018-12-26T15:00:00Z,False,12,10,90,4,44,27,17,25,11,14,19,6
Aguero,279,3,197,2018-12-30T14:15:00Z,False,12,15,72,5,44,27,17,15,8,7,29,9
Aguero,279,3,206,2019-01-03T20:00:00Z,True,12,11,90,6,47,27,20,54,28,26,-7,1
Aguero,279,3,217,2019-01-14T20:00:00Z,True,12,19,14,1,50,30,20,29,14,15,21,15
Aguero,279,3,223,2019-01-20T13:30:00Z,False,12,9,90,5,53,33,20,11,5,6,42,15
Aguero,279,3,237,2019-01-29T20:00:00Z,False,12,14,90,9,56,33,23,21,10,11,35,13
Aguero,279,3,247,2019-02-03T16:30:00Z,True,12,0,80,17,56,33,23,47,32,15,9,18
Aguero,279,3,265,2019-02-06T19:45:00Z,False,12,7,79,2,59,36,23,33,21,12,26,2
Aguero,279,3,255,2019-02-10T16:00:00Z,True,12,5,64,17,62,36,26,50,28,22,12,14
Aguero,279,3,277,2019-02-27T20:00:00Z,True,12,18,84,9,65,39,26,36,21,15,29,24
Aguero,279,3,280,2019-03-02T15:00:00Z,False,12,1,89,2,68,42,26,34,25,9,34,1
Aguero,279,3,297,2019-03-09T17:30:00Z,True,12,17,79,5,71,42,29,43,23,20,28,22
Aguero,279,3,315,2019-03-30T12:30:00Z,False,12,8,56,10,74,45,29,17,15,2,57,14
Aguero,279,3,324,2019-04-03T18:45:00Z,True,12,4,0,0,77,45,32,28,20,8,49,37
Aguero,279,3,332,2019-04-14T13:05:00Z,False,12,6,74,2,80,48,32,39,16,23,41,16
Aguero,279,3,346,2019-04-20T11:30:00Z,True,12,16,65,5,83,48,35,67,34,33,16,15
Aguero,279,3,305,2019-04-24T19:00:00Z,False,12,13,88,2,86,51,35,64,35,29,22,0
Aguero,279,3,351,2019-04-28T13:05:00Z,False,12,3,82,9,89,51,38,40,23,17,49,15
Aguero,279,3,366,2019-05-06T19:00:00Z,True,12,10,86,2,92,51,41,51,26,25,41,26
Aguero,279,3,370,2019-05-12T14:00:00Z,False,12,2,90,6,95,54,41,36,23,13,59,18
Jesus,280,3,0,2018-08-12T15:00:00Z,False,12,0,11,1,0,0,0,0,0,0,0,0
Jesus,280,3,17,2018-08-19T12:30:00Z,True,12,9,90,7,3,0,3,0,0,0,3,0
Jesus,280,3,29,2018-08-25T11:30:00Z,False,12,19,28,1,6,3,3,1,1,0,5,2
Jesus,280,3,37,2018-09-01T16:30:00Z,True,12,14,57,1,7,3,4,1,0,1,6,2
Jesus,280,3,44,2018-09-15T14:00:00Z,True,12,8,36,1,10,6,4,4,3,1,6,5
Jesus,280,3,53,2018-09-22T14:00:00Z,False,12,4,0,0,13,9,4,2,1,1,11,3
Jesus,280,3,66,2018-09-29T14:00:00Z,True,12,2,24,1,16,9,7,5,4,1,11,8
Jesus,280,3,75,2018-10-07T15:30:00Z,False,12,11,24,1,19,12,7,19,9,10,0,-2
Jesus,280,3,86,2018-10-20T14:00:00Z,True,12,3,24,1,20,12,8,8,4,4,12,8
Jesus,280,3,98,2018-10-29T20:00:00Z,False,12,16,1,1,23,15,8,21,6,15,2,2
Jesus,280,3,106,2018-11-04T15:00:00Z,True,12,15,0,0,26,15,11,7,3,4,19,11
Jesus,280,3,117,2018-11-11T16:30:00Z,True,12,13,0,0,29,18,11,20,10,10,9,8
Jesus,280,3,128,2018-11-24T15:00:00Z,False,12,18,9,4,32,21,11,12,7,5,20,4
Jesus,280,3,137,2018-12-01T15:00:00Z,True,12,1,76,2,35,21,14,20,11,9,15,12
Jesus,280,3,145,2018-12-04T20:00:00Z,False,12,17,88,5,38,24,14,20,12,8,18,2
Jesus,280,3,154,2018-12-08T17:30:00Z,False,12,5,37,1,41,24,17,31,18,13,10,-1
Jesus,280,3,165,2018-12-15T12:30:00Z,True,12,7,90,13,41,24,17,24,18,6,17,18
Jesus,280,3,176,2018-12-22T15:00:00Z,True,12,6,90,2,44,27,17,15,8,7,29,20
Jesus,280,3,184,2018-12-26T15:00:00Z,False,12,10,0,0,44,27,17,25,11,14,19,6
Jesus,280,3,197,2018-12-30T14:15:00Z,False,12,15,17,1,44,27,17,15,8,7,29,9
Jesus,280,3,206,2019-01-03T20:00:00Z,True,12,11,0,0,47,27,20,54,28,26,-7,1
Jesus,280,3,217,2019-01-14T20:00:00Z,True,12,19,75,13,50,30,20,29,14,15,21,15
Jesus,280,3,223,2019-01-20T13:30:00Z,False,12,9,0,0,53,33,20,11,5,6,42,15
Jesus,280,3,237,2019-01-29T20:00:00Z,False,12,14,17,1,56,33,23,21,10,11,35,13
Jesus,280,3,247,2019-02-03T16:30:00Z,True,12,0,9,1,56,33,23,47,32,15,9,18
Jesus,280,3,265,2019-02-06T19:45:00Z,False,12,7,10,5,59,36,23,33,21,12,26,2
Jesus,280,3,255,2019-02-10T16:00:00Z,True,12,5,25,1,62,36,26,50,28,22,12,14
Jesus,280,3,277,2019-02-27T20:00:00Z,True,12,18,0,0,65,39,26,36,21,15,29,24
Jesus,280,3,280,2019-03-02T15:00:00Z,False,12,1,1,1,68,42,26,34,25,9,34,1
Jesus,280,3,297,2019-03-09T17:30:00Z,True,12,17,10,1,71,42,29,43,23,20,28,22
Jesus,280,3,315,2019-03-30T12:30:00Z,False,12,8,33,1,74,45,29,17,15,2,57,14
Jesus,280,3,324,2019-04-03T18:45:00Z,True,12,4,90,5,77,45,32,28,20,8,49,37
Jesus,280,3,332,2019-04-14T13:05:00Z,False,12,6,15,5,80,48,32,39,16,23,41,16
Jesus,280,3,346,2019-04-20T11:30:00Z,True,12,16,0,0,83,48,35,67,34,33,16,15
Jesus,280,3,305,2019-04-24T19:00:00Z,False,12,13,1,1,86,51,35,64,35,29,22,0
Jesus,280,3,351,2019-04-28T13:05:00Z,False,12,3,26,1,89,51,38,40,23,17,49,15
Jesus,280,3,366,2019-05-06T19:00:00Z,True,12,10,3,0,92,51,41,51,26,25,41,26
Jesus,280,3,370,2019-05-12T14:00:00Z,False,12,2,0,0,95,54,41,36,23,13,59,18
de Gea,281,0,5,2018-08-10T19:00:00Z,True,13,10,90,3,0,0,0,0,0,0,0,0
de Gea,281,0,10,2018-08-19T15:00:00Z,False,13,2,90,1,3,3,0,0,0,0,3,0
de Gea,281,0,25,2018-08-27T19:00:00Z,True,13,16,90,1,3,3,0,6,3,3,-3,0
de Gea,281,0,31,2018-09-02T15:00:00Z,False,13,3,90,6,3,3,0,1,0,1,2,0
de Gea,281,0,48,2018-09-15T16:30:00Z,False,13,17,90,3,6,3,3,12,9,3,-6,-6
de Gea,281,0,58,2018-09-22T14:00:00Z,True,13,19,90,5,9,3,6,8,5,3,1,0
de Gea,281,0,68,2018-09-29T11:30:00Z,False,13,18,90,1,10,4,6,4,1,3,6,5
de Gea,281,0,76,2018-10-06T16:30:00Z,True,13,14,90,3,10,4,6,2,0,2,8,2
de Gea,281,0,83,2018-10-20T11:30:00Z,False,13,5,90,2,13,7,6,20,10,10,-7,-4
de Gea,281,0,96,2018-10-28T16:00:00Z,True,13,7,90,3,14,7,7,15,10,5,-1,2
de Gea,281,0,101,2018-11-03T12:30:00Z,False,13,1,90,4,17,10,7,20,11,9,-3,-4
de Gea,281,0,117,2018-11-11T16:30:00Z,False,13,12,90,1,20,10,10,29,18,11,-9,-8
de Gea,281,0,125,2018-11-24T15:00:00Z,True,13,6,90,6,20,10,10,8,2,6,12,4
de Gea,281,0,139,2018-12-01T17:30:00Z,False,13,15,90,2,21,11,10,8,4,4,13,6
de Gea,281,0,144,2018-12-05T20:00:00Z,True,13,0,90,2,22,11,11,30,17,13,-8,-2
de Gea,281,0,157,2018-12-08T15:00:00Z,True,13,8,90,3,23,12,11,9,8,1,14,11
de Gea,281,0,164,2018-12-16T16:00:00Z,False,13,11,90,3,26,15,11,42,19,23,-16,-8
de Gea,281,0,172,2018-12-22T17:30:00Z,False,13,4,90,2,26,15,11,14,13,1,12,-2
de Gea,281,0,186,2018-12-26T15:00:00Z,True,13,9,90,2,29,15,14,10,5,5,19,10
de Gea,281,0,196,2018-12-30T16:30:00Z,True,13,1,90,2,32,18,14,26,17,9,6,9
de Gea,281,0,207,2019-01-02T20:00:00Z,False,13,14,90,7,35,21,14,18,7,11,17,7
de Gea,281,0,218,2019-01-13T16:30:00Z,False,13,16,90,12,38,21,17,48,18,30,-10,-1
de Gea,281,0,225,2019-01-19T15:00:00Z,True,13,2,90,2,41,21,20,26,18,8,15,13
de Gea,281,0,234,2019-01-29T20:00:00Z,True,13,3,90,1,44,24,20,22,13,9,22,15
de Gea,281,0,246,2019-02-03T14:05:00Z,False,13,10,90,11,45,25,20,32,14,18,13,6
de Gea,281,0,252,2019-02-09T12:30:00Z,False,13,8,90,6,48,25,23,17,15,2,31,8
de Gea,281,0,267,2019-02-24T14:05:00Z,True,13,11,90,6,51,25,26,65,35,30,-14,-5
de Gea,281,0,272,2019-02-27T20:00:00Z,False,13,6,90,2,52,26,26,30,13,17,22,13
de Gea,281,0,285,2019-03-02T15:00:00Z,True,13,15,90,1,55,26,29,27,15,12,28,14
de Gea,281,0,290,2019-03-10T16:30:00Z,False,13,0,90,1,58,29,29,57,38,19,1,-9
de Gea,281,0,318,2019-03-30T15:00:00Z,True,13,17,90,4,58,29,29,43,23,20,15,9
de Gea,281,0,329,2019-04-02T18:45:00Z,False,13,19,90,1,61,32,29,44,24,20,17,5
de Gea,281,0,336,2019-04-13T16:30:00Z,True,13,18,90,3,61,32,29,42,27,15,19,17
de Gea,281,0,344,2019-04-21T12:30:00Z,False,13,7,90,1,64,35,29,46,28,18,18,1
de Gea,281,0,305,2019-04-24T19:00:00Z,True,13,12,90,2,64,35,29,86,51,35,-22,0
de Gea,281,0,356,2019-04-28T15:30:00Z,True,13,5,90,2,64,35,29,67,39,28,-3,7
de Gea,281,0,365,2019-05-05T13:00:00Z,False,13,9,90,2,65,36,29,14,8,6,51,21
de Gea,281,0,376,2019-05-12T14:00:00Z,True,13,4,90,1,66,36,30,31,20,11,35,25
Romero,282,0,5,2018-08-10T19:00:00Z,True,13,10,0,0,0,0,0,0,0,0,0,0
Romero,282,0,10,2018-08-19T15:00:00Z,False,13,2,0,0,3,3,0,0,0,0,3,0
Romero,282,0,25,2018-08-27T19:00:00Z,True,13,16,0,0,3,3,0,6,3,3,-3,0
Romero,282,0,31,2018-09-02T15:00:00Z,False,13,3,0,0,3,3,0,1,0,1,2,0
Romero,282,0,48,2018-09-15T16:30:00Z,False,13,17,0,0,6,3,3,12,9,3,-6,-6
Romero,282,0,58,2018-09-22T14:00:00Z,True,13,19,0,0,9,3,6,8,5,3,1,0
Romero,282,0,68,2018-09-29T11:30:00Z,False,13,18,0,0,10,4,6,4,1,3,6,5
Romero,282,0,76,2018-10-06T16:30:00Z,True,13,14,0,0,10,4,6,2,0,2,8,2
Romero,282,0,83,2018-10-20T11:30:00Z,False,13,5,0,0,13,7,6,20,10,10,-7,-4
Romero,282,0,96,2018-10-28T16:00:00Z,True,13,7,0,0,14,7,7,15,10,5,-1,2
Romero,282,0,101,2018-11-03T12:30:00Z,False,13,1,0,0,17,10,7,20,11,9,-3,-4
Romero,282,0,117,2018-11-11T16:30:00Z,False,13,12,0,0,20,10,10,29,18,11,-9,-8
Romero,282,0,125,2018-11-24T15:00:00Z,True,13,6,0,0,20,10,10,8,2,6,12,4
Romero,282,0,139,2018-12-01T17:30:00Z,False,13,15,0,0,21,11,10,8,4,4,13,6
Romero,282,0,144,2018-12-05T20:00:00Z,True,13,0,0,0,22,11,11,30,17,13,-8,-2
Romero,282,0,157,2018-12-08T15:00:00Z,True,13,8,0,0,23,12,11,9,8,1,14,11
Romero,282,0,164,2018-12-16T16:00:00Z,False,13,11,0,0,26,15,11,42,19,23,-16,-8
Romero,282,0,172,2018-12-22T17:30:00Z,False,13,4,0,0,26,15,11,14,13,1,12,-2
Romero,282,0,186,2018-12-26T15:00:00Z,True,13,9,0,0,29,15,14,10,5,5,19,10
Romero,282,0,196,2018-12-30T16:30:00Z,True,13,1,0,0,32,18,14,26,17,9,6,9
Romero,282,0,207,2019-01-02T20:00:00Z,False,13,14,0,0,35,21,14,18,7,11,17,7
Romero,282,0,218,2019-01-13T16:30:00Z,False,13,16,0,0,38,21,17,48,18,30,-10,-1
Romero,282,0,225,2019-01-19T15:00:00Z,True,13,2,0,0,41,21,20,26,18,8,15,13
Romero,282,0,234,2019-01-29T20:00:00Z,True,13,3,0,0,44,24,20,22,13,9,22,15
Romero,282,0,246,2019-02-03T14:05:00Z,False,13,10,0,0,45,25,20,32,14,18,13,6
Romero,282,0,252,2019-02-09T12:30:00Z,False,13,8,0,0,48,25,23,17,15,2,31,8
Romero,282,0,267,2019-02-24T14:05:00Z,True,13,11,0,0,51,25,26,65,35,30,-14,-5
Romero,282,0,272,2019-02-27T20:00:00Z,False,13,6,0,0,52,26,26,30,13,17,22,13
Romero,282,0,285,2019-03-02T15:00:00Z,True,13,15,0,0,55,26,29,27,15,12,28,14
Romero,282,0,290,2019-03-10T16:30:00Z,False,13,0,0,0,58,29,29,57,38,19,1,-9
Romero,282,0,318,2019-03-30T15:00:00Z,True,13,17,0,0,58,29,29,43,23,20,15,9
Romero,282,0,329,2019-04-02T18:45:00Z,False,13,19,0,0,61,32,29,44,24,20,17,5
Romero,282,0,336,2019-04-13T16:30:00Z,True,13,18,0,0,61,32,29,42,27,15,19,17
Romero,282,0,344,2019-04-21T12:30:00Z,False,13,7,0,0,64,35,29,46,28,18,18,1
Romero,282,0,305,2019-04-24T19:00:00Z,True,13,12,0,0,64,35,29,86,51,35,-22,0
Romero,282,0,356,2019-04-28T15:30:00Z,True,13,5,0,0,64,35,29,67,39,28,-3,7
Romero,282,0,365,2019-05-05T13:00:00Z,False,13,9,0,0,65,36,29,14,8,6,51,21
Romero,282,0,376,2019-05-12T14:00:00Z,True,13,4,0,0,66,36,30,31,20,11,35,25
Smalling,283,1,5,2018-08-10T19:00:00Z,True,13,10,0,0,0,0,0,0,0,0,0,0
Smalling,283,1,10,2018-08-19T15:00:00Z,False,13,2,0,0,3,3,0,0,0,0,3,0
Smalling,283,1,25,2018-08-27T19:00:00Z,True,13,16,90,1,3,3,0,6,3,3,-3,0
Smalling,283,1,31,2018-09-02T15:00:00Z,False,13,3,90,7,3,3,0,1,0,1,2,0
Smalling,283,1,48,2018-09-15T16:30:00Z,False,13,17,90,10,6,3,3,12,9,3,-6,-6
Smalling,283,1,58,2018-09-22T14:00:00Z,True,13,19,90,2,9,3,6,8,5,3,1,0
Smalling,283,1,68,2018-09-29T11:30:00Z,False,13,18,90,1,10,4,6,4,1,3,6,5
Smalling,283,1,76,2018-10-06T16:30:00Z,True,13,14,90,1,10,4,6,2,0,2,8,2
Smalling,283,1,83,2018-10-20T11:30:00Z,False,13,5,90,1,13,7,6,20,10,10,-7,-4
Smalling,283,1,96,2018-10-28T16:00:00Z,True,13,7,90,1,14,7,7,15,10,5,-1,2
Smalling,283,1,101,2018-11-03T12:30:00Z,False,13,1,90,2,17,10,7,20,11,9,-3,-4
Smalling,283,1,117,2018-11-11T16:30:00Z,False,13,12,90,1,20,10,10,29,18,11,-9,-8
Smalling,283,1,125,2018-11-24T15:00:00Z,True,13,6,90,6,20,10,10,8,2,6,12,4
Smalling,283,1,139,2018-12-01T17:30:00Z,False,13,15,0,0,21,11,10,8,4,4,13,6
Smalling,283,1,144,2018-12-05T20:00:00Z,True,13,0,90,1,22,11,11,30,17,13,-8,-2
Smalling,283,1,157,2018-12-08T15:00:00Z,True,13,8,57,1,23,12,11,9,8,1,14,11
Smalling,283,1,164,2018-12-16T16:00:00Z,False,13,11,0,0,26,15,11,42,19,23,-16,-8
Smalling,283,1,172,2018-12-22T17:30:00Z,False,13,4,0,0,26,15,11,14,13,1,12,-2
Smalling,283,1,186,2018-12-26T15:00:00Z,True,13,9,0,0,29,15,14,10,5,5,19,10
Smalling,283,1,196,2018-12-30T16:30:00Z,True,13,1,0,0,32,18,14,26,17,9,6,9
Smalling,283,1,207,2019-01-02T20:00:00Z,False,13,14,0,0,35,21,14,18,7,11,17,7
Smalling,283,1,218,2019-01-13T16:30:00Z,False,13,16,0,0,38,21,17,48,18,30,-10,-1
Smalling,283,1,225,2019-01-19T15:00:00Z,True,13,2,0,0,41,21,20,26,18,8,15,13
Smalling,283,1,234,2019-01-29T20:00:00Z,True,13,3,0,0,44,24,20,22,13,9,22,15
Smalling,283,1,246,2019-02-03T14:05:00Z,False,13,10,0,0,45,25,20,32,14,18,13,6
Smalling,283,1,252,2019-02-09T12:30:00Z,False,13,8,90,6,48,25,23,17,15,2,31,8
Smalling,283,1,267,2019-02-24T14:05:00Z,True,13,11,90,6,51,25,26,65,35,30,-14,-5
Smalling,283,1,272,2019-02-27T20:00:00Z,False,13,6,90,2,52,26,26,30,13,17,22,13
Smalling,283,1,285,2019-03-02T15:00:00Z,True,13,15,90,1,55,26,29,27,15,12,28,14
Smalling,283,1,290,2019-03-10T16:30:00Z,False,13,0,90,1,58,29,29,57,38,19,1,-9
Smalling,283,1,318,2019-03-30T15:00:00Z,True,13,17,90,2,58,29,29,43,23,20,15,9
Smalling,283,1,329,2019-04-02T18:45:00Z,False,13,19,90,-1,61,32,29,44,24,20,17,5
Smalling,283,1,336,2019-04-13T16:30:00Z,True,13,18,90,2,61,32,29,42,27,15,19,17
Smalling,283,1,344,2019-04-21T12:30:00Z,False,13,7,90,0,64,35,29,46,28,18,18,1
Smalling,283,1,305,2019-04-24T19:00:00Z,True,13,12,90,1,64,35,29,86,51,35,-22,0
Smalling,283,1,356,2019-04-28T15:30:00Z,True,13,5,0,0,64,35,29,67,39,28,-3,7
Smalling,283,1,365,2019-05-05T13:00:00Z,False,13,9,0,0,65,36,29,14,8,6,51,21
Smalling,283,1,376,2019-05-12T14:00:00Z,True,13,4,90,1,66,36,30,31,20,11,35,25
Jones,284,1,5,2018-08-10T19:00:00Z,True,13,10,0,0,0,0,0,0,0,0,0,0
Jones,284,1,10,2018-08-19T15:00:00Z,False,13,2,0,0,3,3,0,0,0,0,3,0
Jones,284,1,25,2018-08-27T19:00:00Z,True,13,16,57,0,3,3,0,6,3,3,-3,0
Jones,284,1,31,2018-09-02T15:00:00Z,False,13,3,0,0,3,3,0,1,0,1,2,0
Jones,284,1,48,2018-09-15T16:30:00Z,False,13,17,0,0,6,3,3,12,9,3,-6,-6
Jones,284,1,58,2018-09-22T14:00:00Z,True,13,19,0,0,9,3,6,8,5,3,1,0
Jones,284,1,68,2018-09-29T11:30:00Z,False,13,18,0,0,10,4,6,4,1,3,6,5
Jones,284,1,76,2018-10-06T16:30:00Z,True,13,14,0,0,10,4,6,2,0,2,8,2
Jones,284,1,83,2018-10-20T11:30:00Z,False,13,5,0,0,13,7,6,20,10,10,-7,-4
Jones,284,1,96,2018-10-28T16:00:00Z,True,13,7,0,0,14,7,7,15,10,5,-1,2
Jones,284,1,101,2018-11-03T12:30:00Z,False,13,1,0,0,17,10,7,20,11,9,-3,-4
Jones,284,1,117,2018-11-11T16:30:00Z,False,13,12,0,0,20,10,10,29,18,11,-9,-8
Jones,284,1,125,2018-11-24T15:00:00Z,True,13,6,0,0,20,10,10,8,2,6,12,4
Jones,284,1,139,2018-12-01T17:30:00Z,False,13,15,90,1,21,11,10,8,4,4,13,6
Jones,284,1,144,2018-12-05T20:00:00Z,True,13,0,0,0,22,11,11,30,17,13,-8,-2
Jones,284,1,157,2018-12-08T15:00:00Z,True,13,8,90,2,23,12,11,9,8,1,14,11
Jones,284,1,164,2018-12-16T16:00:00Z,False,13,11,0,0,26,15,11,42,19,23,-16,-8
Jones,284,1,172,2018-12-22T17:30:00Z,False,13,4,90,2,26,15,11,14,13,1,12,-2
Jones,284,1,186,2018-12-26T15:00:00Z,True,13,9,90,2,29,15,14,10,5,5,19,10
Jones,284,1,196,2018-12-30T16:30:00Z,True,13,1,8,1,32,18,14,26,17,9,6,9
Jones,284,1,207,2019-01-02T20:00:00Z,False,13,14,90,7,35,21,14,18,7,11,17,7
Jones,284,1,218,2019-01-13T16:30:00Z,False,13,16,90,6,38,21,17,48,18,30,-10,-1
Jones,284,1,225,2019-01-19T15:00:00Z,True,13,2,90,2,41,21,20,26,18,8,15,13
Jones,284,1,234,2019-01-29T20:00:00Z,True,13,3,90,1,44,24,20,22,13,9,22,15
Jones,284,1,246,2019-02-03T14:05:00Z,False,13,10,1,1,45,25,20,32,14,18,13,6
Jones,284,1,252,2019-02-09T12:30:00Z,False,13,8,90,11,48,25,23,17,15,2,31,8
Jones,284,1,267,2019-02-24T14:05:00Z,True,13,11,0,0,51,25,26,65,35,30,-14,-5
Jones,284,1,272,2019-02-27T20:00:00Z,False,13,6,0,0,52,26,26,30,13,17,22,13
Jones,284,1,285,2019-03-02T15:00:00Z,True,13,15,0,0,55,26,29,27,15,12,28,14
Jones,284,1,290,2019-03-10T16:30:00Z,False,13,0,0,0,58,29,29,57,38,19,1,-9
Jones,284,1,318,2019-03-30T15:00:00Z,True,13,17,90,2,58,29,29,43,23,20,15,9
Jones,284,1,329,2019-04-02T18:45:00Z,False,13,19,25,1,61,32,29,44,24,20,17,5
Jones,284,1,336,2019-04-13T16:30:00Z,True,13,18,90,2,61,32,29,42,27,15,19,17
Jones,284,1,344,2019-04-21T12:30:00Z,False,13,7,45,0,64,35,29,46,28,18,18,1
Jones,284,1,305,2019-04-24T19:00:00Z,True,13,12,0,0,64,35,29,86,51,35,-22,0
Jones,284,1,356,2019-04-28T15:30:00Z,True,13,5,0,0,64,35,29,67,39,28,-3,7
Jones,284,1,365,2019-05-05T13:00:00Z,False,13,9,90,1,65,36,29,14,8,6,51,21
Jones,284,1,376,2019-05-12T14:00:00Z,True,13,4,45,1,66,36,30,31,20,11,35,25
Shaw,285,1,5,2018-08-10T19:00:00Z,True,13,10,90,11,0,0,0,0,0,0,0,0
Shaw,285,1,10,2018-08-19T15:00:00Z,False,13,2,90,4,3,3,0,0,0,0,3,0
Shaw,285,1,25,2018-08-27T19:00:00Z,True,13,16,90,1,3,3,0,6,3,3,-3,0
Shaw,285,1,31,2018-09-02T15:00:00Z,False,13,3,90,5,3,3,0,1,0,1,2,0
Shaw,285,1,48,2018-09-15T16:30:00Z,False,13,17,0,0,6,3,3,12,9,3,-6,-6
Shaw,285,1,58,2018-09-22T14:00:00Z,True,13,19,90,1,9,3,6,8,5,3,1,0
Shaw,285,1,68,2018-09-29T11:30:00Z,False,13,18,90,4,10,4,6,4,1,3,6,5
Shaw,285,1,76,2018-10-06T16:30:00Z,True,13,14,90,0,10,4,6,2,0,2,8,2
Shaw,285,1,83,2018-10-20T11:30:00Z,False,13,5,90,1,13,7,6,20,10,10,-7,-4
Shaw,285,1,96,2018-10-28T16:00:00Z,True,13,7,90,2,14,7,7,15,10,5,-1,2
Shaw,285,1,101,2018-11-03T12:30:00Z,False,13,1,90,1,17,10,7,20,11,9,-3,-4
Shaw,285,1,117,2018-11-11T16:30:00Z,False,13,12,90,0,20,10,10,29,18,11,-9,-8
Shaw,285,1,125,2018-11-24T15:00:00Z,True,13,6,0,0,20,10,10,8,2,6,12,4
Shaw,285,1,139,2018-12-01T17:30:00Z,False,13,15,71,1,21,11,10,8,4,4,13,6
Shaw,285,1,144,2018-12-05T20:00:00Z,True,13,0,0,0,22,11,11,30,17,13,-8,-2
Shaw,285,1,157,2018-12-08T15:00:00Z,True,13,8,0,0,23,12,11,9,8,1,14,11
Shaw,285,1,164,2018-12-16T16:00:00Z,False,13,11,0,0,26,15,11,42,19,23,-16,-8
Shaw,285,1,172,2018-12-22T17:30:00Z,False,13,4,90,1,26,15,11,14,13,1,12,-2
Shaw,285,1,186,2018-12-26T15:00:00Z,True,13,9,90,2,29,15,14,10,5,5,19,10
Shaw,285,1,196,2018-12-30T16:30:00Z,True,13,1,90,2,32,18,14,26,17,9,6,9
Shaw,285,1,207,2019-01-02T20:00:00Z,False,13,14,90,5,35,21,14,18,7,11,17,7
Shaw,285,1,218,2019-01-13T16:30:00Z,False,13,16,90,8,38,21,17,48,18,30,-10,-1
Shaw,285,1,225,2019-01-19T15:00:00Z,True,13,2,0,0,41,21,20,26,18,8,15,13
Shaw,285,1,234,2019-01-29T20:00:00Z,True,13,3,90,1,44,24,20,22,13,9,22,15
Shaw,285,1,246,2019-02-03T14:05:00Z,False,13,10,90,6,45,25,20,32,14,18,13,6
Shaw,285,1,252,2019-02-09T12:30:00Z,False,13,8,90,6,48,25,23,17,15,2,31,8
Shaw,285,1,267,2019-02-24T14:05:00Z,True,13,11,90,6,51,25,26,65,35,30,-14,-5
Shaw,285,1,272,2019-02-27T20:00:00Z,False,13,6,90,4,52,26,26,30,13,17,22,13
Shaw,285,1,285,2019-03-02T15:00:00Z,True,13,15,90,1,55,26,29,27,15,12,28,14
Shaw,285,1,290,2019-03-10T16:30:00Z,False,13,0,90,1,58,29,29,57,38,19,1,-9
Shaw,285,1,318,2019-03-30T15:00:00Z,True,13,17,90,7,58,29,29,43,23,20,15,9
Shaw,285,1,329,2019-04-02T18:45:00Z,False,13,19,90,0,61,32,29,44,24,20,17,5
Shaw,285,1,336,2019-04-13T16:30:00Z,True,13,18,0,0,61,32,29,42,27,15,19,17
Shaw,285,1,344,2019-04-21T12:30:00Z,False,13,7,0,0,64,35,29,46,28,18,18,1
Shaw,285,1,305,2019-04-24T19:00:00Z,True,13,12,90,0,64,35,29,86,51,35,-22,0
Shaw,285,1,356,2019-04-28T15:30:00Z,True,13,5,90,8,64,35,29,67,39,28,-3,7
Shaw,285,1,365,2019-05-05T13:00:00Z,False,13,9,90,2,65,36,29,14,8,6,51,21
Shaw,285,1,376,2019-05-12T14:00:00Z,True,13,4,0,0,66,36,30,31,20,11,35,25
Rojo,286,1,5,2018-08-10T19:00:00Z,True,13,10,0,0,0,0,0,0,0,0,0,0
Rojo,286,1,10,2018-08-19T15:00:00Z,False,13,2,0,0,3,3,0,0,0,0,3,0
Rojo,286,1,25,2018-08-27T19:00:00Z,True,13,16,0,0,3,3,0,6,3,3,-3,0
Rojo,286,1,31,2018-09-02T15:00:00Z,False,13,3,0,0,3,3,0,1,0,1,2,0
Rojo,286,1,48,2018-09-15T16:30:00Z,False,13,17,0,0,6,3,3,12,9,3,-6,-6
Rojo,286,1,58,2018-09-22T14:00:00Z,True,13,19,0,0,9,3,6,8,5,3,1,0
Rojo,286,1,68,2018-09-29T11:30:00Z,False,13,18,0,0,10,4,6,4,1,3,6,5
Rojo,286,1,76,2018-10-06T16:30:00Z,True,13,14,0,0,10,4,6,2,0,2,8,2
Rojo,286,1,83,2018-10-20T11:30:00Z,False,13,5,0,0,13,7,6,20,10,10,-7,-4
Rojo,286,1,96,2018-10-28T16:00:00Z,True,13,7,0,0,14,7,7,15,10,5,-1,2
Rojo,286,1,101,2018-11-03T12:30:00Z,False,13,1,0,0,17,10,7,20,11,9,-3,-4
Rojo,286,1,117,2018-11-11T16:30:00Z,False,13,12,0,0,20,10,10,29,18,11,-9,-8
Rojo,286,1,125,2018-11-24T15:00:00Z,True,13,6,0,0,20,10,10,8,2,6,12,4
Rojo,286,1,139,2018-12-01T17:30:00Z,False,13,15,0,0,21,11,10,8,4,4,13,6
Rojo,286,1,144,2018-12-05T20:00:00Z,True,13,0,71,-2,22,11,11,30,17,13,-8,-2
Rojo,286,1,157,2018-12-08T15:00:00Z,True,13,8,32,1,23,12,11,9,8,1,14,11
Rojo,286,1,164,2018-12-16T16:00:00Z,False,13,11,0,0,26,15,11,42,19,23,-16,-8
Rojo,286,1,172,2018-12-22T17:30:00Z,False,13,4,0,0,26,15,11,14,13,1,12,-2
Rojo,286,1,186,2018-12-26T15:00:00Z,True,13,9,0,0,29,15,14,10,5,5,19,10
Rojo,286,1,196,2018-12-30T16:30:00Z,True,13,1,0,0,32,18,14,26,17,9,6,9
Rojo,286,1,207,2019-01-02T20:00:00Z,False,13,14,0,0,35,21,14,18,7,11,17,7
Rojo,286,1,218,2019-01-13T16:30:00Z,False,13,16,0,0,38,21,17,48,18,30,-10,-1
Rojo,286,1,225,2019-01-19T15:00:00Z,True,13,2,0,0,41,21,20,26,18,8,15,13
Rojo,286,1,234,2019-01-29T20:00:00Z,True,13,3,0,0,44,24,20,22,13,9,22,15
Rojo,286,1,246,2019-02-03T14:05:00Z,False,13,10,0,0,45,25,20,32,14,18,13,6
Rojo,286,1,252,2019-02-09T12:30:00Z,False,13,8,0,0,48,25,23,17,15,2,31,8
Rojo,286,1,267,2019-02-24T14:05:00Z,True,13,11,0,0,51,25,26,65,35,30,-14,-5
Rojo,286,1,272,2019-02-27T20:00:00Z,False,13,6,0,0,52,26,26,30,13,17,22,13
Rojo,286,1,285,2019-03-02T15:00:00Z,True,13,15,0,0,55,26,29,27,15,12,28,14
Rojo,286,1,290,2019-03-10T16:30:00Z,False,13,0,0,0,58,29,29,57,38,19,1,-9
Rojo,286,1,318,2019-03-30T15:00:00Z,True,13,17,13,1,58,29,29,43,23,20,15,9
Rojo,286,1,329,2019-04-02T18:45:00Z,False,13,19,0,0,61,32,29,44,24,20,17,5
Rojo,286,1,336,2019-04-13T16:30:00Z,True,13,18,74,2,61,32,29,42,27,15,19,17
Rojo,286,1,344,2019-04-21T12:30:00Z,False,13,7,0,0,64,35,29,46,28,18,18,1
Rojo,286,1,305,2019-04-24T19:00:00Z,True,13,12,0,0,64,35,29,86,51,35,-22,0
Rojo,286,1,356,2019-04-28T15:30:00Z,True,13,5,19,0,64,35,29,67,39,28,-3,7
Rojo,286,1,365,2019-05-05T13:00:00Z,False,13,9,0,0,65,36,29,14,8,6,51,21
Rojo,286,1,376,2019-05-12T14:00:00Z,True,13,4,0,0,66,36,30,31,20,11,35,25
Valencia,287,1,5,2018-08-10T19:00:00Z,True,13,10,0,0,0,0,0,0,0,0,0,0
Valencia,287,1,10,2018-08-19T15:00:00Z,False,13,2,0,0,3,3,0,0,0,0,3,0
Valencia,287,1,25,2018-08-27T19:00:00Z,True,13,16,90,0,3,3,0,6,3,3,-3,0
Valencia,287,1,31,2018-09-02T15:00:00Z,False,13,3,90,7,3,3,0,1,0,1,2,0
Valencia,287,1,48,2018-09-15T16:30:00Z,False,13,17,90,1,6,3,3,12,9,3,-6,-6
Valencia,287,1,58,2018-09-22T14:00:00Z,True,13,19,90,2,9,3,6,8,5,3,1,0
Valencia,287,1,68,2018-09-29T11:30:00Z,False,13,18,0,0,10,4,6,4,1,3,6,5
Valencia,287,1,76,2018-10-06T16:30:00Z,True,13,14,0,0,10,4,6,2,0,2,8,2
Valencia,287,1,83,2018-10-20T11:30:00Z,False,13,5,0,0,13,7,6,20,10,10,-7,-4
Valencia,287,1,96,2018-10-28T16:00:00Z,True,13,7,0,0,14,7,7,15,10,5,-1,2
Valencia,287,1,101,2018-11-03T12:30:00Z,False,13,1,0,0,17,10,7,20,11,9,-3,-4
Valencia,287,1,117,2018-11-11T16:30:00Z,False,13,12,0,0,20,10,10,29,18,11,-9,-8
Valencia,287,1,125,2018-11-24T15:00:00Z,True,13,6,0,0,20,10,10,8,2,6,12,4
Valencia,287,1,139,2018-12-01T17:30:00Z,False,13,15,0,0,21,11,10,8,4,4,13,6
Valencia,287,1,144,2018-12-05T20:00:00Z,True,13,0,0,0,22,11,11,30,17,13,-8,-2
Valencia,287,1,157,2018-12-08T15:00:00Z,True,13,8,0,0,23,12,11,9,8,1,14,11
Valencia,287,1,164,2018-12-16T16:00:00Z,False,13,11,0,0,26,15,11,42,19,23,-16,-8
Valencia,287,1,172,2018-12-22T17:30:00Z,False,13,4,0,0,26,15,11,14,13,1,12,-2
Valencia,287,1,186,2018-12-26T15:00:00Z,True,13,9,0,0,29,15,14,10,5,5,19,10
Valencia,287,1,196,2018-12-30T16:30:00Z,True,13,1,0,0,32,18,14,26,17,9,6,9
Valencia,287,1,207,2019-01-02T20:00:00Z,False,13,14,90,6,35,21,14,18,7,11,17,7
Valencia,287,1,218,2019-01-13T16:30:00Z,False,13,16,0,0,38,21,17,48,18,30,-10,-1
Valencia,287,1,225,2019-01-19T15:00:00Z,True,13,2,0,0,41,21,20,26,18,8,15,13
Valencia,287,1,234,2019-01-29T20:00:00Z,True,13,3,0,0,44,24,20,22,13,9,22,15
Valencia,287,1,246,2019-02-03T14:05:00Z,False,13,10,0,0,45,25,20,32,14,18,13,6
Valencia,287,1,252,2019-02-09T12:30:00Z,False,13,8,0,0,48,25,23,17,15,2,31,8
Valencia,287,1,267,2019-02-24T14:05:00Z,True,13,11,0,0,51,25,26,65,35,30,-14,-5
Valencia,287,1,272,2019-02-27T20:00:00Z,False,13,6,0,0,52,26,26,30,13,17,22,13
Valencia,287,1,285,2019-03-02T15:00:00Z,True,13,15,0,0,55,26,29,27,15,12,28,14
Valencia,287,1,290,2019-03-10T16:30:00Z,False,13,0,0,0,58,29,29,57,38,19,1,-9
Valencia,287,1,318,2019-03-30T15:00:00Z,True,13,17,0,0,58,29,29,43,23,20,15,9
Valencia,287,1,329,2019-04-02T18:45:00Z,False,13,19,0,0,61,32,29,44,24,20,17,5
Valencia,287,1,336,2019-04-13T16:30:00Z,True,13,18,0,0,61,32,29,42,27,15,19,17
Valencia,287,1,344,2019-04-21T12:30:00Z,False,13,7,0,0,64,35,29,46,28,18,18,1
Valencia,287,1,305,2019-04-24T19:00:00Z,True,13,12,0,0,64,35,29,86,51,35,-22,0
Valencia,287,1,356,2019-04-28T15:30:00Z,True,13,5,0,0,64,35,29,67,39,28,-3,7
Valencia,287,1,365,2019-05-05T13:00:00Z,False,13,9,0,0,65,36,29,14,8,6,51,21
Valencia,287,1,376,2019-05-12T14:00:00Z,True,13,4,16,1,66,36,30,31,20,11,35,25
Darmian,288,1,5,2018-08-10T19:00:00Z,True,13,10,90,2,0,0,0,0,0,0,0,0
Darmian,288,1,10,2018-08-19T15:00:00Z,False,13,2,0,0,3,3,0,0,0,0,3,0
Darmian,288,1,25,2018-08-27T19:00:00Z,True,13,16,0,0,3,3,0,6,3,3,-3,0
Darmian,288,1,31,2018-09-02T15:00:00Z,False,13,3,0,0,3,3,0,1,0,1,2,0
Darmian,288,1,48,2018-09-15T16:30:00Z,False,13,17,0,0,6,3,3,12,9,3,-6,-6
Darmian,288,1,58,2018-09-22T14:00:00Z,True,13,19,0,0,9,3,6,8,5,3,1,0
Darmian,288,1,68,2018-09-29T11:30:00Z,False,13,18,0,0,10,4,6,4,1,3,6,5
Darmian,288,1,76,2018-10-06T16:30:00Z,True,13,14,0,0,10,4,6,2,0,2,8,2
Darmian,288,1,83,2018-10-20T11:30:00Z,False,13,5,0,0,13,7,6,20,10,10,-7,-4
Darmian,288,1,96,2018-10-28T16:00:00Z,True,13,7,0,0,14,7,7,15,10,5,-1,2
Darmian,288,1,101,2018-11-03T12:30:00Z,False,13,1,0,0,17,10,7,20,11,9,-3,-4
Darmian,288,1,117,2018-11-11T16:30:00Z,False,13,12,0,0,20,10,10,29,18,11,-9,-8
Darmian,288,1,125,2018-11-24T15:00:00Z,True,13,6,90,8,20,10,10,8,2,6,12,4
Darmian,288,1,139,2018-12-01T17:30:00Z,False,13,15,0,0,21,11,10,8,4,4,13,6
Darmian,288,1,144,2018-12-05T20:00:00Z,True,13,0,90,1,22,11,11,30,17,13,-8,-2
Darmian,288,1,157,2018-12-08T15:00:00Z,True,13,8,0,0,23,12,11,9,8,1,14,11
Darmian,288,1,164,2018-12-16T16:00:00Z,False,13,11,90,1,26,15,11,42,19,23,-16,-8
Darmian,288,1,172,2018-12-22T17:30:00Z,False,13,4,0,0,26,15,11,14,13,1,12,-2
Darmian,288,1,186,2018-12-26T15:00:00Z,True,13,9,0,0,29,15,14,10,5,5,19,10
Darmian,288,1,196,2018-12-30T16:30:00Z,True,13,1,0,0,32,18,14,26,17,9,6,9
Darmian,288,1,207,2019-01-02T20:00:00Z,False,13,14,0,0,35,21,14,18,7,11,17,7
Darmian,288,1,218,2019-01-13T16:30:00Z,False,13,16,0,0,38,21,17,48,18,30,-10,-1
Darmian,288,1,225,2019-01-19T15:00:00Z,True,13,2,1,1,41,21,20,26,18,8,15,13
Darmian,288,1,234,2019-01-29T20:00:00Z,True,13,3,0,0,44,24,20,22,13,9,22,15
Darmian,288,1,246,2019-02-03T14:05:00Z,False,13,10,0,0,45,25,20,32,14,18,13,6
Darmian,288,1,252,2019-02-09T12:30:00Z,False,13,8,0,0,48,25,23,17,15,2,31,8
Darmian,288,1,267,2019-02-24T14:05:00Z,True,13,11,0,0,51,25,26,65,35,30,-14,-5
Darmian,288,1,272,2019-02-27T20:00:00Z,False,13,6,0,0,52,26,26,30,13,17,22,13
Darmian,288,1,285,2019-03-02T15:00:00Z,True,13,15,0,0,55,26,29,27,15,12,28,14
Darmian,288,1,290,2019-03-10T16:30:00Z,False,13,0,0,0,58,29,29,57,38,19,1,-9
Darmian,288,1,318,2019-03-30T15:00:00Z,True,13,17,0,0,58,29,29,43,23,20,15,9
Darmian,288,1,329,2019-04-02T18:45:00Z,False,13,19,0,0,61,32,29,44,24,20,17,5
Darmian,288,1,336,2019-04-13T16:30:00Z,True,13,18,0,0,61,32,29,42,27,15,19,17
Darmian,288,1,344,2019-04-21T12:30:00Z,False,13,7,0,0,64,35,29,46,28,18,18,1
Darmian,288,1,305,2019-04-24T19:00:00Z,True,13,12,82,1,64,35,29,86,51,35,-22,0
Darmian,288,1,356,2019-04-28T15:30:00Z,True,13,5,0,0,64,35,29,67,39,28,-3,7
Darmian,288,1,365,2019-05-05T13:00:00Z,False,13,9,0,0,65,36,29,14,8,6,51,21
Darmian,288,1,376,2019-05-12T14:00:00Z,True,13,4,0,0,66,36,30,31,20,11,35,25
Blind,289,1,5,2018-08-10T19:00:00Z,True,13,10,0,0,0,0,0,0,0,0,0,0
Blind,289,1,10,2018-08-19T15:00:00Z,False,13,2,0,0,3,3,0,0,0,0,3,0
Blind,289,1,25,2018-08-27T19:00:00Z,True,13,16,0,0,3,3,0,6,3,3,-3,0
Blind,289,1,31,2018-09-02T15:00:00Z,False,13,3,0,0,3,3,0,1,0,1,2,0
Blind,289,1,48,2018-09-15T16:30:00Z,False,13,17,0,0,6,3,3,12,9,3,-6,-6
Blind,289,1,58,2018-09-22T14:00:00Z,True,13,19,0,0,9,3,6,8,5,3,1,0
Blind,289,1,68,2018-09-29T11:30:00Z,False,13,18,0,0,10,4,6,4,1,3,6,5
Blind,289,1,76,2018-10-06T16:30:00Z,True,13,14,0,0,10,4,6,2,0,2,8,2
Blind,289,1,83,2018-10-20T11:30:00Z,False,13,5,0,0,13,7,6,20,10,10,-7,-4
Blind,289,1,96,2018-10-28T16:00:00Z,True,13,7,0,0,14,7,7,15,10,5,-1,2
Blind,289,1,101,2018-11-03T12:30:00Z,False,13,1,0,0,17,10,7,20,11,9,-3,-4
Blind,289,1,117,2018-11-11T16:30:00Z,False,13,12,0,0,20,10,10,29,18,11,-9,-8
Blind,289,1,125,2018-11-24T15:00:00Z,True,13,6,0,0,20,10,10,8,2,6,12,4
Blind,289,1,139,2018-12-01T17:30:00Z,False,13,15,0,0,21,11,10,8,4,4,13,6
Blind,289,1,144,2018-12-05T20:00:00Z,True,13,0,0,0,22,11,11,30,17,13,-8,-2
Blind,289,1,157,2018-12-08T15:00:00Z,True,13,8,0,0,23,12,11,9,8,1,14,11
Blind,289,1,164,2018-12-16T16:00:00Z,False,13,11,0,0,26,15,11,42,19,23,-16,-8
Blind,289,1,172,2018-12-22T17:30:00Z,False,13,4,0,0,26,15,11,14,13,1,12,-2
Blind,289,1,186,2018-12-26T15:00:00Z,True,13,9,0,0,29,15,14,10,5,5,19,10
Blind,289,1,196,2018-12-30T16:30:00Z,True,13,1,0,0,32,18,14,26,17,9,6,9
Blind,289,1,207,2019-01-02T20:00:00Z,False,13,14,0,0,35,21,14,18,7,11,17,7
Blind,289,1,218,2019-01-13T16:30:00Z,False,13,16,0,0,38,21,17,48,18,30,-10,-1
Blind,289,1,225,2019-01-19T15:00:00Z,True,13,2,0,0,41,21,20,26,18,8,15,13
Blind,289,1,234,2019-01-29T20:00:00Z,True,13,3,0,0,44,24,20,22,13,9,22,15
Blind,289,1,246,2019-02-03T14:05:00Z,False,13,10,0,0,45,25,20,32,14,18,13,6
Blind,289,1,252,2019-02-09T12:30:00Z,False,13,8,0,0,48,25,23,17,15,2,31,8
Blind,289,1,267,2019-02-24T14:05:00Z,True,13,11,0,0,51,25,26,65,35,30,-14,-5
Blind,289,1,272,2019-02-27T20:00:00Z,False,13,6,0,0,52,26,26,30,13,17,22,13
Blind,289,1,285,2019-03-02T15:00:00Z,True,13,15,0,0,55,26,29,27,15,12,28,14
Blind,289,1,290,2019-03-10T16:30:00Z,False,13,0,0,0,58,29,29,57,38,19,1,-9
Blind,289,1,318,2019-03-30T15:00:00Z,True,13,17,0,0,58,29,29,43,23,20,15,9
Blind,289,1,329,2019-04-02T18:45:00Z,False,13,19,0,0,61,32,29,44,24,20,17,5
Blind,289,1,336,2019-04-13T16:30:00Z,True,13,18,0,0,61,32,29,42,27,15,19,17
Blind,289,1,344,2019-04-21T12:30:00Z,False,13,7,0,0,64,35,29,46,28,18,18,1
Blind,289,1,305,2019-04-24T19:00:00Z,True,13,12,0,0,64,35,29,86,51,35,-22,0
Blind,289,1,356,2019-04-28T15:30:00Z,True,13,5,0,0,64,35,29,67,39,28,-3,7
Blind,289,1,365,2019-05-05T13:00:00Z,False,13,9,0,0,65,36,29,14,8,6,51,21
Blind,289,1,376,2019-05-12T14:00:00Z,True,13,4,0,0,66,36,30,31,20,11,35,25
Bailly,290,1,5,2018-08-10T19:00:00Z,True,13,10,90,2,0,0,0,0,0,0,0,0
Bailly,290,1,10,2018-08-19T15:00:00Z,False,13,2,90,1,3,3,0,0,0,0,3,0
Bailly,290,1,25,2018-08-27T19:00:00Z,True,13,16,0,0,3,3,0,6,3,3,-3,0
Bailly,290,1,31,2018-09-02T15:00:00Z,False,13,3,1,1,3,3,0,1,0,1,2,0
Bailly,290,1,48,2018-09-15T16:30:00Z,False,13,17,1,1,6,3,3,12,9,3,-6,-6
Bailly,290,1,58,2018-09-22T14:00:00Z,True,13,19,0,0,9,3,6,8,5,3,1,0
Bailly,290,1,68,2018-09-29T11:30:00Z,False,13,18,0,0,10,4,6,4,1,3,6,5
Bailly,290,1,76,2018-10-06T16:30:00Z,True,13,14,18,0,10,4,6,2,0,2,8,2
Bailly,290,1,83,2018-10-20T11:30:00Z,False,13,5,0,0,13,7,6,20,10,10,-7,-4
Bailly,290,1,96,2018-10-28T16:00:00Z,True,13,7,0,0,14,7,7,15,10,5,-1,2
Bailly,290,1,101,2018-11-03T12:30:00Z,False,13,1,0,0,17,10,7,20,11,9,-3,-4
Bailly,290,1,117,2018-11-11T16:30:00Z,False,13,12,0,0,20,10,10,29,18,11,-9,-8
Bailly,290,1,125,2018-11-24T15:00:00Z,True,13,6,0,0,20,10,10,8,2,6,12,4
Bailly,290,1,139,2018-12-01T17:30:00Z,False,13,15,0,0,21,11,10,8,4,4,13,6
Bailly,290,1,144,2018-12-05T20:00:00Z,True,13,0,90,1,22,11,11,30,17,13,-8,-2
Bailly,290,1,157,2018-12-08T15:00:00Z,True,13,8,0,0,23,12,11,9,8,1,14,11
Bailly,290,1,164,2018-12-16T16:00:00Z,False,13,11,90,1,26,15,11,42,19,23,-16,-8
Bailly,290,1,172,2018-12-22T17:30:00Z,False,13,4,0,0,26,15,11,14,13,1,12,-2
Bailly,290,1,186,2018-12-26T15:00:00Z,True,13,9,0,0,29,15,14,10,5,5,19,10
Bailly,290,1,196,2018-12-30T16:30:00Z,True,13,1,78,-1,32,18,14,26,17,9,6,9
Bailly,290,1,207,2019-01-02T20:00:00Z,False,13,14,0,0,35,21,14,18,7,11,17,7
Bailly,290,1,218,2019-01-13T16:30:00Z,False,13,16,0,0,38,21,17,48,18,30,-10,-1
Bailly,290,1,225,2019-01-19T15:00:00Z,True,13,2,0,0,41,21,20,26,18,8,15,13
Bailly,290,1,234,2019-01-29T20:00:00Z,True,13,3,0,0,44,24,20,22,13,9,22,15
Bailly,290,1,246,2019-02-03T14:05:00Z,False,13,10,90,6,45,25,20,32,14,18,13,6
Bailly,290,1,252,2019-02-09T12:30:00Z,False,13,8,5,1,48,25,23,17,15,2,31,8
Bailly,290,1,267,2019-02-24T14:05:00Z,True,13,11,0,0,51,25,26,65,35,30,-14,-5
Bailly,290,1,272,2019-02-27T20:00:00Z,False,13,6,13,1,52,26,26,30,13,17,22,13
Bailly,290,1,285,2019-03-02T15:00:00Z,True,13,15,0,0,55,26,29,27,15,12,28,14
Bailly,290,1,290,2019-03-10T16:30:00Z,False,13,0,0,0,58,29,29,57,38,19,1,-9
Bailly,290,1,318,2019-03-30T15:00:00Z,True,13,17,0,0,58,29,29,43,23,20,15,9
Bailly,290,1,329,2019-04-02T18:45:00Z,False,13,19,0,0,61,32,29,44,24,20,17,5
Bailly,290,1,336,2019-04-13T16:30:00Z,True,13,18,0,0,61,32,29,42,27,15,19,17
Bailly,290,1,344,2019-04-21T12:30:00Z,False,13,7,0,0,64,35,29,46,28,18,18,1
Bailly,290,1,305,2019-04-24T19:00:00Z,True,13,12,0,0,64,35,29,86,51,35,-22,0
Bailly,290,1,356,2019-04-28T15:30:00Z,True,13,5,70,2,64,35,29,67,39,28,-3,7
Bailly,290,1,365,2019-05-05T13:00:00Z,False,13,9,0,0,65,36,29,14,8,6,51,21
Bailly,290,1,376,2019-05-12T14:00:00Z,True,13,4,0,0,66,36,30,31,20,11,35,25
Lindelof,291,1,5,2018-08-10T19:00:00Z,True,13,10,90,2,0,0,0,0,0,0,0,0
Lindelof,291,1,10,2018-08-19T15:00:00Z,False,13,2,90,1,3,3,0,0,0,0,3,0
Lindelof,291,1,25,2018-08-27T19:00:00Z,True,13,16,32,1,3,3,0,6,3,3,-3,0
Lindelof,291,1,31,2018-09-02T15:00:00Z,False,13,3,90,6,3,3,0,1,0,1,2,0
Lindelof,291,1,48,2018-09-15T16:30:00Z,False,13,17,90,2,6,3,3,12,9,3,-6,-6
Lindelof,291,1,58,2018-09-22T14:00:00Z,True,13,19,90,2,9,3,6,8,5,3,1,0
Lindelof,291,1,68,2018-09-29T11:30:00Z,False,13,18,56,-2,10,4,6,4,1,3,6,5
Lindelof,291,1,76,2018-10-06T16:30:00Z,True,13,14,0,0,10,4,6,2,0,2,8,2
Lindelof,291,1,83,2018-10-20T11:30:00Z,False,13,5,90,1,13,7,6,20,10,10,-7,-4
Lindelof,291,1,96,2018-10-28T16:00:00Z,True,13,7,90,2,14,7,7,15,10,5,-1,2
Lindelof,291,1,101,2018-11-03T12:30:00Z,False,13,1,90,2,17,10,7,20,11,9,-3,-4
Lindelof,291,1,117,2018-11-11T16:30:00Z,False,13,12,90,1,20,10,10,29,18,11,-9,-8
Lindelof,291,1,125,2018-11-24T15:00:00Z,True,13,6,90,7,20,10,10,8,2,6,12,4
Lindelof,291,1,139,2018-12-01T17:30:00Z,False,13,15,0,0,21,11,10,8,4,4,13,6
Lindelof,291,1,144,2018-12-05T20:00:00Z,True,13,0,0,0,22,11,11,30,17,13,-8,-2
Lindelof,291,1,157,2018-12-08T15:00:00Z,True,13,8,0,0,23,12,11,9,8,1,14,11
Lindelof,291,1,164,2018-12-16T16:00:00Z,False,13,11,90,1,26,15,11,42,19,23,-16,-8
Lindelof,291,1,172,2018-12-22T17:30:00Z,False,13,4,90,2,26,15,11,14,13,1,12,-2
Lindelof,291,1,186,2018-12-26T15:00:00Z,True,13,9,90,2,29,15,14,10,5,5,19,10
Lindelof,291,1,196,2018-12-30T16:30:00Z,True,13,1,90,2,32,18,14,26,17,9,6,9
Lindelof,291,1,207,2019-01-02T20:00:00Z,False,13,14,90,7,35,21,14,18,7,11,17,7
Lindelof,291,1,218,2019-01-13T16:30:00Z,False,13,16,90,6,38,21,17,48,18,30,-10,-1
Lindelof,291,1,225,2019-01-19T15:00:00Z,True,13,2,90,2,41,21,20,26,18,8,15,13
Lindelof,291,1,234,2019-01-29T20:00:00Z,True,13,3,90,10,44,24,20,22,13,9,22,15
Lindelof,291,1,246,2019-02-03T14:05:00Z,False,13,10,90,7,45,25,20,32,14,18,13,6
Lindelof,291,1,252,2019-02-09T12:30:00Z,False,13,8,0,0,48,25,23,17,15,2,31,8
Lindelof,291,1,267,2019-02-24T14:05:00Z,True,13,11,90,6,51,25,26,65,35,30,-14,-5
Lindelof,291,1,272,2019-02-27T20:00:00Z,False,13,6,90,7,52,26,26,30,13,17,22,13
Lindelof,291,1,285,2019-03-02T15:00:00Z,True,13,15,90,1,55,26,29,27,15,12,28,14
Lindelof,291,1,290,2019-03-10T16:30:00Z,False,13,0,90,1,58,29,29,57,38,19,1,-9
Lindelof,291,1,318,2019-03-30T15:00:00Z,True,13,17,0,0,58,29,29,43,23,20,15,9
Lindelof,291,1,329,2019-04-02T18:45:00Z,False,13,19,90,1,61,32,29,44,24,20,17,5
Lindelof,291,1,336,2019-04-13T16:30:00Z,True,13,18,0,0,61,32,29,42,27,15,19,17
Lindelof,291,1,344,2019-04-21T12:30:00Z,False,13,7,90,0,64,35,29,46,28,18,18,1
Lindelof,291,1,305,2019-04-24T19:00:00Z,True,13,12,90,1,64,35,29,86,51,35,-22,0
Lindelof,291,1,356,2019-04-28T15:30:00Z,True,13,5,90,2,64,35,29,67,39,28,-3,7
Lindelof,291,1,365,2019-05-05T13:00:00Z,False,13,9,82,2,65,36,29,14,8,6,51,21
Lindelof,291,1,376,2019-05-12T14:00:00Z,True,13,4,0,0,66,36,30,31,20,11,35,25
Young,292,1,5,2018-08-10T19:00:00Z,True,13,10,0,0,0,0,0,0,0,0,0,0
Young,292,1,10,2018-08-19T15:00:00Z,False,13,2,90,1,3,3,0,0,0,0,3,0
Young,292,1,25,2018-08-27T19:00:00Z,True,13,16,0,0,3,3,0,6,3,3,-3,0
Young,292,1,31,2018-09-02T15:00:00Z,False,13,3,0,0,3,3,0,1,0,1,2,0
Young,292,1,48,2018-09-15T16:30:00Z,False,13,17,90,5,6,3,3,12,9,3,-6,-6
Young,292,1,58,2018-09-22T14:00:00Z,True,13,19,0,0,9,3,6,8,5,3,1,0
Young,292,1,68,2018-09-29T11:30:00Z,False,13,18,90,0,10,4,6,4,1,3,6,5
Young,292,1,76,2018-10-06T16:30:00Z,True,13,14,90,4,10,4,6,2,0,2,8,2
Young,292,1,83,2018-10-20T11:30:00Z,False,13,5,90,0,13,7,6,20,10,10,-7,-4
Young,292,1,96,2018-10-28T16:00:00Z,True,13,7,90,2,14,7,7,15,10,5,-1,2
Young,292,1,101,2018-11-03T12:30:00Z,False,13,1,90,1,17,10,7,20,11,9,-3,-4
Young,292,1,117,2018-11-11T16:30:00Z,False,13,12,90,1,20,10,10,29,18,11,-9,-8
Young,292,1,125,2018-11-24T15:00:00Z,True,13,6,90,5,20,10,10,8,2,6,12,4
Young,292,1,139,2018-12-01T17:30:00Z,False,13,15,90,0,21,11,10,8,4,4,13,6
Young,292,1,144,2018-12-05T20:00:00Z,True,13,0,0,0,22,11,11,30,17,13,-8,-2
Young,292,1,157,2018-12-08T15:00:00Z,True,13,8,90,12,23,12,11,9,8,1,14,11
Young,292,1,164,2018-12-16T16:00:00Z,False,13,11,90,1,26,15,11,42,19,23,-16,-8
Young,292,1,172,2018-12-22T17:30:00Z,False,13,4,90,2,26,15,11,14,13,1,12,-2
Young,292,1,186,2018-12-26T15:00:00Z,True,13,9,37,1,29,15,14,10,5,5,19,10
Young,292,1,196,2018-12-30T16:30:00Z,True,13,1,90,1,32,18,14,26,17,9,6,9
Young,292,1,207,2019-01-02T20:00:00Z,False,13,14,0,0,35,21,14,18,7,11,17,7
Young,292,1,218,2019-01-13T16:30:00Z,False,13,16,90,6,38,21,17,48,18,30,-10,-1
Young,292,1,225,2019-01-19T15:00:00Z,True,13,2,90,2,41,21,20,26,18,8,15,13
Young,292,1,234,2019-01-29T20:00:00Z,True,13,3,90,1,44,24,20,22,13,9,22,15
Young,292,1,246,2019-02-03T14:05:00Z,False,13,10,90,8,45,25,20,32,14,18,13,6
Young,292,1,252,2019-02-09T12:30:00Z,False,13,8,0,0,48,25,23,17,15,2,31,8
Young,292,1,267,2019-02-24T14:05:00Z,True,13,11,90,5,51,25,26,65,35,30,-14,-5
Young,292,1,272,2019-02-27T20:00:00Z,False,13,6,90,8,52,26,26,30,13,17,22,13
Young,292,1,285,2019-03-02T15:00:00Z,True,13,15,90,1,55,26,29,27,15,12,28,14
Young,292,1,290,2019-03-10T16:30:00Z,False,13,0,90,1,58,29,29,57,38,19,1,-9
Young,292,1,318,2019-03-30T15:00:00Z,True,13,17,90,2,58,29,29,43,23,20,15,9
Young,292,1,329,2019-04-02T18:45:00Z,False,13,19,56,-3,61,32,29,44,24,20,17,5
Young,292,1,336,2019-04-13T16:30:00Z,True,13,18,0,0,61,32,29,42,27,15,19,17
Young,292,1,344,2019-04-21T12:30:00Z,False,13,7,45,0,64,35,29,46,28,18,18,1
Young,292,1,305,2019-04-24T19:00:00Z,True,13,12,90,1,64,35,29,86,51,35,-22,0
Young,292,1,356,2019-04-28T15:30:00Z,True,13,5,90,1,64,35,29,67,39,28,-3,7
Young,292,1,365,2019-05-05T13:00:00Z,False,13,9,90,3,65,36,29,14,8,6,51,21
Young,292,1,376,2019-05-12T14:00:00Z,True,13,4,90,1,66,36,30,31,20,11,35,25
Dalot,293,1,5,2018-08-10T19:00:00Z,True,13,10,0,0,0,0,0,0,0,0,0,0
Dalot,293,1,10,2018-08-19T15:00:00Z,False,13,2,0,0,3,3,0,0,0,0,3,0
Dalot,293,1,25,2018-08-27T19:00:00Z,True,13,16,0,0,3,3,0,6,3,3,-3,0
Dalot,293,1,31,2018-09-02T15:00:00Z,False,13,3,0,0,3,3,0,1,0,1,2,0
Dalot,293,1,48,2018-09-15T16:30:00Z,False,13,17,0,0,6,3,3,12,9,3,-6,-6
Dalot,293,1,58,2018-09-22T14:00:00Z,True,13,19,0,0,9,3,6,8,5,3,1,0
Dalot,293,1,68,2018-09-29T11:30:00Z,False,13,18,0,0,10,4,6,4,1,3,6,5
Dalot,293,1,76,2018-10-06T16:30:00Z,True,13,14,0,0,10,4,6,2,0,2,8,2
Dalot,293,1,83,2018-10-20T11:30:00Z,False,13,5,0,0,13,7,6,20,10,10,-7,-4
Dalot,293,1,96,2018-10-28T16:00:00Z,True,13,7,0,0,14,7,7,15,10,5,-1,2
Dalot,293,1,101,2018-11-03T12:30:00Z,False,13,1,0,0,17,10,7,20,11,9,-3,-4
Dalot,293,1,117,2018-11-11T16:30:00Z,False,13,12,0,0,20,10,10,29,18,11,-9,-8
Dalot,293,1,125,2018-11-24T15:00:00Z,True,13,6,0,0,20,10,10,8,2,6,12,4
Dalot,293,1,139,2018-12-01T17:30:00Z,False,13,15,18,1,21,11,10,8,4,4,13,6
Dalot,293,1,144,2018-12-05T20:00:00Z,True,13,0,90,1,22,11,11,30,17,13,-8,-2
Dalot,293,1,157,2018-12-08T15:00:00Z,True,13,8,90,1,23,12,11,9,8,1,14,11
Dalot,293,1,164,2018-12-16T16:00:00Z,False,13,11,45,0,26,15,11,42,19,23,-16,-8
Dalot,293,1,172,2018-12-22T17:30:00Z,False,13,4,0,0,26,15,11,14,13,1,12,-2
Dalot,293,1,186,2018-12-26T15:00:00Z,True,13,9,52,1,29,15,14,10,5,5,19,10
Dalot,293,1,196,2018-12-30T16:30:00Z,True,13,1,0,0,32,18,14,26,17,9,6,9
Dalot,293,1,207,2019-01-02T20:00:00Z,False,13,14,0,0,35,21,14,18,7,11,17,7
Dalot,293,1,218,2019-01-13T16:30:00Z,False,13,16,7,1,38,21,17,48,18,30,-10,-1
Dalot,293,1,225,2019-01-19T15:00:00Z,True,13,2,90,5,41,21,20,26,18,8,15,13
Dalot,293,1,234,2019-01-29T20:00:00Z,True,13,3,0,0,44,24,20,22,13,9,22,15
Dalot,293,1,246,2019-02-03T14:05:00Z,False,13,10,0,0,45,25,20,32,14,18,13,6
Dalot,293,1,252,2019-02-09T12:30:00Z,False,13,8,90,6,48,25,23,17,15,2,31,8
Dalot,293,1,267,2019-02-24T14:05:00Z,True,13,11,0,0,51,25,26,65,35,30,-14,-5
Dalot,293,1,272,2019-02-27T20:00:00Z,False,13,6,76,2,52,26,26,30,13,17,22,13
Dalot,293,1,285,2019-03-02T15:00:00Z,True,13,15,38,4,55,26,29,27,15,12,28,14
Dalot,293,1,290,2019-03-10T16:30:00Z,False,13,0,70,1,58,29,29,57,38,19,1,-9
Dalot,293,1,318,2019-03-30T15:00:00Z,True,13,17,0,0,58,29,29,43,23,20,15,9
Dalot,293,1,329,2019-04-02T18:45:00Z,False,13,19,83,0,61,32,29,44,24,20,17,5
Dalot,293,1,336,2019-04-13T16:30:00Z,True,13,18,90,2,61,32,29,42,27,15,19,17
Dalot,293,1,344,2019-04-21T12:30:00Z,False,13,7,90,0,64,35,29,46,28,18,18,1
Dalot,293,1,305,2019-04-24T19:00:00Z,True,13,12,0,0,64,35,29,86,51,35,-22,0
Dalot,293,1,356,2019-04-28T15:30:00Z,True,13,5,0,0,64,35,29,67,39,28,-3,7
Dalot,293,1,365,2019-05-05T13:00:00Z,False,13,9,7,1,65,36,29,14,8,6,51,21
Dalot,293,1,376,2019-05-12T14:00:00Z,True,13,4,73,1,66,36,30,31,20,11,35,25
Sanchez,294,2,5,2018-08-10T19:00:00Z,True,13,10,90,5,0,0,0,0,0,0,0,0
Sanchez,294,2,10,2018-08-19T15:00:00Z,False,13,2,0,0,3,3,0,0,0,0,3,0
Sanchez,294,2,25,2018-08-27T19:00:00Z,True,13,16,35,1,3,3,0,6,3,3,-3,0
Sanchez,294,2,31,2018-09-02T15:00:00Z,False,13,3,60,5,3,3,0,1,0,1,2,0
Sanchez,294,2,48,2018-09-15T16:30:00Z,False,13,17,83,2,6,3,3,12,9,3,-6,-6
Sanchez,294,2,58,2018-09-22T14:00:00Z,True,13,19,62,2,9,3,6,8,5,3,1,0
Sanchez,294,2,68,2018-09-29T11:30:00Z,False,13,18,0,0,10,4,6,4,1,3,6,5
Sanchez,294,2,76,2018-10-06T16:30:00Z,True,13,14,23,7,10,4,6,2,0,2,8,2
Sanchez,294,2,83,2018-10-20T11:30:00Z,False,13,5,5,0,13,7,6,20,10,10,-7,-4
Sanchez,294,2,96,2018-10-28T16:00:00Z,True,13,7,0,0,14,7,7,15,10,5,-1,2
Sanchez,294,2,101,2018-11-03T12:30:00Z,False,13,1,77,5,17,10,7,20,11,9,-3,-4
Sanchez,294,2,117,2018-11-11T16:30:00Z,False,13,12,17,1,20,10,10,29,18,11,-9,-8
Sanchez,294,2,125,2018-11-24T15:00:00Z,True,13,6,22,1,20,10,10,8,2,6,12,4
Sanchez,294,2,139,2018-12-01T17:30:00Z,False,13,15,0,0,21,11,10,8,4,4,13,6
Sanchez,294,2,144,2018-12-05T20:00:00Z,True,13,0,0,0,22,11,11,30,17,13,-8,-2
Sanchez,294,2,157,2018-12-08T15:00:00Z,True,13,8,0,0,23,12,11,9,8,1,14,11
Sanchez,294,2,164,2018-12-16T16:00:00Z,False,13,11,0,0,26,15,11,42,19,23,-16,-8
Sanchez,294,2,172,2018-12-22T17:30:00Z,False,13,4,0,0,26,15,11,14,13,1,12,-2
Sanchez,294,2,186,2018-12-26T15:00:00Z,True,13,9,0,0,29,15,14,10,5,5,19,10
Sanchez,294,2,196,2018-12-30T16:30:00Z,True,13,1,0,0,32,18,14,26,17,9,6,9
Sanchez,294,2,207,2019-01-02T20:00:00Z,False,13,14,27,4,35,21,14,18,7,11,17,7
Sanchez,294,2,218,2019-01-13T16:30:00Z,False,13,16,0,0,38,21,17,48,18,30,-10,-1
Sanchez,294,2,225,2019-01-19T15:00:00Z,True,13,2,0,0,41,21,20,26,18,8,15,13
Sanchez,294,2,234,2019-01-29T20:00:00Z,True,13,3,23,4,44,24,20,22,13,9,22,15
Sanchez,294,2,246,2019-02-03T14:05:00Z,False,13,10,66,3,45,25,20,32,14,18,13,6
Sanchez,294,2,252,2019-02-09T12:30:00Z,False,13,8,20,1,48,25,23,17,15,2,31,8
Sanchez,294,2,267,2019-02-24T14:05:00Z,True,13,11,47,1,51,25,26,65,35,30,-14,-5
Sanchez,294,2,272,2019-02-27T20:00:00Z,False,13,6,76,1,52,26,26,30,13,17,22,13
Sanchez,294,2,285,2019-03-02T15:00:00Z,True,13,15,51,1,55,26,29,27,15,12,28,14
Sanchez,294,2,290,2019-03-10T16:30:00Z,False,13,0,0,0,58,29,29,57,38,19,1,-9
Sanchez,294,2,318,2019-03-30T15:00:00Z,True,13,17,0,0,58,29,29,43,23,20,15,9
Sanchez,294,2,329,2019-04-02T18:45:00Z,False,13,19,0,0,61,32,29,44,24,20,17,5
Sanchez,294,2,336,2019-04-13T16:30:00Z,True,13,18,0,0,61,32,29,42,27,15,19,17
Sanchez,294,2,344,2019-04-21T12:30:00Z,False,13,7,0,0,64,35,29,46,28,18,18,1
Sanchez,294,2,305,2019-04-24T19:00:00Z,True,13,12,7,1,64,35,29,86,51,35,-22,0
Sanchez,294,2,356,2019-04-28T15:30:00Z,True,13,5,25,1,64,35,29,67,39,28,-3,7
Sanchez,294,2,365,2019-05-05T13:00:00Z,False,13,9,53,1,65,36,29,14,8,6,51,21
Sanchez,294,2,376,2019-05-12T14:00:00Z,True,13,4,0,0,66,36,30,31,20,11,35,25
Matic,295,2,5,2018-08-10T19:00:00Z,True,13,10,0,0,0,0,0,0,0,0,0,0
Matic,295,2,10,2018-08-19T15:00:00Z,False,13,2,0,0,3,3,0,0,0,0,3,0
Matic,295,2,25,2018-08-27T19:00:00Z,True,13,16,60,2,3,3,0,6,3,3,-3,0
Matic,295,2,31,2018-09-02T15:00:00Z,False,13,3,90,3,3,3,0,1,0,1,2,0
Matic,295,2,48,2018-09-15T16:30:00Z,False,13,17,90,-1,6,3,3,12,9,3,-6,-6
Matic,295,2,58,2018-09-22T14:00:00Z,True,13,19,0,0,9,3,6,8,5,3,1,0
Matic,295,2,68,2018-09-29T11:30:00Z,False,13,18,90,2,10,4,6,4,1,3,6,5
Matic,295,2,76,2018-10-06T16:30:00Z,True,13,14,90,2,10,4,6,2,0,2,8,2
Matic,295,2,83,2018-10-20T11:30:00Z,False,13,5,90,1,13,7,6,20,10,10,-7,-4
Matic,295,2,96,2018-10-28T16:00:00Z,True,13,7,90,1,14,7,7,15,10,5,-1,2
Matic,295,2,101,2018-11-03T12:30:00Z,False,13,1,90,2,17,10,7,20,11,9,-3,-4
Matic,295,2,117,2018-11-11T16:30:00Z,False,13,12,90,2,20,10,10,29,18,11,-9,-8
Matic,295,2,125,2018-11-24T15:00:00Z,True,13,6,90,3,20,10,10,8,2,6,12,4
Matic,295,2,139,2018-12-01T17:30:00Z,False,13,15,90,2,21,11,10,8,4,4,13,6
Matic,295,2,144,2018-12-05T20:00:00Z,True,13,0,90,1,22,11,11,30,17,13,-8,-2
Matic,295,2,157,2018-12-08T15:00:00Z,True,13,8,90,2,23,12,11,9,8,1,14,11
Matic,295,2,164,2018-12-16T16:00:00Z,False,13,11,90,2,26,15,11,42,19,23,-16,-8
Matic,295,2,172,2018-12-22T17:30:00Z,False,13,4,86,2,26,15,11,14,13,1,12,-2
Matic,295,2,186,2018-12-26T15:00:00Z,True,13,9,90,9,29,15,14,10,5,5,19,10
Matic,295,2,196,2018-12-30T16:30:00Z,True,13,1,90,2,32,18,14,26,17,9,6,9
Matic,295,2,207,2019-01-02T20:00:00Z,False,13,14,90,3,35,21,14,18,7,11,17,7
Matic,295,2,218,2019-01-13T16:30:00Z,False,13,16,90,3,38,21,17,48,18,30,-10,-1
Matic,295,2,225,2019-01-19T15:00:00Z,True,13,2,90,2,41,21,20,26,18,8,15,13
Matic,295,2,234,2019-01-29T20:00:00Z,True,13,3,90,2,44,24,20,22,13,9,22,15
Matic,295,2,246,2019-02-03T14:05:00Z,False,13,10,90,2,45,25,20,32,14,18,13,6
Matic,295,2,252,2019-02-09T12:30:00Z,False,13,8,90,2,48,25,23,17,15,2,31,8
Matic,295,2,267,2019-02-24T14:05:00Z,True,13,11,0,0,51,25,26,65,35,30,-14,-5
Matic,295,2,272,2019-02-27T20:00:00Z,False,13,6,0,0,52,26,26,30,13,17,22,13
Matic,295,2,285,2019-03-02T15:00:00Z,True,13,15,0,0,55,26,29,27,15,12,28,14
Matic,295,2,290,2019-03-10T16:30:00Z,False,13,0,79,1,58,29,29,57,38,19,1,-9
Matic,295,2,318,2019-03-30T15:00:00Z,True,13,17,90,2,58,29,29,43,23,20,15,9
Matic,295,2,329,2019-04-02T18:45:00Z,False,13,19,0,0,61,32,29,44,24,20,17,5
Matic,295,2,336,2019-04-13T16:30:00Z,True,13,18,0,0,61,32,29,42,27,15,19,17
Matic,295,2,344,2019-04-21T12:30:00Z,False,13,7,90,2,64,35,29,46,28,18,18,1
Matic,295,2,305,2019-04-24T19:00:00Z,True,13,12,0,0,64,35,29,86,51,35,-22,0
Matic,295,2,356,2019-04-28T15:30:00Z,True,13,5,90,2,64,35,29,67,39,28,-3,7
Matic,295,2,365,2019-05-05T13:00:00Z,False,13,9,52,1,65,36,29,14,8,6,51,21
Matic,295,2,376,2019-05-12T14:00:00Z,True,13,4,0,0,66,36,30,31,20,11,35,25
Mata,296,2,5,2018-08-10T19:00:00Z,True,13,10,90,5,0,0,0,0,0,0,0,0
Mata,296,2,10,2018-08-19T15:00:00Z,False,13,2,45,1,3,3,0,0,0,0,3,0
Mata,296,2,25,2018-08-27T19:00:00Z,True,13,16,0,0,3,3,0,6,3,3,-3,0
Mata,296,2,31,2018-09-02T15:00:00Z,False,13,3,0,0,3,3,0,1,0,1,2,0
Mata,296,2,48,2018-09-15T16:30:00Z,False,13,17,0,0,6,3,3,12,9,3,-6,-6
Mata,296,2,58,2018-09-22T14:00:00Z,True,13,19,27,1,9,3,6,8,5,3,1,0
Mata,296,2,68,2018-09-29T11:30:00Z,False,13,18,19,1,10,4,6,4,1,3,6,5
Mata,296,2,76,2018-10-06T16:30:00Z,True,13,14,71,10,10,4,6,2,0,2,8,2
Mata,296,2,83,2018-10-20T11:30:00Z,False,13,5,74,1,13,7,6,20,10,10,-7,-4
Mata,296,2,96,2018-10-28T16:00:00Z,True,13,7,84,2,14,7,7,15,10,5,-1,2
Mata,296,2,101,2018-11-03T12:30:00Z,False,13,1,55,1,17,10,7,20,11,9,-3,-4
Mata,296,2,117,2018-11-11T16:30:00Z,False,13,12,17,1,20,10,10,29,18,11,-9,-8
Mata,296,2,125,2018-11-24T15:00:00Z,True,13,6,59,1,20,10,10,8,2,6,12,4
Mata,296,2,139,2018-12-01T17:30:00Z,False,13,15,0,0,21,11,10,8,4,4,13,6
Mata,296,2,144,2018-12-05T20:00:00Z,True,13,0,0,0,22,11,11,30,17,13,-8,-2
Mata,296,2,157,2018-12-08T15:00:00Z,True,13,8,90,13,23,12,11,9,8,1,14,11
Mata,296,2,164,2018-12-16T16:00:00Z,False,13,11,5,1,26,15,11,42,19,23,-16,-8
Mata,296,2,172,2018-12-22T17:30:00Z,False,13,4,0,0,26,15,11,14,13,1,12,-2
Mata,296,2,186,2018-12-26T15:00:00Z,True,13,9,80,3,29,15,14,10,5,5,19,10
Mata,296,2,196,2018-12-30T16:30:00Z,True,13,1,0,0,32,18,14,26,17,9,6,9
Mata,296,2,207,2019-01-02T20:00:00Z,False,13,14,62,3,35,21,14,18,7,11,17,7
Mata,296,2,218,2019-01-13T16:30:00Z,False,13,16,0,0,38,21,17,48,18,30,-10,-1
Mata,296,2,225,2019-01-19T15:00:00Z,True,13,2,15,1,41,21,20,26,18,8,15,13
Mata,296,2,234,2019-01-29T20:00:00Z,True,13,3,90,1,44,24,20,22,13,9,22,15
Mata,296,2,246,2019-02-03T14:05:00Z,False,13,10,0,0,45,25,20,32,14,18,13,6
Mata,296,2,252,2019-02-09T12:30:00Z,False,13,8,90,6,48,25,23,17,15,2,31,8
Mata,296,2,267,2019-02-24T14:05:00Z,True,13,11,24,1,51,25,26,65,35,30,-14,-5
Mata,296,2,272,2019-02-27T20:00:00Z,False,13,6,0,0,52,26,26,30,13,17,22,13
Mata,296,2,285,2019-03-02T15:00:00Z,True,13,15,0,0,55,26,29,27,15,12,28,14
Mata,296,2,290,2019-03-10T16:30:00Z,False,13,0,0,0,58,29,29,57,38,19,1,-9
Mata,296,2,318,2019-03-30T15:00:00Z,True,13,17,62,3,58,29,29,43,23,20,15,9
Mata,296,2,329,2019-04-02T18:45:00Z,False,13,19,0,0,61,32,29,44,24,20,17,5
Mata,296,2,336,2019-04-13T16:30:00Z,True,13,18,55,3,61,32,29,42,27,15,19,17
Mata,296,2,344,2019-04-21T12:30:00Z,False,13,7,0,0,64,35,29,46,28,18,18,1
Mata,296,2,305,2019-04-24T19:00:00Z,True,13,12,0,0,64,35,29,86,51,35,-22,0
Mata,296,2,356,2019-04-28T15:30:00Z,True,13,5,80,9,64,35,29,67,39,28,-3,7
Mata,296,2,365,2019-05-05T13:00:00Z,False,13,9,90,2,65,36,29,14,8,6,51,21
Mata,296,2,376,2019-05-12T14:00:00Z,True,13,4,0,0,66,36,30,31,20,11,35,25
Fellaini,297,2,5,2018-08-10T19:00:00Z,True,13,10,6,1,0,0,0,0,0,0,0,0
Fellaini,297,2,10,2018-08-19T15:00:00Z,False,13,2,30,4,3,3,0,0,0,0,3,0
Fellaini,297,2,25,2018-08-27T19:00:00Z,True,13,16,29,1,3,3,0,6,3,3,-3,0
Fellaini,297,2,31,2018-09-02T15:00:00Z,False,13,3,90,3,3,3,0,1,0,1,2,0
Fellaini,297,2,48,2018-09-15T16:30:00Z,False,13,17,90,5,6,3,3,12,9,3,-6,-6
Fellaini,297,2,58,2018-09-22T14:00:00Z,True,13,19,90,2,9,3,6,8,5,3,1,0
Fellaini,297,2,68,2018-09-29T11:30:00Z,False,13,18,90,2,10,4,6,4,1,3,6,5
Fellaini,297,2,76,2018-10-06T16:30:00Z,True,13,14,45,1,10,4,6,2,0,2,8,2
Fellaini,297,2,83,2018-10-20T11:30:00Z,False,13,5,0,0,13,7,6,20,10,10,-7,-4
Fellaini,297,2,96,2018-10-28T16:00:00Z,True,13,7,0,0,14,7,7,15,10,5,-1,2
Fellaini,297,2,101,2018-11-03T12:30:00Z,False,13,1,0,0,17,10,7,20,11,9,-3,-4
Fellaini,297,2,117,2018-11-11T16:30:00Z,False,13,12,90,2,20,10,10,29,18,11,-9,-8
Fellaini,297,2,125,2018-11-24T15:00:00Z,True,13,6,30,1,20,10,10,8,2,6,12,4
Fellaini,297,2,139,2018-12-01T17:30:00Z,False,13,15,90,1,21,11,10,8,4,4,13,6
Fellaini,297,2,144,2018-12-05T20:00:00Z,True,13,0,18,1,22,11,11,30,17,13,-8,-2
Fellaini,297,2,157,2018-12-08T15:00:00Z,True,13,8,0,0,23,12,11,9,8,1,14,11
Fellaini,297,2,164,2018-12-16T16:00:00Z,False,13,11,45,1,26,15,11,42,19,23,-16,-8
Fellaini,297,2,172,2018-12-22T17:30:00Z,False,13,4,3,1,26,15,11,14,13,1,12,-2
Fellaini,297,2,186,2018-12-26T15:00:00Z,True,13,9,0,0,29,15,14,10,5,5,19,10
Fellaini,297,2,196,2018-12-30T16:30:00Z,True,13,1,0,0,32,18,14,26,17,9,6,9
Fellaini,297,2,207,2019-01-02T20:00:00Z,False,13,14,0,0,35,21,14,18,7,11,17,7
Fellaini,297,2,218,2019-01-13T16:30:00Z,False,13,16,0,0,38,21,17,48,18,30,-10,-1
Fellaini,297,2,225,2019-01-19T15:00:00Z,True,13,2,0,0,41,21,20,26,18,8,15,13
Fellaini,297,2,234,2019-01-29T20:00:00Z,True,13,3,0,0,44,24,20,22,13,9,22,15
Fellaini,297,2,246,2019-02-03T14:05:00Z,False,13,10,0,0,45,25,20,32,14,18,13,6
Fellaini,297,2,252,2019-02-09T12:30:00Z,False,13,8,0,0,48,25,23,17,15,2,31,8
Fellaini,297,2,267,2019-02-24T14:05:00Z,True,13,11,0,0,51,25,26,65,35,30,-14,-5
Fellaini,297,2,272,2019-02-27T20:00:00Z,False,13,6,0,0,52,26,26,30,13,17,22,13
Fellaini,297,2,285,2019-03-02T15:00:00Z,True,13,15,0,0,55,26,29,27,15,12,28,14
Fellaini,297,2,290,2019-03-10T16:30:00Z,False,13,0,0,0,58,29,29,57,38,19,1,-9
Fellaini,297,2,318,2019-03-30T15:00:00Z,True,13,17,0,0,58,29,29,43,23,20,15,9
Fellaini,297,2,329,2019-04-02T18:45:00Z,False,13,19,0,0,61,32,29,44,24,20,17,5
Fellaini,297,2,336,2019-04-13T16:30:00Z,True,13,18,0,0,61,32,29,42,27,15,19,17
Fellaini,297,2,344,2019-04-21T12:30:00Z,False,13,7,0,0,64,35,29,46,28,18,18,1
Fellaini,297,2,305,2019-04-24T19:00:00Z,True,13,12,0,0,64,35,29,86,51,35,-22,0
Fellaini,297,2,356,2019-04-28T15:30:00Z,True,13,5,0,0,64,35,29,67,39,28,-3,7
Fellaini,297,2,365,2019-05-05T13:00:00Z,False,13,9,0,0,65,36,29,14,8,6,51,21
Fellaini,297,2,376,2019-05-12T14:00:00Z,True,13,4,0,0,66,36,30,31,20,11,35,25
Herrera,298,2,5,2018-08-10T19:00:00Z,True,13,10,0,0,0,0,0,0,0,0,0,0
Herrera,298,2,10,2018-08-19T15:00:00Z,False,13,2,0,0,3,3,0,0,0,0,3,0
Herrera,298,2,25,2018-08-27T19:00:00Z,True,13,16,54,0,3,3,0,6,3,3,-3,0
Herrera,298,2,31,2018-09-02T15:00:00Z,False,13,3,14,1,3,3,0,1,0,1,2,0
Herrera,298,2,48,2018-09-15T16:30:00Z,False,13,17,0,0,6,3,3,12,9,3,-6,-6
Herrera,298,2,58,2018-09-22T14:00:00Z,True,13,19,0,0,9,3,6,8,5,3,1,0
Herrera,298,2,68,2018-09-29T11:30:00Z,False,13,18,0,0,10,4,6,4,1,3,6,5
Herrera,298,2,76,2018-10-06T16:30:00Z,True,13,14,0,0,10,4,6,2,0,2,8,2
Herrera,298,2,83,2018-10-20T11:30:00Z,False,13,5,15,1,13,7,6,20,10,10,-7,-4
Herrera,298,2,96,2018-10-28T16:00:00Z,True,13,7,5,1,14,7,7,15,10,5,-1,2
Herrera,298,2,101,2018-11-03T12:30:00Z,False,13,1,34,1,17,10,7,20,11,9,-3,-4
Herrera,298,2,117,2018-11-11T16:30:00Z,False,13,12,72,2,20,10,10,29,18,11,-9,-8
Herrera,298,2,125,2018-11-24T15:00:00Z,True,13,6,0,0,20,10,10,8,2,6,12,4
Herrera,298,2,139,2018-12-01T17:30:00Z,False,13,15,90,9,21,11,10,8,4,4,13,6
Herrera,298,2,144,2018-12-05T20:00:00Z,True,13,0,90,8,22,11,11,30,17,13,-8,-2
Herrera,298,2,157,2018-12-08T15:00:00Z,True,13,8,90,2,23,12,11,9,8,1,14,11
Herrera,298,2,164,2018-12-16T16:00:00Z,False,13,11,78,2,26,15,11,42,19,23,-16,-8
Herrera,298,2,172,2018-12-22T17:30:00Z,False,13,4,90,8,26,15,11,14,13,1,12,-2
Herrera,298,2,186,2018-12-26T15:00:00Z,True,13,9,37,4,29,15,14,10,5,5,19,10
Herrera,298,2,196,2018-12-30T16:30:00Z,True,13,1,75,4,32,18,14,26,17,9,6,9
Herrera,298,2,207,2019-01-02T20:00:00Z,False,13,14,90,3,35,21,14,18,7,11,17,7
Herrera,298,2,218,2019-01-13T16:30:00Z,False,13,16,90,2,38,21,17,48,18,30,-10,-1
Herrera,298,2,225,2019-01-19T15:00:00Z,True,13,2,90,2,41,21,20,26,18,8,15,13
Herrera,298,2,234,2019-01-29T20:00:00Z,True,13,3,0,0,44,24,20,22,13,9,22,15
Herrera,298,2,246,2019-02-03T14:05:00Z,False,13,10,90,3,45,25,20,32,14,18,13,6
Herrera,298,2,252,2019-02-09T12:30:00Z,False,13,8,84,3,48,25,23,17,15,2,31,8
Herrera,298,2,267,2019-02-24T14:05:00Z,True,13,11,20,1,51,25,26,65,35,30,-14,-5
Herrera,298,2,272,2019-02-27T20:00:00Z,False,13,6,0,0,52,26,26,30,13,17,22,13
Herrera,298,2,285,2019-03-02T15:00:00Z,True,13,15,0,0,55,26,29,27,15,12,28,14
Herrera,298,2,290,2019-03-10T16:30:00Z,False,13,0,0,0,58,29,29,57,38,19,1,-9
Herrera,298,2,318,2019-03-30T15:00:00Z,True,13,17,62,3,58,29,29,43,23,20,15,9
Herrera,298,2,329,2019-04-02T18:45:00Z,False,13,19,0,0,61,32,29,44,24,20,17,5
Herrera,298,2,336,2019-04-13T16:30:00Z,True,13,18,0,0,61,32,29,42,27,15,19,17
Herrera,298,2,344,2019-04-21T12:30:00Z,False,13,7,0,0,64,35,29,46,28,18,18,1
Herrera,298,2,305,2019-04-24T19:00:00Z,True,13,12,0,0,64,35,29,86,51,35,-22,0
Herrera,298,2,356,2019-04-28T15:30:00Z,True,13,5,90,1,64,35,29,67,39,28,-3,7
Herrera,298,2,365,2019-05-05T13:00:00Z,False,13,9,37,1,65,36,29,14,8,6,51,21
Herrera,298,2,376,2019-05-12T14:00:00Z,True,13,4,0,0,66,36,30,31,20,11,35,25
Lingard,299,2,5,2018-08-10T19:00:00Z,True,13,10,0,0,0,0,0,0,0,0,0,0
Lingard,299,2,10,2018-08-19T15:00:00Z,False,13,2,45,1,3,3,0,0,0,0,3,0
Lingard,299,2,25,2018-08-27T19:00:00Z,True,13,16,90,2,3,3,0,6,3,3,-3,0
Lingard,299,2,31,2018-09-02T15:00:00Z,False,13,3,75,3,3,3,0,1,0,1,2,0
Lingard,299,2,48,2018-09-15T16:30:00Z,False,13,17,70,2,6,3,3,12,9,3,-6,-6
Lingard,299,2,58,2018-09-22T14:00:00Z,True,13,19,74,2,9,3,6,8,5,3,1,0
Lingard,299,2,68,2018-09-29T11:30:00Z,False,13,18,0,0,10,4,6,4,1,3,6,5
Lingard,299,2,76,2018-10-06T16:30:00Z,True,13,14,0,0,10,4,6,2,0,2,8,2
Lingard,299,2,83,2018-10-20T11:30:00Z,False,13,5,0,0,13,7,6,20,10,10,-7,-4
Lingard,299,2,96,2018-10-28T16:00:00Z,True,13,7,1,1,14,7,7,15,10,5,-1,2
Lingard,299,2,101,2018-11-03T12:30:00Z,False,13,1,12,1,17,10,7,20,11,9,-3,-4
Lingard,299,2,117,2018-11-11T16:30:00Z,False,13,12,56,1,20,10,10,29,18,11,-9,-8
Lingard,299,2,125,2018-11-24T15:00:00Z,True,13,6,59,1,20,10,10,8,2,6,12,4
Lingard,299,2,139,2018-12-01T17:30:00Z,False,13,15,4,1,21,11,10,8,4,4,13,6
Lingard,299,2,144,2018-12-05T20:00:00Z,True,13,0,74,6,22,11,11,30,17,13,-8,-2
Lingard,299,2,157,2018-12-08T15:00:00Z,True,13,8,72,2,23,12,11,9,8,1,14,11
Lingard,299,2,164,2018-12-16T16:00:00Z,False,13,11,84,9,26,15,11,42,19,23,-16,-8
Lingard,299,2,172,2018-12-22T17:30:00Z,False,13,4,90,18,26,15,11,14,13,1,12,-2
Lingard,299,2,186,2018-12-26T15:00:00Z,True,13,9,90,5,29,15,14,10,5,5,19,10
Lingard,299,2,196,2018-12-30T16:30:00Z,True,13,1,90,2,32,18,14,26,17,9,6,9
Lingard,299,2,207,2019-01-02T20:00:00Z,False,13,14,3,1,35,21,14,18,7,11,17,7
Lingard,299,2,218,2019-01-13T16:30:00Z,False,13,16,82,3,38,21,17,48,18,30,-10,-1
Lingard,299,2,225,2019-01-19T15:00:00Z,True,13,2,74,2,41,21,20,26,18,8,15,13
Lingard,299,2,234,2019-01-29T20:00:00Z,True,13,3,27,4,44,24,20,22,13,9,22,15
Lingard,299,2,246,2019-02-03T14:05:00Z,False,13,10,89,2,45,25,20,32,14,18,13,6
Lingard,299,2,252,2019-02-09T12:30:00Z,False,13,8,0,0,48,25,23,17,15,2,31,8
Lingard,299,2,267,2019-02-24T14:05:00Z,True,13,11,17,1,51,25,26,65,35,30,-14,-5
Lingard,299,2,272,2019-02-27T20:00:00Z,False,13,6,0,0,52,26,26,30,13,17,22,13
Lingard,299,2,285,2019-03-02T15:00:00Z,True,13,15,0,0,55,26,29,27,15,12,28,14
Lingard,299,2,290,2019-03-10T16:30:00Z,False,13,0,0,0,58,29,29,57,38,19,1,-9
Lingard,299,2,318,2019-03-30T15:00:00Z,True,13,17,27,1,58,29,29,43,23,20,15,9
Lingard,299,2,329,2019-04-02T18:45:00Z,False,13,19,90,2,61,32,29,44,24,20,17,5
Lingard,299,2,336,2019-04-13T16:30:00Z,True,13,18,90,2,61,32,29,42,27,15,19,17
Lingard,299,2,344,2019-04-21T12:30:00Z,False,13,7,0,0,64,35,29,46,28,18,18,1
Lingard,299,2,305,2019-04-24T19:00:00Z,True,13,12,82,2,64,35,29,86,51,35,-22,0
Lingard,299,2,356,2019-04-28T15:30:00Z,True,13,5,0,0,64,35,29,67,39,28,-3,7
Lingard,299,2,365,2019-05-05T13:00:00Z,False,13,9,0,0,65,36,29,14,8,6,51,21
Lingard,299,2,376,2019-05-12T14:00:00Z,True,13,4,90,1,66,36,30,31,20,11,35,25
Martial,300,2,5,2018-08-10T19:00:00Z,True,13,10,0,0,0,0,0,0,0,0,0,0
Martial,300,2,10,2018-08-19T15:00:00Z,False,13,2,59,0,3,3,0,0,0,0,3,0
Martial,300,2,25,2018-08-27T19:00:00Z,True,13,16,0,0,3,3,0,6,3,3,-3,0
Martial,300,2,31,2018-09-02T15:00:00Z,False,13,3,0,0,3,3,0,1,0,1,2,0
Martial,300,2,48,2018-09-15T16:30:00Z,False,13,17,19,1,6,3,3,12,9,3,-6,-6
Martial,300,2,58,2018-09-22T14:00:00Z,True,13,19,27,1,9,3,6,8,5,3,1,0
Martial,300,2,68,2018-09-29T11:30:00Z,False,13,18,70,2,10,4,6,4,1,3,6,5
Martial,300,2,76,2018-10-06T16:30:00Z,True,13,14,90,13,10,4,6,2,0,2,8,2
Martial,300,2,83,2018-10-20T11:30:00Z,False,13,5,83,15,13,7,6,20,10,10,-7,-4
Martial,300,2,96,2018-10-28T16:00:00Z,True,13,7,90,9,14,7,7,15,10,5,-1,2
Martial,300,2,101,2018-11-03T12:30:00Z,False,13,1,90,10,17,10,7,20,11,9,-3,-4
Martial,300,2,117,2018-11-11T16:30:00Z,False,13,12,90,7,20,10,10,29,18,11,-9,-8
Martial,300,2,125,2018-11-24T15:00:00Z,True,13,6,90,3,20,10,10,8,2,6,12,4
Martial,300,2,139,2018-12-01T17:30:00Z,False,13,15,13,1,21,11,10,8,4,4,13,6
Martial,300,2,144,2018-12-05T20:00:00Z,True,13,0,62,7,22,11,11,30,17,13,-8,-2
Martial,300,2,157,2018-12-08T15:00:00Z,True,13,8,0,0,23,12,11,9,8,1,14,11
Martial,300,2,164,2018-12-16T16:00:00Z,False,13,11,11,1,26,15,11,42,19,23,-16,-8
Martial,300,2,172,2018-12-22T17:30:00Z,False,13,4,86,7,26,15,11,14,13,1,12,-2
Martial,300,2,186,2018-12-26T15:00:00Z,True,13,9,0,0,29,15,14,10,5,5,19,10
Martial,300,2,196,2018-12-30T16:30:00Z,True,13,1,81,5,32,18,14,26,17,9,6,9
Martial,300,2,207,2019-01-02T20:00:00Z,False,13,14,62,3,35,21,14,18,7,11,17,7
Martial,300,2,218,2019-01-13T16:30:00Z,False,13,16,72,3,38,21,17,48,18,30,-10,-1
Martial,300,2,225,2019-01-19T15:00:00Z,True,13,2,82,2,41,21,20,26,18,8,15,13
Martial,300,2,234,2019-01-29T20:00:00Z,True,13,3,0,0,44,24,20,22,13,9,22,15
Martial,300,2,246,2019-02-03T14:05:00Z,False,13,10,23,0,45,25,20,32,14,18,13,6
Martial,300,2,252,2019-02-09T12:30:00Z,False,13,8,69,12,48,25,23,17,15,2,31,8
Martial,300,2,267,2019-02-24T14:05:00Z,True,13,11,0,0,51,25,26,65,35,30,-14,-5
Martial,300,2,272,2019-02-27T20:00:00Z,False,13,6,0,0,52,26,26,30,13,17,22,13
Martial,300,2,285,2019-03-02T15:00:00Z,True,13,15,0,0,55,26,29,27,15,12,28,14
Martial,300,2,290,2019-03-10T16:30:00Z,False,13,0,19,1,58,29,29,57,38,19,1,-9
Martial,300,2,318,2019-03-30T15:00:00Z,True,13,17,76,9,58,29,29,43,23,20,15,9
Martial,300,2,329,2019-04-02T18:45:00Z,False,13,19,17,1,61,32,29,44,24,20,17,5
Martial,300,2,336,2019-04-13T16:30:00Z,True,13,18,90,5,61,32,29,42,27,15,19,17
Martial,300,2,344,2019-04-21T12:30:00Z,False,13,7,90,2,64,35,29,46,28,18,18,1
Martial,300,2,305,2019-04-24T19:00:00Z,True,13,12,7,1,64,35,29,86,51,35,-22,0
Martial,300,2,356,2019-04-28T15:30:00Z,True,13,5,0,0,64,35,29,67,39,28,-3,7
Martial,300,2,365,2019-05-05T13:00:00Z,False,13,9,0,0,65,36,29,14,8,6,51,21
Martial,300,2,376,2019-05-12T14:00:00Z,True,13,4,45,1,66,36,30,31,20,11,35,25
Pogba,301,2,5,2018-08-10T19:00:00Z,True,13,10,83,10,0,0,0,0,0,0,0,0
Pogba,301,2,10,2018-08-19T15:00:00Z,False,13,2,90,8,3,3,0,0,0,0,3,0
Pogba,301,2,25,2018-08-27T19:00:00Z,True,13,16,90,2,3,3,0,6,3,3,-3,0
Pogba,301,2,31,2018-09-02T15:00:00Z,False,13,3,90,1,3,3,0,1,0,1,2,0
Pogba,301,2,48,2018-09-15T16:30:00Z,False,13,17,90,2,6,3,3,12,9,3,-6,-6
Pogba,301,2,58,2018-09-22T14:00:00Z,True,13,19,90,5,9,3,6,8,5,3,1,0
Pogba,301,2,68,2018-09-29T11:30:00Z,False,13,18,69,2,10,4,6,4,1,3,6,5
Pogba,301,2,76,2018-10-06T16:30:00Z,True,13,14,90,4,10,4,6,2,0,2,8,2
Pogba,301,2,83,2018-10-20T11:30:00Z,False,13,5,90,2,13,7,6,20,10,10,-7,-4
Pogba,301,2,96,2018-10-28T16:00:00Z,True,13,7,90,8,14,7,7,15,10,5,-1,2
Pogba,301,2,101,2018-11-03T12:30:00Z,False,13,1,90,2,17,10,7,20,11,9,-3,-4
Pogba,301,2,117,2018-11-11T16:30:00Z,False,13,12,0,0,20,10,10,29,18,11,-9,-8
Pogba,301,2,125,2018-11-24T15:00:00Z,True,13,6,67,3,20,10,10,8,2,6,12,4
Pogba,301,2,139,2018-12-01T17:30:00Z,False,13,15,90,1,21,11,10,8,4,4,13,6
Pogba,301,2,144,2018-12-05T20:00:00Z,True,13,0,15,1,22,11,11,30,17,13,-8,-2
Pogba,301,2,157,2018-12-08T15:00:00Z,True,13,8,0,0,23,12,11,9,8,1,14,11
Pogba,301,2,164,2018-12-16T16:00:00Z,False,13,11,0,0,26,15,11,42,19,23,-16,-8
Pogba,301,2,172,2018-12-22T17:30:00Z,False,13,4,90,13,26,15,11,14,13,1,12,-2
Pogba,301,2,186,2018-12-26T15:00:00Z,True,13,9,90,15,29,15,14,10,5,5,19,10
Pogba,301,2,196,2018-12-30T16:30:00Z,True,13,1,90,18,32,18,14,26,17,9,6,9
Pogba,301,2,207,2019-01-02T20:00:00Z,False,13,14,90,3,35,21,14,18,7,11,17,7
Pogba,301,2,218,2019-01-13T16:30:00Z,False,13,16,90,5,38,21,17,48,18,30,-10,-1
Pogba,301,2,225,2019-01-19T15:00:00Z,True,13,2,90,8,41,21,20,26,18,8,15,13
Pogba,301,2,234,2019-01-29T20:00:00Z,True,13,3,90,7,44,24,20,22,13,9,22,15
Pogba,301,2,246,2019-02-03T14:05:00Z,False,13,10,90,7,45,25,20,32,14,18,13,6
Pogba,301,2,252,2019-02-09T12:30:00Z,False,13,8,73,16,48,25,23,17,15,2,31,8
Pogba,301,2,267,2019-02-24T14:05:00Z,True,13,11,90,3,51,25,26,65,35,30,-14,-5
Pogba,301,2,272,2019-02-27T20:00:00Z,False,13,6,90,5,52,26,26,30,13,17,22,13
Pogba,301,2,285,2019-03-02T15:00:00Z,True,13,15,90,-1,55,26,29,27,15,12,28,14
Pogba,301,2,290,2019-03-10T16:30:00Z,False,13,0,90,1,58,29,29,57,38,19,1,-9
Pogba,301,2,318,2019-03-30T15:00:00Z,True,13,17,90,2,58,29,29,43,23,20,15,9
Pogba,301,2,329,2019-04-02T18:45:00Z,False,13,19,90,2,61,32,29,44,24,20,17,5
Pogba,301,2,336,2019-04-13T16:30:00Z,True,13,18,90,15,61,32,29,42,27,15,19,17
Pogba,301,2,344,2019-04-21T12:30:00Z,False,13,7,90,2,64,35,29,46,28,18,18,1
Pogba,301,2,305,2019-04-24T19:00:00Z,True,13,12,90,2,64,35,29,86,51,35,-22,0
Pogba,301,2,356,2019-04-28T15:30:00Z,True,13,5,90,2,64,35,29,67,39,28,-3,7
Pogba,301,2,365,2019-05-05T13:00:00Z,False,13,9,90,2,65,36,29,14,8,6,51,21
Pogba,301,2,376,2019-05-12T14:00:00Z,True,13,4,90,1,66,36,30,31,20,11,35,25
McTominay,302,2,5,2018-08-10T19:00:00Z,True,13,10,14,1,0,0,0,0,0,0,0,0
McTominay,302,2,10,2018-08-19T15:00:00Z,False,13,2,0,0,3,3,0,0,0,0,3,0
McTominay,302,2,25,2018-08-27T19:00:00Z,True,13,16,0,0,3,3,0,6,3,3,-3,0
McTominay,302,2,31,2018-09-02T15:00:00Z,False,13,3,0,0,3,3,0,1,0,1,2,0
McTominay,302,2,48,2018-09-15T16:30:00Z,False,13,17,6,1,6,3,3,12,9,3,-6,-6
McTominay,302,2,58,2018-09-22T14:00:00Z,True,13,19,0,0,9,3,6,8,5,3,1,0
McTominay,302,2,68,2018-09-29T11:30:00Z,False,13,18,90,2,10,4,6,4,1,3,6,5
McTominay,302,2,76,2018-10-06T16:30:00Z,True,13,14,45,1,10,4,6,2,0,2,8,2
McTominay,302,2,83,2018-10-20T11:30:00Z,False,13,5,0,0,13,7,6,20,10,10,-7,-4
McTominay,302,2,96,2018-10-28T16:00:00Z,True,13,7,0,0,14,7,7,15,10,5,-1,2
McTominay,302,2,101,2018-11-03T12:30:00Z,False,13,1,0,0,17,10,7,20,11,9,-3,-4
McTominay,302,2,117,2018-11-11T16:30:00Z,False,13,12,0,0,20,10,10,29,18,11,-9,-8
McTominay,302,2,125,2018-11-24T15:00:00Z,True,13,6,0,0,20,10,10,8,2,6,12,4
McTominay,302,2,139,2018-12-01T17:30:00Z,False,13,15,90,2,21,11,10,8,4,4,13,6
McTominay,302,2,144,2018-12-05T20:00:00Z,True,13,0,0,0,22,11,11,30,17,13,-8,-2
McTominay,302,2,157,2018-12-08T15:00:00Z,True,13,8,6,1,23,12,11,9,8,1,14,11
McTominay,302,2,164,2018-12-16T16:00:00Z,False,13,11,0,0,26,15,11,42,19,23,-16,-8
McTominay,302,2,172,2018-12-22T17:30:00Z,False,13,4,0,0,26,15,11,14,13,1,12,-2
McTominay,302,2,186,2018-12-26T15:00:00Z,True,13,9,0,0,29,15,14,10,5,5,19,10
McTominay,302,2,196,2018-12-30T16:30:00Z,True,13,1,0,0,32,18,14,26,17,9,6,9
McTominay,302,2,207,2019-01-02T20:00:00Z,False,13,14,0,0,35,21,14,18,7,11,17,7
McTominay,302,2,218,2019-01-13T16:30:00Z,False,13,16,1,1,38,21,17,48,18,30,-10,-1
McTominay,302,2,225,2019-01-19T15:00:00Z,True,13,2,0,0,41,21,20,26,18,8,15,13
McTominay,302,2,234,2019-01-29T20:00:00Z,True,13,3,0,0,44,24,20,22,13,9,22,15
McTominay,302,2,246,2019-02-03T14:05:00Z,False,13,10,0,0,45,25,20,32,14,18,13,6
McTominay,302,2,252,2019-02-09T12:30:00Z,False,13,8,16,1,48,25,23,17,15,2,31,8
McTominay,302,2,267,2019-02-24T14:05:00Z,True,13,11,90,3,51,25,26,65,35,30,-14,-5
McTominay,302,2,272,2019-02-27T20:00:00Z,False,13,6,90,2,52,26,26,30,13,17,22,13
McTominay,302,2,285,2019-03-02T15:00:00Z,True,13,15,90,2,55,26,29,27,15,12,28,14
McTominay,302,2,290,2019-03-10T16:30:00Z,False,13,0,0,0,58,29,29,57,38,19,1,-9
McTominay,302,2,318,2019-03-30T15:00:00Z,True,13,17,0,0,58,29,29,43,23,20,15,9
McTominay,302,2,329,2019-04-02T18:45:00Z,False,13,19,90,9,61,32,29,44,24,20,17,5
McTominay,302,2,336,2019-04-13T16:30:00Z,True,13,18,0,0,61,32,29,42,27,15,19,17
McTominay,302,2,344,2019-04-21T12:30:00Z,False,13,7,45,0,64,35,29,46,28,18,18,1
McTominay,302,2,305,2019-04-24T19:00:00Z,True,13,12,0,0,64,35,29,86,51,35,-22,0
McTominay,302,2,356,2019-04-28T15:30:00Z,True,13,5,9,1,64,35,29,67,39,28,-3,7
McTominay,302,2,365,2019-05-05T13:00:00Z,False,13,9,90,9,65,36,29,14,8,6,51,21
McTominay,302,2,376,2019-05-12T14:00:00Z,True,13,4,90,2,66,36,30,31,20,11,35,25
Fred,303,2,5,2018-08-10T19:00:00Z,True,13,10,75,2,0,0,0,0,0,0,0,0
Fred,303,2,10,2018-08-19T15:00:00Z,False,13,2,90,2,3,3,0,0,0,0,3,0
Fred,303,2,25,2018-08-27T19:00:00Z,True,13,16,90,2,3,3,0,6,3,3,-3,0
Fred,303,2,31,2018-09-02T15:00:00Z,False,13,3,0,0,3,3,0,1,0,1,2,0
Fred,303,2,48,2018-09-15T16:30:00Z,False,13,17,0,0,6,3,3,12,9,3,-6,-6
Fred,303,2,58,2018-09-22T14:00:00Z,True,13,19,62,10,9,3,6,8,5,3,1,0
Fred,303,2,68,2018-09-29T11:30:00Z,False,13,18,20,1,10,4,6,4,1,3,6,5
Fred,303,2,76,2018-10-06T16:30:00Z,True,13,14,0,0,10,4,6,2,0,2,8,2
Fred,303,2,83,2018-10-20T11:30:00Z,False,13,5,0,0,13,7,6,20,10,10,-7,-4
Fred,303,2,96,2018-10-28T16:00:00Z,True,13,7,90,2,14,7,7,15,10,5,-1,2
Fred,303,2,101,2018-11-03T12:30:00Z,False,13,1,55,1,17,10,7,20,11,9,-3,-4
Fred,303,2,117,2018-11-11T16:30:00Z,False,13,12,0,0,20,10,10,29,18,11,-9,-8
Fred,303,2,125,2018-11-24T15:00:00Z,True,13,6,0,0,20,10,10,8,2,6,12,4
Fred,303,2,139,2018-12-01T17:30:00Z,False,13,15,0,0,21,11,10,8,4,4,13,6
Fred,303,2,144,2018-12-05T20:00:00Z,True,13,0,0,0,22,11,11,30,17,13,-8,-2
Fred,303,2,157,2018-12-08T15:00:00Z,True,13,8,17,1,23,12,11,9,8,1,14,11
Fred,303,2,164,2018-12-16T16:00:00Z,False,13,11,0,0,26,15,11,42,19,23,-16,-8
Fred,303,2,172,2018-12-22T17:30:00Z,False,13,4,11,1,26,15,11,14,13,1,12,-2
Fred,303,2,186,2018-12-26T15:00:00Z,True,13,9,53,0,29,15,14,10,5,5,19,10
Fred,303,2,196,2018-12-30T16:30:00Z,True,13,1,0,0,32,18,14,26,17,9,6,9
Fred,303,2,207,2019-01-02T20:00:00Z,False,13,14,0,0,35,21,14,18,7,11,17,7
Fred,303,2,218,2019-01-13T16:30:00Z,False,13,16,0,0,38,21,17,48,18,30,-10,-1
Fred,303,2,225,2019-01-19T15:00:00Z,True,13,2,0,0,41,21,20,26,18,8,15,13
Fred,303,2,234,2019-01-29T20:00:00Z,True,13,3,0,0,44,24,20,22,13,9,22,15
Fred,303,2,246,2019-02-03T14:05:00Z,False,13,10,0,0,45,25,20,32,14,18,13,6
Fred,303,2,252,2019-02-09T12:30:00Z,False,13,8,0,0,48,25,23,17,15,2,31,8
Fred,303,2,267,2019-02-24T14:05:00Z,True,13,11,0,0,51,25,26,65,35,30,-14,-5
Fred,303,2,272,2019-02-27T20:00:00Z,False,13,6,89,2,52,26,26,30,13,17,22,13
Fred,303,2,285,2019-03-02T15:00:00Z,True,13,15,8,4,55,26,29,27,15,12,28,14
Fred,303,2,290,2019-03-10T16:30:00Z,False,13,0,90,2,58,29,29,57,38,19,1,-9
Fred,303,2,318,2019-03-30T15:00:00Z,True,13,17,0,0,58,29,29,43,23,20,15,9
Fred,303,2,329,2019-04-02T18:45:00Z,False,13,19,64,5,61,32,29,44,24,20,17,5
Fred,303,2,336,2019-04-13T16:30:00Z,True,13,18,90,2,61,32,29,42,27,15,19,17
Fred,303,2,344,2019-04-21T12:30:00Z,False,13,7,45,1,64,35,29,46,28,18,18,1
Fred,303,2,305,2019-04-24T19:00:00Z,True,13,12,90,2,64,35,29,86,51,35,-22,0
Fred,303,2,356,2019-04-28T15:30:00Z,True,13,5,0,0,64,35,29,67,39,28,-3,7
Fred,303,2,365,2019-05-05T13:00:00Z,False,13,9,0,0,65,36,29,14,8,6,51,21
Fred,303,2,376,2019-05-12T14:00:00Z,True,13,4,0,0,66,36,30,31,20,11,35,25
Rashford,304,3,5,2018-08-10T19:00:00Z,True,13,10,66,2,0,0,0,0,0,0,0,0
Rashford,304,3,10,2018-08-19T15:00:00Z,False,13,2,45,1,3,3,0,0,0,0,3,0
Rashford,304,3,25,2018-08-27T19:00:00Z,True,13,16,0,0,3,3,0,6,3,3,-3,0
Rashford,304,3,31,2018-09-02T15:00:00Z,False,13,3,10,-2,3,3,0,1,0,1,2,0
Rashford,304,3,48,2018-09-15T16:30:00Z,False,13,17,0,0,6,3,3,12,9,3,-6,-6
Rashford,304,3,58,2018-09-22T14:00:00Z,True,13,19,0,0,9,3,6,8,5,3,1,0
Rashford,304,3,68,2018-09-29T11:30:00Z,False,13,18,33,5,10,4,6,4,1,3,6,5
Rashford,304,3,76,2018-10-06T16:30:00Z,True,13,14,66,2,10,4,6,2,0,2,8,2
Rashford,304,3,83,2018-10-20T11:30:00Z,False,13,5,84,5,13,7,6,20,10,10,-7,-4
Rashford,304,3,96,2018-10-28T16:00:00Z,True,13,7,64,2,14,7,7,15,10,5,-1,2
Rashford,304,3,101,2018-11-03T12:30:00Z,False,13,1,34,5,17,10,7,20,11,9,-3,-4
Rashford,304,3,117,2018-11-11T16:30:00Z,False,13,12,72,2,20,10,10,29,18,11,-9,-8
Rashford,304,3,125,2018-11-24T15:00:00Z,True,13,6,30,1,20,10,10,8,2,6,12,4
Rashford,304,3,139,2018-12-01T17:30:00Z,False,13,15,76,7,21,11,10,8,4,4,13,6
Rashford,304,3,144,2018-12-05T20:00:00Z,True,13,0,90,2,22,11,11,30,17,13,-8,-2
Rashford,304,3,157,2018-12-08T15:00:00Z,True,13,8,83,14,23,12,11,9,8,1,14,11
Rashford,304,3,164,2018-12-16T16:00:00Z,False,13,11,90,2,26,15,11,42,19,23,-16,-8
Rashford,304,3,172,2018-12-22T17:30:00Z,False,13,4,78,6,26,15,11,14,13,1,12,-2
Rashford,304,3,186,2018-12-26T15:00:00Z,True,13,9,90,2,29,15,14,10,5,5,19,10
Rashford,304,3,196,2018-12-30T16:30:00Z,True,13,1,69,11,32,18,14,26,17,9,6,9
Rashford,304,3,207,2019-01-02T20:00:00Z,False,13,14,86,12,35,21,14,18,7,11,17,7
Rashford,304,3,218,2019-01-13T16:30:00Z,False,13,16,90,7,38,21,17,48,18,30,-10,-1
Rashford,304,3,225,2019-01-19T15:00:00Z,True,13,2,90,8,41,21,20,26,18,8,15,13
Rashford,304,3,234,2019-01-29T20:00:00Z,True,13,3,90,2,44,24,20,22,13,9,22,15
Rashford,304,3,246,2019-02-03T14:05:00Z,False,13,10,77,7,45,25,20,32,14,18,13,6
Rashford,304,3,252,2019-02-09T12:30:00Z,False,13,8,0,0,48,25,23,17,15,2,31,8
Rashford,304,3,267,2019-02-24T14:05:00Z,True,13,11,90,2,51,25,26,65,35,30,-14,-5
Rashford,304,3,272,2019-02-27T20:00:00Z,False,13,6,13,1,52,26,26,30,13,17,22,13
Rashford,304,3,285,2019-03-02T15:00:00Z,True,13,15,90,2,55,26,29,27,15,12,28,14
Rashford,304,3,290,2019-03-10T16:30:00Z,False,13,0,90,2,58,29,29,57,38,19,1,-9
Rashford,304,3,318,2019-03-30T15:00:00Z,True,13,17,90,7,58,29,29,43,23,20,15,9
Rashford,304,3,329,2019-04-02T18:45:00Z,False,13,19,0,0,61,32,29,44,24,20,17,5
Rashford,304,3,336,2019-04-13T16:30:00Z,True,13,18,35,1,61,32,29,42,27,15,19,17
Rashford,304,3,344,2019-04-21T12:30:00Z,False,13,7,76,2,64,35,29,46,28,18,18,1
Rashford,304,3,305,2019-04-24T19:00:00Z,True,13,12,90,2,64,35,29,86,51,35,-22,0
Rashford,304,3,356,2019-04-28T15:30:00Z,True,13,5,64,2,64,35,29,67,39,28,-3,7
Rashford,304,3,365,2019-05-05T13:00:00Z,False,13,9,90,2,65,36,29,14,8,6,51,21
Rashford,304,3,376,2019-05-12T14:00:00Z,True,13,4,90,2,66,36,30,31,20,11,35,25
Lukaku,305,3,5,2018-08-10T19:00:00Z,True,13,10,23,1,0,0,0,0,0,0,0,0
Lukaku,305,3,10,2018-08-19T15:00:00Z,False,13,2,90,8,3,3,0,0,0,0,3,0
Lukaku,305,3,25,2018-08-27T19:00:00Z,True,13,16,90,2,3,3,0,6,3,3,-3,0
Lukaku,305,3,31,2018-09-02T15:00:00Z,False,13,3,90,12,3,3,0,1,0,1,2,0
Lukaku,305,3,48,2018-09-15T16:30:00Z,False,13,17,90,6,6,3,3,12,9,3,-6,-6
Lukaku,305,3,58,2018-09-22T14:00:00Z,True,13,19,90,2,9,3,6,8,5,3,1,0
Lukaku,305,3,68,2018-09-29T11:30:00Z,False,13,18,90,2,10,4,6,4,1,3,6,5
Lukaku,305,3,76,2018-10-06T16:30:00Z,True,13,14,90,2,10,4,6,2,0,2,8,2
Lukaku,305,3,83,2018-10-20T11:30:00Z,False,13,5,90,2,13,7,6,20,10,10,-7,-4
Lukaku,305,3,96,2018-10-28T16:00:00Z,True,13,7,25,1,14,7,7,15,10,5,-1,2
Lukaku,305,3,101,2018-11-03T12:30:00Z,False,13,1,0,0,17,10,7,20,11,9,-3,-4
Lukaku,305,3,117,2018-11-11T16:30:00Z,False,13,12,33,4,20,10,10,29,18,11,-9,-8
Lukaku,305,3,125,2018-11-24T15:00:00Z,True,13,6,90,2,20,10,10,8,2,6,12,4
Lukaku,305,3,139,2018-12-01T17:30:00Z,False,13,15,85,9,21,11,10,8,4,4,13,6
Lukaku,305,3,144,2018-12-05T20:00:00Z,True,13,0,27,1,22,11,11,30,17,13,-8,-2
Lukaku,305,3,157,2018-12-08T15:00:00Z,True,13,8,90,6,23,12,11,9,8,1,14,11
Lukaku,305,3,164,2018-12-16T16:00:00Z,False,13,11,90,1,26,15,11,42,19,23,-16,-8
Lukaku,305,3,172,2018-12-22T17:30:00Z,False,13,4,0,0,26,15,11,14,13,1,12,-2
Lukaku,305,3,186,2018-12-26T15:00:00Z,True,13,9,0,0,29,15,14,10,5,5,19,10
Lukaku,305,3,196,2018-12-30T16:30:00Z,True,13,1,20,5,32,18,14,26,17,9,6,9
Lukaku,305,3,207,2019-01-02T20:00:00Z,False,13,14,27,5,35,21,14,18,7,11,17,7
Lukaku,305,3,218,2019-01-13T16:30:00Z,False,13,16,17,1,38,21,17,48,18,30,-10,-1
Lukaku,305,3,225,2019-01-19T15:00:00Z,True,13,2,7,1,41,21,20,26,18,8,15,13
Lukaku,305,3,234,2019-01-29T20:00:00Z,True,13,3,66,2,44,24,20,22,13,9,22,15
Lukaku,305,3,246,2019-02-03T14:05:00Z,False,13,10,12,1,45,25,20,32,14,18,13,6
Lukaku,305,3,252,2019-02-09T12:30:00Z,False,13,8,90,2,48,25,23,17,15,2,31,8
Lukaku,305,3,267,2019-02-24T14:05:00Z,True,13,11,90,2,51,25,26,65,35,30,-14,-5
Lukaku,305,3,272,2019-02-27T20:00:00Z,False,13,6,90,12,52,26,26,30,13,17,22,13
Lukaku,305,3,285,2019-03-02T15:00:00Z,True,13,15,90,12,55,26,29,27,15,12,28,14
Lukaku,305,3,290,2019-03-10T16:30:00Z,False,13,0,90,2,58,29,29,57,38,19,1,-9
Lukaku,305,3,318,2019-03-30T15:00:00Z,True,13,17,0,0,58,29,29,43,23,20,15,9
Lukaku,305,3,329,2019-04-02T18:45:00Z,False,13,19,72,2,61,32,29,44,24,20,17,5
Lukaku,305,3,336,2019-04-13T16:30:00Z,True,13,18,74,2,61,32,29,42,27,15,19,17
Lukaku,305,3,344,2019-04-21T12:30:00Z,False,13,7,90,2,64,35,29,46,28,18,18,1
Lukaku,305,3,305,2019-04-24T19:00:00Z,True,13,12,18,1,64,35,29,86,51,35,-22,0
Lukaku,305,3,356,2019-04-28T15:30:00Z,True,13,5,90,2,64,35,29,67,39,28,-3,7
Lukaku,305,3,365,2019-05-05T13:00:00Z,False,13,9,0,0,65,36,29,14,8,6,51,21
Lukaku,305,3,376,2019-05-12T14:00:00Z,True,13,4,0,0,66,36,30,31,20,11,35,25
Elliot,306,0,6,2018-08-11T11:30:00Z,True,14,16,0,0,0,0,0,0,0,0,0,0
Elliot,306,0,12,2018-08-18T11:30:00Z,False,14,4,0,0,0,0,0,0,0,0,0,0
Elliot,306,0,26,2018-08-26T15:00:00Z,True,14,5,0,0,1,0,1,6,3,3,-5,-3
Elliot,306,0,37,2018-09-01T16:30:00Z,False,14,12,0,0,1,0,1,7,3,4,-6,-2
Elliot,306,0,45,2018-09-15T14:00:00Z,True,14,0,0,0,1,0,1,6,3,3,-5,-3
Elliot,306,0,54,2018-09-22T14:00:00Z,False,14,6,0,0,1,0,1,6,0,6,-5,1
Elliot,306,0,67,2018-09-29T14:00:00Z,True,14,10,0,0,2,0,2,9,6,3,-7,-3
Elliot,306,0,76,2018-10-06T16:30:00Z,False,14,13,0,0,2,0,2,10,4,6,-8,-2
Elliot,306,0,87,2018-10-20T14:00:00Z,True,14,2,0,0,2,0,2,8,7,1,-6,-1
Elliot,306,0,97,2018-10-27T14:00:00Z,False,14,15,0,0,2,0,2,6,2,4,-4,0
Elliot,306,0,107,2018-11-03T15:00:00Z,True,14,17,0,0,3,0,3,19,12,7,-16,-7
Elliot,306,0,118,2018-11-10T15:00:00Z,True,14,1,0,0,6,3,3,20,11,9,-14,-6
Elliot,306,0,122,2018-11-26T20:30:00Z,False,14,3,0,0,9,6,3,9,4,5,0,-1
Elliot,306,0,138,2018-12-01T15:00:00Z,True,14,18,0,0,12,6,6,12,7,5,0,1
Elliot,306,0,148,2018-12-05T19:45:00Z,False,14,7,0,0,12,6,6,22,16,6,-10,-10
Elliot,306,0,158,2018-12-09T16:00:00Z,True,14,19,0,0,13,6,7,19,11,8,-6,-2
Elliot,306,0,163,2018-12-15T15:00:00Z,False,14,9,0,0,13,6,7,10,5,5,3,2
Elliot,306,0,177,2018-12-22T15:00:00Z,True,14,8,0,0,16,6,10,9,8,1,7,5
Elliot,306,0,185,2018-12-26T15:00:00Z,False,14,11,0,0,17,7,10,48,22,26,-31,-12
Elliot,306,0,199,2018-12-29T15:00:00Z,False,14,17,0,0,17,7,10,27,15,12,-10,-5
Elliot,306,0,207,2019-01-02T20:00:00Z,True,14,13,0,0,18,7,11,35,21,14,-17,-7
Elliot,306,0,213,2019-01-12T17:30:00Z,False,14,5,0,0,18,7,11,44,22,22,-26,-11
Elliot,306,0,226,2019-01-19T15:00:00Z,True,14,4,0,0,18,7,11,19,14,5,-1,2
Elliot,306,0,237,2019-01-29T20:00:00Z,True,14,12,0,0,21,10,11,56,33,23,-35,-13
Elliot,306,0,248,2019-02-02T12:30:00Z,False,14,16,0,0,24,13,11,54,21,33,-30,-10
Elliot,306,0,259,2019-02-11T20:00:00Z,False,14,19,0,0,24,13,11,38,20,18,-14,-9
Elliot,306,0,268,2019-02-23T15:00:00Z,True,14,9,0,0,25,13,12,11,5,6,14,7
Elliot,306,0,278,2019-02-26T20:00:00Z,True,14,3,0,0,28,16,12,30,17,13,-2,3
Elliot,306,0,288,2019-03-02T17:30:00Z,False,14,18,0,0,31,19,12,36,21,15,-5,-9
Elliot,306,0,298,2019-03-09T15:00:00Z,True,14,7,0,0,31,19,12,37,22,15,-6,4
Elliot,306,0,300,2019-03-16T15:00:00Z,False,14,1,0,0,34,22,12,37,25,12,-3,-13
Elliot,306,0,310,2019-04-01T19:00:00Z,False,14,0,0,0,35,22,13,60,41,19,-25,-28
Elliot,306,0,325,2019-04-06T14:00:00Z,True,14,6,0,0,35,22,13,36,16,20,-1,2
Elliot,306,0,334,2019-04-12T19:00:00Z,False,14,10,0,0,35,22,13,47,23,24,-12,-10
Elliot,306,0,347,2019-04-20T16:30:00Z,True,14,15,0,0,38,22,16,36,21,15,2,7
Elliot,306,0,350,2019-04-27T16:30:00Z,False,14,2,0,0,41,25,16,34,22,12,7,-6
Elliot,306,0,367,2019-05-04T18:45:00Z,True,14,11,0,0,42,25,17,91,50,41,-49,-16
Elliot,306,0,373,2019-05-12T14:00:00Z,False,14,8,0,0,42,25,17,26,21,5,16,-4
Darlow,307,0,6,2018-08-11T11:30:00Z,True,14,16,0,0,0,0,0,0,0,0,0,0
Darlow,307,0,12,2018-08-18T11:30:00Z,False,14,4,0,0,0,0,0,0,0,0,0,0
Darlow,307,0,26,2018-08-26T15:00:00Z,True,14,5,0,0,1,0,1,6,3,3,-5,-3
Darlow,307,0,37,2018-09-01T16:30:00Z,False,14,12,0,0,1,0,1,7,3,4,-6,-2
Darlow,307,0,45,2018-09-15T14:00:00Z,True,14,0,0,0,1,0,1,6,3,3,-5,-3
Darlow,307,0,54,2018-09-22T14:00:00Z,False,14,6,0,0,1,0,1,6,0,6,-5,1
Darlow,307,0,67,2018-09-29T14:00:00Z,True,14,10,0,0,2,0,2,9,6,3,-7,-3
Darlow,307,0,76,2018-10-06T16:30:00Z,False,14,13,0,0,2,0,2,10,4,6,-8,-2
Darlow,307,0,87,2018-10-20T14:00:00Z,True,14,2,0,0,2,0,2,8,7,1,-6,-1
Darlow,307,0,97,2018-10-27T14:00:00Z,False,14,15,0,0,2,0,2,6,2,4,-4,0
Darlow,307,0,107,2018-11-03T15:00:00Z,True,14,17,0,0,3,0,3,19,12,7,-16,-7
Darlow,307,0,118,2018-11-10T15:00:00Z,True,14,1,0,0,6,3,3,20,11,9,-14,-6
Darlow,307,0,122,2018-11-26T20:30:00Z,False,14,3,0,0,9,6,3,9,4,5,0,-1
Darlow,307,0,138,2018-12-01T15:00:00Z,True,14,18,0,0,12,6,6,12,7,5,0,1
Darlow,307,0,148,2018-12-05T19:45:00Z,False,14,7,0,0,12,6,6,22,16,6,-10,-10
Darlow,307,0,158,2018-12-09T16:00:00Z,True,14,19,0,0,13,6,7,19,11,8,-6,-2
Darlow,307,0,163,2018-12-15T15:00:00Z,False,14,9,0,0,13,6,7,10,5,5,3,2
Darlow,307,0,177,2018-12-22T15:00:00Z,True,14,8,0,0,16,6,10,9,8,1,7,5
Darlow,307,0,185,2018-12-26T15:00:00Z,False,14,11,0,0,17,7,10,48,22,26,-31,-12
Darlow,307,0,199,2018-12-29T15:00:00Z,False,14,17,0,0,17,7,10,27,15,12,-10,-5
Darlow,307,0,207,2019-01-02T20:00:00Z,True,14,13,0,0,18,7,11,35,21,14,-17,-7
Darlow,307,0,213,2019-01-12T17:30:00Z,False,14,5,0,0,18,7,11,44,22,22,-26,-11
Darlow,307,0,226,2019-01-19T15:00:00Z,True,14,4,0,0,18,7,11,19,14,5,-1,2
Darlow,307,0,237,2019-01-29T20:00:00Z,True,14,12,0,0,21,10,11,56,33,23,-35,-13
Darlow,307,0,248,2019-02-02T12:30:00Z,False,14,16,0,0,24,13,11,54,21,33,-30,-10
Darlow,307,0,259,2019-02-11T20:00:00Z,False,14,19,0,0,24,13,11,38,20,18,-14,-9
Darlow,307,0,268,2019-02-23T15:00:00Z,True,14,9,0,0,25,13,12,11,5,6,14,7
Darlow,307,0,278,2019-02-26T20:00:00Z,True,14,3,0,0,28,16,12,30,17,13,-2,3
Darlow,307,0,288,2019-03-02T17:30:00Z,False,14,18,0,0,31,19,12,36,21,15,-5,-9
Darlow,307,0,298,2019-03-09T15:00:00Z,True,14,7,0,0,31,19,12,37,22,15,-6,4
Darlow,307,0,300,2019-03-16T15:00:00Z,False,14,1,0,0,34,22,12,37,25,12,-3,-13
Darlow,307,0,310,2019-04-01T19:00:00Z,False,14,0,0,0,35,22,13,60,41,19,-25,-28
Darlow,307,0,325,2019-04-06T14:00:00Z,True,14,6,0,0,35,22,13,36,16,20,-1,2
Darlow,307,0,334,2019-04-12T19:00:00Z,False,14,10,0,0,35,22,13,47,23,24,-12,-10
Darlow,307,0,347,2019-04-20T16:30:00Z,True,14,15,0,0,38,22,16,36,21,15,2,7
Darlow,307,0,350,2019-04-27T16:30:00Z,False,14,2,0,0,41,25,16,34,22,12,7,-6
Darlow,307,0,367,2019-05-04T18:45:00Z,True,14,11,0,0,42,25,17,91,50,41,-49,-16
Darlow,307,0,373,2019-05-12T14:00:00Z,False,14,8,0,0,42,25,17,26,21,5,16,-4
Dubravka,308,0,6,2018-08-11T11:30:00Z,True,14,16,90,2,0,0,0,0,0,0,0,0
Dubravka,308,0,12,2018-08-18T11:30:00Z,False,14,4,90,6,0,0,0,0,0,0,0,0
Dubravka,308,0,26,2018-08-26T15:00:00Z,True,14,5,90,1,1,0,1,6,3,3,-5,-3
Dubravka,308,0,37,2018-09-01T16:30:00Z,False,14,12,90,3,1,0,1,7,3,4,-6,-2
Dubravka,308,0,45,2018-09-15T14:00:00Z,True,14,0,90,1,1,0,1,6,3,3,-5,-3
Dubravka,308,0,54,2018-09-22T14:00:00Z,False,14,6,90,10,1,0,1,6,0,6,-5,1
Dubravka,308,0,67,2018-09-29T14:00:00Z,True,14,10,90,2,2,0,2,9,6,3,-7,-3
Dubravka,308,0,76,2018-10-06T16:30:00Z,False,14,13,90,3,2,0,2,10,4,6,-8,-2
Dubravka,308,0,87,2018-10-20T14:00:00Z,True,14,2,90,2,2,0,2,8,7,1,-6,-1
Dubravka,308,0,97,2018-10-27T14:00:00Z,False,14,15,90,9,2,0,2,6,2,4,-4,0
Dubravka,308,0,107,2018-11-03T15:00:00Z,True,14,17,90,6,3,0,3,19,12,7,-16,-7
Dubravka,308,0,118,2018-11-10T15:00:00Z,True,14,1,90,3,6,3,3,20,11,9,-14,-6
Dubravka,308,0,122,2018-11-26T20:30:00Z,False,14,3,90,3,9,6,3,9,4,5,0,-1
Dubravka,308,0,138,2018-12-01T15:00:00Z,True,14,18,90,1,12,6,6,12,7,5,0,1
Dubravka,308,0,148,2018-12-05T19:45:00Z,False,14,7,90,2,12,6,6,22,16,6,-10,-10
Dubravka,308,0,158,2018-12-09T16:00:00Z,True,14,19,90,2,13,6,7,19,11,8,-6,-2
Dubravka,308,0,163,2018-12-15T15:00:00Z,False,14,9,90,9,13,6,7,10,5,5,3,2
Dubravka,308,0,177,2018-12-22T15:00:00Z,True,14,8,90,6,16,6,10,9,8,1,7,5
Dubravka,308,0,185,2018-12-26T15:00:00Z,False,14,11,90,1,17,7,10,48,22,26,-31,-12
Dubravka,308,0,199,2018-12-29T15:00:00Z,False,14,17,90,3,17,7,10,27,15,12,-10,-5
Dubravka,308,0,207,2019-01-02T20:00:00Z,True,14,13,90,2,18,7,11,35,21,14,-17,-7
Dubravka,308,0,213,2019-01-12T17:30:00Z,False,14,5,90,2,18,7,11,44,22,22,-26,-11
Dubravka,308,0,226,2019-01-19T15:00:00Z,True,14,4,90,6,18,7,11,19,14,5,-1,2
Dubravka,308,0,237,2019-01-29T20:00:00Z,True,14,12,90,2,21,10,11,56,33,23,-35,-13
Dubravka,308,0,248,2019-02-02T12:30:00Z,False,14,16,90,2,24,13,11,54,21,33,-30,-10
Dubravka,308,0,259,2019-02-11T20:00:00Z,False,14,19,90,4,24,13,11,38,20,18,-14,-9
Dubravka,308,0,268,2019-02-23T15:00:00Z,True,14,9,90,6,25,13,12,11,5,6,14,7
Dubravka,308,0,278,2019-02-26T20:00:00Z,True,14,3,90,6,28,16,12,30,17,13,-2,3
Dubravka,308,0,288,2019-03-02T17:30:00Z,False,14,18,90,0,31,19,12,36,21,15,-5,-9
Dubravka,308,0,298,2019-03-09T15:00:00Z,True,14,7,90,1,31,19,12,37,22,15,-6,4
Dubravka,308,0,300,2019-03-16T15:00:00Z,False,14,1,90,1,34,22,12,37,25,12,-3,-13
Dubravka,308,0,310,2019-04-01T19:00:00Z,False,14,0,90,1,35,22,13,60,41,19,-25,-28
Dubravka,308,0,325,2019-04-06T14:00:00Z,True,14,6,90,2,35,22,13,36,16,20,-1,2
Dubravka,308,0,334,2019-04-12T19:00:00Z,False,14,10,90,9,35,22,13,47,23,24,-12,-10
Dubravka,308,0,347,2019-04-20T16:30:00Z,True,14,15,90,3,38,22,16,36,21,15,2,7
Dubravka,308,0,350,2019-04-27T16:30:00Z,False,14,2,90,2,41,25,16,34,22,12,7,-6
Dubravka,308,0,367,2019-05-04T18:45:00Z,True,14,11,90,1,42,25,17,91,50,41,-49,-16
Dubravka,308,0,373,2019-05-12T14:00:00Z,False,14,8,90,6,42,25,17,26,21,5,16,-4
Yedlin,309,1,6,2018-08-11T11:30:00Z,True,14,16,90,1,0,0,0,0,0,0,0,0
Yedlin,309,1,12,2018-08-18T11:30:00Z,False,14,4,0,0,0,0,0,0,0,0,0,0
Yedlin,309,1,26,2018-08-26T15:00:00Z,True,14,5,90,2,1,0,1,6,3,3,-5,-3
Yedlin,309,1,37,2018-09-01T16:30:00Z,False,14,12,90,7,1,0,1,7,3,4,-6,-2
Yedlin,309,1,45,2018-09-15T14:00:00Z,True,14,0,90,1,1,0,1,6,3,3,-5,-3
Yedlin,309,1,54,2018-09-22T14:00:00Z,False,14,6,90,5,1,0,1,6,0,6,-5,1
Yedlin,309,1,67,2018-09-29T14:00:00Z,True,14,10,79,1,2,0,2,9,6,3,-7,-3
Yedlin,309,1,76,2018-10-06T16:30:00Z,False,14,13,90,1,2,0,2,10,4,6,-8,-2
Yedlin,309,1,87,2018-10-20T14:00:00Z,True,14,2,90,2,2,0,2,8,7,1,-6,-1
Yedlin,309,1,97,2018-10-27T14:00:00Z,False,14,15,90,6,2,0,2,6,2,4,-4,0
Yedlin,309,1,107,2018-11-03T15:00:00Z,True,14,17,90,7,3,0,3,19,12,7,-16,-7
Yedlin,309,1,118,2018-11-10T15:00:00Z,True,14,1,90,2,6,3,3,20,11,9,-14,-6
Yedlin,309,1,122,2018-11-26T20:30:00Z,False,14,3,90,2,9,6,3,9,4,5,0,-1
Yedlin,309,1,138,2018-12-01T15:00:00Z,True,14,18,90,0,12,6,6,12,7,5,0,1
Yedlin,309,1,148,2018-12-05T19:45:00Z,False,14,7,90,1,12,6,6,22,16,6,-10,-10
Yedlin,309,1,158,2018-12-09T16:00:00Z,True,14,19,56,-3,13,6,7,19,11,8,-6,-2
Yedlin,309,1,163,2018-12-15T15:00:00Z,False,14,9,0,0,13,6,7,10,5,5,3,2
Yedlin,309,1,177,2018-12-22T15:00:00Z,True,14,8,6,1,16,6,10,9,8,1,7,5
Yedlin,309,1,185,2018-12-26T15:00:00Z,False,14,11,90,0,17,7,10,48,22,26,-31,-12
Yedlin,309,1,199,2018-12-29T15:00:00Z,False,14,17,90,1,17,7,10,27,15,12,-10,-5
Yedlin,309,1,207,2019-01-02T20:00:00Z,True,14,13,90,1,18,7,11,35,21,14,-17,-7
Yedlin,309,1,213,2019-01-12T17:30:00Z,False,14,5,81,1,18,7,11,44,22,22,-26,-11
Yedlin,309,1,226,2019-01-19T15:00:00Z,True,14,4,90,6,18,7,11,19,14,5,-1,2
Yedlin,309,1,237,2019-01-29T20:00:00Z,True,14,12,90,2,21,10,11,56,33,23,-35,-13
Yedlin,309,1,248,2019-02-02T12:30:00Z,False,14,16,90,1,24,13,11,54,21,33,-30,-10
Yedlin,309,1,259,2019-02-11T20:00:00Z,False,14,19,90,2,24,13,11,38,20,18,-14,-9
Yedlin,309,1,268,2019-02-23T15:00:00Z,True,14,9,90,5,25,13,12,11,5,6,14,7
Yedlin,309,1,278,2019-02-26T20:00:00Z,True,14,3,0,0,28,16,12,30,17,13,-2,3
Yedlin,309,1,288,2019-03-02T17:30:00Z,False,14,18,0,0,31,19,12,36,21,15,-5,-9
Yedlin,309,1,298,2019-03-09T15:00:00Z,True,14,7,90,1,31,19,12,37,22,15,-6,4
Yedlin,309,1,300,2019-03-16T15:00:00Z,False,14,1,90,4,34,22,12,37,25,12,-3,-13
Yedlin,309,1,310,2019-04-01T19:00:00Z,False,14,0,90,1,35,22,13,60,41,19,-25,-28
Yedlin,309,1,325,2019-04-06T14:00:00Z,True,14,6,90,2,35,22,13,36,16,20,-1,2
Yedlin,309,1,334,2019-04-12T19:00:00Z,False,14,10,0,0,35,22,13,47,23,24,-12,-10
Yedlin,309,1,347,2019-04-20T16:30:00Z,True,14,15,0,0,38,22,16,36,21,15,2,7
Yedlin,309,1,350,2019-04-27T16:30:00Z,False,14,2,0,0,41,25,16,34,22,12,7,-6
Yedlin,309,1,367,2019-05-04T18:45:00Z,True,14,11,0,0,42,25,17,91,50,41,-49,-16
Yedlin,309,1,373,2019-05-12T14:00:00Z,False,14,8,0,0,42,25,17,26,21,5,16,-4
Clark,310,1,6,2018-08-11T11:30:00Z,True,14,16,90,1,0,0,0,0,0,0,0,0
Clark,310,1,12,2018-08-18T11:30:00Z,False,14,4,90,6,0,0,0,0,0,0,0,0
Clark,310,1,26,2018-08-26T15:00:00Z,True,14,5,90,1,1,0,1,6,3,3,-5,-3
Clark,310,1,37,2018-09-01T16:30:00Z,False,14,12,80,1,1,0,1,7,3,4,-6,-2
Clark,310,1,45,2018-09-15T14:00:00Z,True,14,0,45,6,1,0,1,6,3,3,-5,-3
Clark,310,1,54,2018-09-22T14:00:00Z,False,14,6,0,0,1,0,1,6,0,6,-5,1
Clark,310,1,67,2018-09-29T14:00:00Z,True,14,10,90,1,2,0,2,9,6,3,-7,-3
Clark,310,1,76,2018-10-06T16:30:00Z,False,14,13,0,0,2,0,2,10,4,6,-8,-2
Clark,310,1,87,2018-10-20T14:00:00Z,True,14,2,0,0,2,0,2,8,7,1,-6,-1
Clark,310,1,97,2018-10-27T14:00:00Z,False,14,15,0,0,2,0,2,6,2,4,-4,0
Clark,310,1,107,2018-11-03T15:00:00Z,True,14,17,0,0,3,0,3,19,12,7,-16,-7
Clark,310,1,118,2018-11-10T15:00:00Z,True,14,1,12,1,6,3,3,20,11,9,-14,-6
Clark,310,1,122,2018-11-26T20:30:00Z,False,14,3,90,11,9,6,3,9,4,5,0,-1
Clark,310,1,138,2018-12-01T15:00:00Z,True,14,18,0,0,12,6,6,12,7,5,0,1
Clark,310,1,148,2018-12-05T19:45:00Z,False,14,7,0,0,12,6,6,22,16,6,-10,-10
Clark,310,1,158,2018-12-09T16:00:00Z,True,14,19,90,0,13,6,7,19,11,8,-6,-2
Clark,310,1,163,2018-12-15T15:00:00Z,False,14,9,90,6,13,6,7,10,5,5,3,2
Clark,310,1,177,2018-12-22T15:00:00Z,True,14,8,0,0,16,6,10,9,8,1,7,5
Clark,310,1,185,2018-12-26T15:00:00Z,False,14,11,0,0,17,7,10,48,22,26,-31,-12
Clark,310,1,199,2018-12-29T15:00:00Z,False,14,17,0,0,17,7,10,27,15,12,-10,-5
Clark,310,1,207,2019-01-02T20:00:00Z,True,14,13,0,0,18,7,11,35,21,14,-17,-7
Clark,310,1,213,2019-01-12T17:30:00Z,False,14,5,90,8,18,7,11,44,22,22,-26,-11
Clark,310,1,226,2019-01-19T15:00:00Z,True,14,4,0,0,18,7,11,19,14,5,-1,2
Clark,310,1,237,2019-01-29T20:00:00Z,True,14,12,0,0,21,10,11,56,33,23,-35,-13
Clark,310,1,248,2019-02-02T12:30:00Z,False,14,16,0,0,24,13,11,54,21,33,-30,-10
Clark,310,1,259,2019-02-11T20:00:00Z,False,14,19,0,0,24,13,11,38,20,18,-14,-9
Clark,310,1,268,2019-02-23T15:00:00Z,True,14,9,0,0,25,13,12,11,5,6,14,7
Clark,310,1,278,2019-02-26T20:00:00Z,True,14,3,0,0,28,16,12,30,17,13,-2,3
Clark,310,1,288,2019-03-02T17:30:00Z,False,14,18,0,0,31,19,12,36,21,15,-5,-9
Clark,310,1,298,2019-03-09T15:00:00Z,True,14,7,0,0,31,19,12,37,22,15,-6,4
Clark,310,1,300,2019-03-16T15:00:00Z,False,14,1,0,0,34,22,12,37,25,12,-3,-13
Clark,310,1,310,2019-04-01T19:00:00Z,False,14,0,0,0,35,22,13,60,41,19,-25,-28
Clark,310,1,325,2019-04-06T14:00:00Z,True,14,6,0,0,35,22,13,36,16,20,-1,2
Clark,310,1,334,2019-04-12T19:00:00Z,False,14,10,0,0,35,22,13,47,23,24,-12,-10
Clark,310,1,347,2019-04-20T16:30:00Z,True,14,15,0,0,38,22,16,36,21,15,2,7
Clark,310,1,350,2019-04-27T16:30:00Z,False,14,2,0,0,41,25,16,34,22,12,7,-6
Clark,310,1,367,2019-05-04T18:45:00Z,True,14,11,0,0,42,25,17,91,50,41,-49,-16
Clark,310,1,373,2019-05-12T14:00:00Z,False,14,8,0,0,42,25,17,26,21,5,16,-4
Lascelles,311,1,6,2018-08-11T11:30:00Z,True,14,16,90,1,0,0,0,0,0,0,0,0
Lascelles,311,1,12,2018-08-18T11:30:00Z,False,14,4,90,8,0,0,0,0,0,0,0,0
Lascelles,311,1,26,2018-08-26T15:00:00Z,True,14,5,0,0,1,0,1,6,3,3,-5,-3
Lascelles,311,1,37,2018-09-01T16:30:00Z,False,14,12,90,1,1,0,1,7,3,4,-6,-2
Lascelles,311,1,45,2018-09-15T14:00:00Z,True,14,0,45,1,1,0,1,6,3,3,-5,-3
Lascelles,311,1,54,2018-09-22T14:00:00Z,False,14,6,90,6,1,0,1,6,0,6,-5,1
Lascelles,311,1,67,2018-09-29T14:00:00Z,True,14,10,90,1,2,0,2,9,6,3,-7,-3
Lascelles,311,1,76,2018-10-06T16:30:00Z,False,14,13,90,1,2,0,2,10,4,6,-8,-2
Lascelles,311,1,87,2018-10-20T14:00:00Z,True,14,2,90,2,2,0,2,8,7,1,-6,-1
Lascelles,311,1,97,2018-10-27T14:00:00Z,False,14,15,90,9,2,0,2,6,2,4,-4,0
Lascelles,311,1,107,2018-11-03T15:00:00Z,True,14,17,45,1,3,0,3,19,12,7,-16,-7
Lascelles,311,1,118,2018-11-10T15:00:00Z,True,14,1,0,0,6,3,3,20,11,9,-14,-6
Lascelles,311,1,122,2018-11-26T20:30:00Z,False,14,3,0,0,9,6,3,9,4,5,0,-1
Lascelles,311,1,138,2018-12-01T15:00:00Z,True,14,18,0,0,12,6,6,12,7,5,0,1
Lascelles,311,1,148,2018-12-05T19:45:00Z,False,14,7,90,2,12,6,6,22,16,6,-10,-10
Lascelles,311,1,158,2018-12-09T16:00:00Z,True,14,19,90,1,13,6,7,19,11,8,-6,-2
Lascelles,311,1,163,2018-12-15T15:00:00Z,False,14,9,90,5,13,6,7,10,5,5,3,2
Lascelles,311,1,177,2018-12-22T15:00:00Z,True,14,8,90,6,16,6,10,9,8,1,7,5
Lascelles,311,1,185,2018-12-26T15:00:00Z,False,14,11,90,0,17,7,10,48,22,26,-31,-12
Lascelles,311,1,199,2018-12-29T15:00:00Z,False,14,17,90,2,17,7,10,27,15,12,-10,-5
Lascelles,311,1,207,2019-01-02T20:00:00Z,True,14,13,90,0,18,7,11,35,21,14,-17,-7
Lascelles,311,1,213,2019-01-12T17:30:00Z,False,14,5,90,1,18,7,11,44,22,22,-26,-11
Lascelles,311,1,226,2019-01-19T15:00:00Z,True,14,4,90,11,18,7,11,19,14,5,-1,2
Lascelles,311,1,237,2019-01-29T20:00:00Z,True,14,12,90,2,21,10,11,56,33,23,-35,-13
Lascelles,311,1,248,2019-02-02T12:30:00Z,False,14,16,90,2,24,13,11,54,21,33,-30,-10
Lascelles,311,1,259,2019-02-11T20:00:00Z,False,14,19,90,1,24,13,11,38,20,18,-14,-9
Lascelles,311,1,268,2019-02-23T15:00:00Z,True,14,9,90,6,25,13,12,11,5,6,14,7
Lascelles,311,1,278,2019-02-26T20:00:00Z,True,14,3,90,6,28,16,12,30,17,13,-2,3
Lascelles,311,1,288,2019-03-02T17:30:00Z,False,14,18,90,1,31,19,12,36,21,15,-5,-9
Lascelles,311,1,298,2019-03-09T15:00:00Z,True,14,7,45,-1,31,19,12,37,22,15,-6,4
Lascelles,311,1,300,2019-03-16T15:00:00Z,False,14,1,0,0,34,22,12,37,25,12,-3,-13
Lascelles,311,1,310,2019-04-01T19:00:00Z,False,14,0,90,1,35,22,13,60,41,19,-25,-28
Lascelles,311,1,325,2019-04-06T14:00:00Z,True,14,6,90,2,35,22,13,36,16,20,-1,2
Lascelles,311,1,334,2019-04-12T19:00:00Z,False,14,10,90,7,35,22,13,47,23,24,-12,-10
Lascelles,311,1,347,2019-04-20T16:30:00Z,True,14,15,90,2,38,22,16,36,21,15,2,7
Lascelles,311,1,350,2019-04-27T16:30:00Z,False,14,2,0,0,41,25,16,34,22,12,7,-6
Lascelles,311,1,367,2019-05-04T18:45:00Z,True,14,11,90,1,42,25,17,91,50,41,-49,-16
Lascelles,311,1,373,2019-05-12T14:00:00Z,False,14,8,90,6,42,25,17,26,21,5,16,-4
Dummett,312,1,6,2018-08-11T11:30:00Z,True,14,16,90,1,0,0,0,0,0,0,0,0
Dummett,312,1,12,2018-08-18T11:30:00Z,False,14,4,90,6,0,0,0,0,0,0,0,0
Dummett,312,1,26,2018-08-26T15:00:00Z,True,14,5,90,1,1,0,1,6,3,3,-5,-3
Dummett,312,1,37,2018-09-01T16:30:00Z,False,14,12,90,1,1,0,1,7,3,4,-6,-2
Dummett,312,1,45,2018-09-15T14:00:00Z,True,14,0,90,1,1,0,1,6,3,3,-5,-3
Dummett,312,1,54,2018-09-22T14:00:00Z,False,14,6,90,6,1,0,1,6,0,6,-5,1
Dummett,312,1,67,2018-09-29T14:00:00Z,True,14,10,0,0,2,0,2,9,6,3,-7,-3
Dummett,312,1,76,2018-10-06T16:30:00Z,False,14,13,0,0,2,0,2,10,4,6,-8,-2
Dummett,312,1,87,2018-10-20T14:00:00Z,True,14,2,90,2,2,0,2,8,7,1,-6,-1
Dummett,312,1,97,2018-10-27T14:00:00Z,False,14,15,90,6,2,0,2,6,2,4,-4,0
Dummett,312,1,107,2018-11-03T15:00:00Z,True,14,17,90,6,3,0,3,19,12,7,-16,-7
Dummett,312,1,118,2018-11-10T15:00:00Z,True,14,1,90,2,6,3,3,20,11,9,-14,-6
Dummett,312,1,122,2018-11-26T20:30:00Z,False,14,3,0,0,9,6,3,9,4,5,0,-1
Dummett,312,1,138,2018-12-01T15:00:00Z,True,14,18,0,0,12,6,6,12,7,5,0,1
Dummett,312,1,148,2018-12-05T19:45:00Z,False,14,7,0,0,12,6,6,22,16,6,-10,-10
Dummett,312,1,158,2018-12-09T16:00:00Z,True,14,19,0,0,13,6,7,19,11,8,-6,-2
Dummett,312,1,163,2018-12-15T15:00:00Z,False,14,9,1,1,13,6,7,10,5,5,3,2
Dummett,312,1,177,2018-12-22T15:00:00Z,True,14,8,90,9,16,6,10,9,8,1,7,5
Dummett,312,1,185,2018-12-26T15:00:00Z,False,14,11,90,0,17,7,10,48,22,26,-31,-12
Dummett,312,1,199,2018-12-29T15:00:00Z,False,14,17,90,2,17,7,10,27,15,12,-10,-5
Dummett,312,1,207,2019-01-02T20:00:00Z,True,14,13,90,1,18,7,11,35,21,14,-17,-7
Dummett,312,1,213,2019-01-12T17:30:00Z,False,14,5,0,0,18,7,11,44,22,22,-26,-11
Dummett,312,1,226,2019-01-19T15:00:00Z,True,14,4,0,0,18,7,11,19,14,5,-1,2
Dummett,312,1,237,2019-01-29T20:00:00Z,True,14,12,0,0,21,10,11,56,33,23,-35,-13
Dummett,312,1,248,2019-02-02T12:30:00Z,False,14,16,0,0,24,13,11,54,21,33,-30,-10
Dummett,312,1,259,2019-02-11T20:00:00Z,False,14,19,0,0,24,13,11,38,20,18,-14,-9
Dummett,312,1,268,2019-02-23T15:00:00Z,True,14,9,0,0,25,13,12,11,5,6,14,7
Dummett,312,1,278,2019-02-26T20:00:00Z,True,14,3,10,1,28,16,12,30,17,13,-2,3
Dummett,312,1,288,2019-03-02T17:30:00Z,False,14,18,25,1,31,19,12,36,21,15,-5,-9
Dummett,312,1,298,2019-03-09T15:00:00Z,True,14,7,45,1,31,19,12,37,22,15,-6,4
Dummett,312,1,300,2019-03-16T15:00:00Z,False,14,1,90,1,34,22,12,37,25,12,-3,-13
Dummett,312,1,310,2019-04-01T19:00:00Z,False,14,0,90,1,35,22,13,60,41,19,-25,-28
Dummett,312,1,325,2019-04-06T14:00:00Z,True,14,6,25,1,35,22,13,36,16,20,-1,2
Dummett,312,1,334,2019-04-12T19:00:00Z,False,14,10,90,6,35,22,13,47,23,24,-12,-10
Dummett,312,1,347,2019-04-20T16:30:00Z,True,14,15,90,2,38,22,16,36,21,15,2,7
Dummett,312,1,350,2019-04-27T16:30:00Z,False,14,2,90,1,41,25,16,34,22,12,7,-6
Dummett,312,1,367,2019-05-04T18:45:00Z,True,14,11,90,1,42,25,17,91,50,41,-49,-16
Dummett,312,1,373,2019-05-12T14:00:00Z,False,14,8,80,6,42,25,17,26,21,5,16,-4
Lejeune,313,1,6,2018-08-11T11:30:00Z,True,14,16,0,0,0,0,0,0,0,0,0,0
Lejeune,313,1,12,2018-08-18T11:30:00Z,False,14,4,0,0,0,0,0,0,0,0,0,0
Lejeune,313,1,26,2018-08-26T15:00:00Z,True,14,5,0,0,1,0,1,6,3,3,-5,-3
Lejeune,313,1,37,2018-09-01T16:30:00Z,False,14,12,0,0,1,0,1,7,3,4,-6,-2
Lejeune,313,1,45,2018-09-15T14:00:00Z,True,14,0,0,0,1,0,1,6,3,3,-5,-3
Lejeune,313,1,54,2018-09-22T14:00:00Z,False,14,6,0,0,1,0,1,6,0,6,-5,1
Lejeune,313,1,67,2018-09-29T14:00:00Z,True,14,10,0,0,2,0,2,9,6,3,-7,-3
Lejeune,313,1,76,2018-10-06T16:30:00Z,False,14,13,0,0,2,0,2,10,4,6,-8,-2
Lejeune,313,1,87,2018-10-20T14:00:00Z,True,14,2,0,0,2,0,2,8,7,1,-6,-1
Lejeune,313,1,97,2018-10-27T14:00:00Z,False,14,15,0,0,2,0,2,6,2,4,-4,0
Lejeune,313,1,107,2018-11-03T15:00:00Z,True,14,17,0,0,3,0,3,19,12,7,-16,-7
Lejeune,313,1,118,2018-11-10T15:00:00Z,True,14,1,0,0,6,3,3,20,11,9,-14,-6
Lejeune,313,1,122,2018-11-26T20:30:00Z,False,14,3,0,0,9,6,3,9,4,5,0,-1
Lejeune,313,1,138,2018-12-01T15:00:00Z,True,14,18,0,0,12,6,6,12,7,5,0,1
Lejeune,313,1,148,2018-12-05T19:45:00Z,False,14,7,0,0,12,6,6,22,16,6,-10,-10
Lejeune,313,1,158,2018-12-09T16:00:00Z,True,14,19,0,0,13,6,7,19,11,8,-6,-2
Lejeune,313,1,163,2018-12-15T15:00:00Z,False,14,9,0,0,13,6,7,10,5,5,3,2
Lejeune,313,1,177,2018-12-22T15:00:00Z,True,14,8,0,0,16,6,10,9,8,1,7,5
Lejeune,313,1,185,2018-12-26T15:00:00Z,False,14,11,0,0,17,7,10,48,22,26,-31,-12
Lejeune,313,1,199,2018-12-29T15:00:00Z,False,14,17,0,0,17,7,10,27,15,12,-10,-5
Lejeune,313,1,207,2019-01-02T20:00:00Z,True,14,13,0,0,18,7,11,35,21,14,-17,-7
Lejeune,313,1,213,2019-01-12T17:30:00Z,False,14,5,90,1,18,7,11,44,22,22,-26,-11
Lejeune,313,1,226,2019-01-19T15:00:00Z,True,14,4,90,6,18,7,11,19,14,5,-1,2
Lejeune,313,1,237,2019-01-29T20:00:00Z,True,14,12,90,2,21,10,11,56,33,23,-35,-13
Lejeune,313,1,248,2019-02-02T12:30:00Z,False,14,16,90,2,24,13,11,54,21,33,-30,-10
Lejeune,313,1,259,2019-02-11T20:00:00Z,False,14,19,90,2,24,13,11,38,20,18,-14,-9
Lejeune,313,1,268,2019-02-23T15:00:00Z,True,14,9,90,6,25,13,12,11,5,6,14,7
Lejeune,313,1,278,2019-02-26T20:00:00Z,True,14,3,90,6,28,16,12,30,17,13,-2,3
Lejeune,313,1,288,2019-03-02T17:30:00Z,False,14,18,90,1,31,19,12,36,21,15,-5,-9
Lejeune,313,1,298,2019-03-09T15:00:00Z,True,14,7,90,1,31,19,12,37,22,15,-6,4
Lejeune,313,1,300,2019-03-16T15:00:00Z,False,14,1,90,1,34,22,12,37,25,12,-3,-13
Lejeune,313,1,310,2019-04-01T19:00:00Z,False,14,0,90,1,35,22,13,60,41,19,-25,-28
Lejeune,313,1,325,2019-04-06T14:00:00Z,True,14,6,64,6,35,22,13,36,16,20,-1,2
Lejeune,313,1,334,2019-04-12T19:00:00Z,False,14,10,0,0,35,22,13,47,23,24,-12,-10
Lejeune,313,1,347,2019-04-20T16:30:00Z,True,14,15,0,0,38,22,16,36,21,15,2,7
Lejeune,313,1,350,2019-04-27T16:30:00Z,False,14,2,0,0,41,25,16,34,22,12,7,-6
Lejeune,313,1,367,2019-05-04T18:45:00Z,True,14,11,0,0,42,25,17,91,50,41,-49,-16
Lejeune,313,1,373,2019-05-12T14:00:00Z,False,14,8,0,0,42,25,17,26,21,5,16,-4
Manquillo,314,1,6,2018-08-11T11:30:00Z,True,14,16,0,0,0,0,0,0,0,0,0,0
Manquillo,314,1,12,2018-08-18T11:30:00Z,False,14,4,45,0,0,0,0,0,0,0,0,0
Manquillo,314,1,26,2018-08-26T15:00:00Z,True,14,5,0,0,1,0,1,6,3,3,-5,-3
Manquillo,314,1,37,2018-09-01T16:30:00Z,False,14,12,0,0,1,0,1,7,3,4,-6,-2
Manquillo,314,1,45,2018-09-15T14:00:00Z,True,14,0,0,0,1,0,1,6,3,3,-5,-3
Manquillo,314,1,54,2018-09-22T14:00:00Z,False,14,6,0,0,1,0,1,6,0,6,-5,1
Manquillo,314,1,67,2018-09-29T14:00:00Z,True,14,10,10,1,2,0,2,9,6,3,-7,-3
Manquillo,314,1,76,2018-10-06T16:30:00Z,False,14,13,90,1,2,0,2,10,4,6,-8,-2
Manquillo,314,1,87,2018-10-20T14:00:00Z,True,14,2,0,0,2,0,2,8,7,1,-6,-1
Manquillo,314,1,97,2018-10-27T14:00:00Z,False,14,15,0,0,2,0,2,6,2,4,-4,0
Manquillo,314,1,107,2018-11-03T15:00:00Z,True,14,17,0,0,3,0,3,19,12,7,-16,-7
Manquillo,314,1,118,2018-11-10T15:00:00Z,True,14,1,0,0,6,3,3,20,11,9,-14,-6
Manquillo,314,1,122,2018-11-26T20:30:00Z,False,14,3,0,0,9,6,3,9,4,5,0,-1
Manquillo,314,1,138,2018-12-01T15:00:00Z,True,14,18,90,1,12,6,6,12,7,5,0,1
Manquillo,314,1,148,2018-12-05T19:45:00Z,False,14,7,90,2,12,6,6,22,16,6,-10,-10
Manquillo,314,1,158,2018-12-09T16:00:00Z,True,14,19,45,1,13,6,7,19,11,8,-6,-2
Manquillo,314,1,163,2018-12-15T15:00:00Z,False,14,9,90,12,13,6,7,10,5,5,3,2
Manquillo,314,1,177,2018-12-22T15:00:00Z,True,14,8,83,6,16,6,10,9,8,1,7,5
Manquillo,314,1,185,2018-12-26T15:00:00Z,False,14,11,0,0,17,7,10,48,22,26,-31,-12
Manquillo,314,1,199,2018-12-29T15:00:00Z,False,14,17,0,0,17,7,10,27,15,12,-10,-5
Manquillo,314,1,207,2019-01-02T20:00:00Z,True,14,13,0,0,18,7,11,35,21,14,-17,-7
Manquillo,314,1,213,2019-01-12T17:30:00Z,False,14,5,8,1,18,7,11,44,22,22,-26,-11
Manquillo,314,1,226,2019-01-19T15:00:00Z,True,14,4,5,1,18,7,11,19,14,5,-1,2
Manquillo,314,1,237,2019-01-29T20:00:00Z,True,14,12,1,1,21,10,11,56,33,23,-35,-13
Manquillo,314,1,248,2019-02-02T12:30:00Z,False,14,16,0,0,24,13,11,54,21,33,-30,-10
Manquillo,314,1,259,2019-02-11T20:00:00Z,False,14,19,1,1,24,13,11,38,20,18,-14,-9
Manquillo,314,1,268,2019-02-23T15:00:00Z,True,14,9,0,0,25,13,12,11,5,6,14,7
Manquillo,314,1,278,2019-02-26T20:00:00Z,True,14,3,90,11,28,16,12,30,17,13,-2,3
Manquillo,314,1,288,2019-03-02T17:30:00Z,False,14,18,90,1,31,19,12,36,21,15,-5,-9
Manquillo,314,1,298,2019-03-09T15:00:00Z,True,14,7,0,0,31,19,12,37,22,15,-6,4
Manquillo,314,1,300,2019-03-16T15:00:00Z,False,14,1,0,0,34,22,12,37,25,12,-3,-13
Manquillo,314,1,310,2019-04-01T19:00:00Z,False,14,0,0,0,35,22,13,60,41,19,-25,-28
Manquillo,314,1,325,2019-04-06T14:00:00Z,True,14,6,0,0,35,22,13,36,16,20,-1,2
Manquillo,314,1,334,2019-04-12T19:00:00Z,False,14,10,90,5,35,22,13,47,23,24,-12,-10
Manquillo,314,1,347,2019-04-20T16:30:00Z,True,14,15,90,2,38,22,16,36,21,15,2,7
Manquillo,314,1,350,2019-04-27T16:30:00Z,False,14,2,90,2,41,25,16,34,22,12,7,-6
Manquillo,314,1,367,2019-05-04T18:45:00Z,True,14,11,90,4,42,25,17,91,50,41,-49,-16
Manquillo,314,1,373,2019-05-12T14:00:00Z,False,14,8,0,0,42,25,17,26,21,5,16,-4
Mbemba,315,1,6,2018-08-11T11:30:00Z,True,14,16,0,0,0,0,0,0,0,0,0,0
Mbemba,315,1,12,2018-08-18T11:30:00Z,False,14,4,0,0,0,0,0,0,0,0,0,0
Mbemba,315,1,26,2018-08-26T15:00:00Z,True,14,5,0,0,1,0,1,6,3,3,-5,-3
Mbemba,315,1,37,2018-09-01T16:30:00Z,False,14,12,0,0,1,0,1,7,3,4,-6,-2
Mbemba,315,1,45,2018-09-15T14:00:00Z,True,14,0,0,0,1,0,1,6,3,3,-5,-3
Mbemba,315,1,54,2018-09-22T14:00:00Z,False,14,6,0,0,1,0,1,6,0,6,-5,1
Mbemba,315,1,67,2018-09-29T14:00:00Z,True,14,10,0,0,2,0,2,9,6,3,-7,-3
Mbemba,315,1,76,2018-10-06T16:30:00Z,False,14,13,0,0,2,0,2,10,4,6,-8,-2
Mbemba,315,1,87,2018-10-20T14:00:00Z,True,14,2,0,0,2,0,2,8,7,1,-6,-1
Mbemba,315,1,97,2018-10-27T14:00:00Z,False,14,15,0,0,2,0,2,6,2,4,-4,0
Mbemba,315,1,107,2018-11-03T15:00:00Z,True,14,17,0,0,3,0,3,19,12,7,-16,-7
Mbemba,315,1,118,2018-11-10T15:00:00Z,True,14,1,0,0,6,3,3,20,11,9,-14,-6
Mbemba,315,1,122,2018-11-26T20:30:00Z,False,14,3,0,0,9,6,3,9,4,5,0,-1
Mbemba,315,1,138,2018-12-01T15:00:00Z,True,14,18,0,0,12,6,6,12,7,5,0,1
Mbemba,315,1,148,2018-12-05T19:45:00Z,False,14,7,0,0,12,6,6,22,16,6,-10,-10
Mbemba,315,1,158,2018-12-09T16:00:00Z,True,14,19,0,0,13,6,7,19,11,8,-6,-2
Mbemba,315,1,163,2018-12-15T15:00:00Z,False,14,9,0,0,13,6,7,10,5,5,3,2
Mbemba,315,1,177,2018-12-22T15:00:00Z,True,14,8,0,0,16,6,10,9,8,1,7,5
Mbemba,315,1,185,2018-12-26T15:00:00Z,False,14,11,0,0,17,7,10,48,22,26,-31,-12
Mbemba,315,1,199,2018-12-29T15:00:00Z,False,14,17,0,0,17,7,10,27,15,12,-10,-5
Mbemba,315,1,207,2019-01-02T20:00:00Z,True,14,13,0,0,18,7,11,35,21,14,-17,-7
Mbemba,315,1,213,2019-01-12T17:30:00Z,False,14,5,0,0,18,7,11,44,22,22,-26,-11
Mbemba,315,1,226,2019-01-19T15:00:00Z,True,14,4,0,0,18,7,11,19,14,5,-1,2
Mbemba,315,1,237,2019-01-29T20:00:00Z,True,14,12,0,0,21,10,11,56,33,23,-35,-13
Mbemba,315,1,248,2019-02-02T12:30:00Z,False,14,16,0,0,24,13,11,54,21,33,-30,-10
Mbemba,315,1,259,2019-02-11T20:00:00Z,False,14,19,0,0,24,13,11,38,20,18,-14,-9
Mbemba,315,1,268,2019-02-23T15:00:00Z,True,14,9,0,0,25,13,12,11,5,6,14,7
Mbemba,315,1,278,2019-02-26T20:00:00Z,True,14,3,0,0,28,16,12,30,17,13,-2,3
Mbemba,315,1,288,2019-03-02T17:30:00Z,False,14,18,0,0,31,19,12,36,21,15,-5,-9
Mbemba,315,1,298,2019-03-09T15:00:00Z,True,14,7,0,0,31,19,12,37,22,15,-6,4
Mbemba,315,1,300,2019-03-16T15:00:00Z,False,14,1,0,0,34,22,12,37,25,12,-3,-13
Mbemba,315,1,310,2019-04-01T19:00:00Z,False,14,0,0,0,35,22,13,60,41,19,-25,-28
Mbemba,315,1,325,2019-04-06T14:00:00Z,True,14,6,0,0,35,22,13,36,16,20,-1,2
Mbemba,315,1,334,2019-04-12T19:00:00Z,False,14,10,0,0,35,22,13,47,23,24,-12,-10
Mbemba,315,1,347,2019-04-20T16:30:00Z,True,14,15,0,0,38,22,16,36,21,15,2,7
Mbemba,315,1,350,2019-04-27T16:30:00Z,False,14,2,0,0,41,25,16,34,22,12,7,-6
Mbemba,315,1,367,2019-05-04T18:45:00Z,True,14,11,0,0,42,25,17,91,50,41,-49,-16
Mbemba,315,1,373,2019-05-12T14:00:00Z,False,14,8,0,0,42,25,17,26,21,5,16,-4
Ritchie,316,2,6,2018-08-11T11:30:00Z,True,14,16,68,5,0,0,0,0,0,0,0,0
Ritchie,316,2,12,2018-08-18T11:30:00Z,False,14,4,69,2,0,0,0,0,0,0,0,0
Ritchie,316,2,26,2018-08-26T15:00:00Z,True,14,5,90,1,1,0,1,6,3,3,-5,-3
Ritchie,316,2,37,2018-09-01T16:30:00Z,False,14,12,0,0,1,0,1,7,3,4,-6,-2
Ritchie,316,2,45,2018-09-15T14:00:00Z,True,14,0,78,2,1,0,1,6,3,3,-5,-3
Ritchie,316,2,54,2018-09-22T14:00:00Z,False,14,6,72,3,1,0,1,6,0,6,-5,1
Ritchie,316,2,67,2018-09-29T14:00:00Z,True,14,10,64,2,2,0,2,9,6,3,-7,-3
Ritchie,316,2,76,2018-10-06T16:30:00Z,False,14,13,90,1,2,0,2,10,4,6,-8,-2
Ritchie,316,2,87,2018-10-20T14:00:00Z,True,14,2,90,2,2,0,2,8,7,1,-6,-1
Ritchie,316,2,97,2018-10-27T14:00:00Z,False,14,15,90,3,2,0,2,6,2,4,-4,0
Ritchie,316,2,107,2018-11-03T15:00:00Z,True,14,17,90,3,3,0,3,19,12,7,-16,-7
Ritchie,316,2,118,2018-11-10T15:00:00Z,True,14,1,73,2,6,3,3,20,11,9,-14,-6
Ritchie,316,2,122,2018-11-26T20:30:00Z,False,14,3,90,4,9,6,3,9,4,5,0,-1
Ritchie,316,2,138,2018-12-01T15:00:00Z,True,14,18,53,0,12,6,6,12,7,5,0,1
Ritchie,316,2,148,2018-12-05T19:45:00Z,False,14,7,0,0,12,6,6,22,16,6,-10,-10
Ritchie,316,2,158,2018-12-09T16:00:00Z,True,14,19,90,2,13,6,7,19,11,8,-6,-2
Ritchie,316,2,163,2018-12-15T15:00:00Z,False,14,9,9,1,13,6,7,10,5,5,3,2
Ritchie,316,2,177,2018-12-22T15:00:00Z,True,14,8,90,3,16,6,10,9,8,1,7,5
Ritchie,316,2,185,2018-12-26T15:00:00Z,False,14,11,80,2,17,7,10,48,22,26,-31,-12
Ritchie,316,2,199,2018-12-29T15:00:00Z,False,14,17,90,8,17,7,10,27,15,12,-10,-5
Ritchie,316,2,207,2019-01-02T20:00:00Z,True,14,13,90,2,18,7,11,35,21,14,-17,-7
Ritchie,316,2,213,2019-01-12T17:30:00Z,False,14,5,90,4,18,7,11,44,22,22,-26,-11
Ritchie,316,2,226,2019-01-19T15:00:00Z,True,14,4,84,3,18,7,11,19,14,5,-1,2
Ritchie,316,2,237,2019-01-29T20:00:00Z,True,14,12,90,8,21,10,11,56,33,23,-35,-13
Ritchie,316,2,248,2019-02-02T12:30:00Z,False,14,16,85,2,24,13,11,54,21,33,-30,-10
Ritchie,316,2,259,2019-02-11T20:00:00Z,False,14,19,90,1,24,13,11,38,20,18,-14,-9
Ritchie,316,2,268,2019-02-23T15:00:00Z,True,14,9,67,2,25,13,12,11,5,6,14,7
Ritchie,316,2,278,2019-02-26T20:00:00Z,True,14,3,90,3,28,16,12,30,17,13,-2,3
Ritchie,316,2,288,2019-03-02T17:30:00Z,False,14,18,90,2,31,19,12,36,21,15,-5,-9
Ritchie,316,2,298,2019-03-09T15:00:00Z,True,14,7,72,0,31,19,12,37,22,15,-6,4
Ritchie,316,2,300,2019-03-16T15:00:00Z,False,14,1,90,8,34,22,12,37,25,12,-3,-13
Ritchie,316,2,310,2019-04-01T19:00:00Z,False,14,0,74,2,35,22,13,60,41,19,-25,-28
Ritchie,316,2,325,2019-04-06T14:00:00Z,True,14,6,89,2,35,22,13,36,16,20,-1,2
Ritchie,316,2,334,2019-04-12T19:00:00Z,False,14,10,90,6,35,22,13,47,23,24,-12,-10
Ritchie,316,2,347,2019-04-20T16:30:00Z,True,14,15,90,7,38,22,16,36,21,15,2,7
Ritchie,316,2,350,2019-04-27T16:30:00Z,False,14,2,90,1,41,25,16,34,22,12,7,-6
Ritchie,316,2,367,2019-05-04T18:45:00Z,True,14,11,90,2,42,25,17,91,50,41,-49,-16
Ritchie,316,2,373,2019-05-12T14:00:00Z,False,14,8,90,9,42,25,17,26,21,5,16,-4
Shelvey,317,2,6,2018-08-11T11:30:00Z,True,14,16,90,2,0,0,0,0,0,0,0,0
Shelvey,317,2,12,2018-08-18T11:30:00Z,False,14,4,90,3,0,0,0,0,0,0,0,0
Shelvey,317,2,26,2018-08-26T15:00:00Z,True,14,5,0,0,1,0,1,6,3,3,-5,-3
Shelvey,317,2,37,2018-09-01T16:30:00Z,False,14,12,0,0,1,0,1,7,3,4,-6,-2
Shelvey,317,2,45,2018-09-15T14:00:00Z,True,14,0,0,0,1,0,1,6,3,3,-5,-3
Shelvey,317,2,54,2018-09-22T14:00:00Z,False,14,6,90,3,1,0,1,6,0,6,-5,1
Shelvey,317,2,67,2018-09-29T14:00:00Z,True,14,10,90,2,2,0,2,9,6,3,-7,-3
Shelvey,317,2,76,2018-10-06T16:30:00Z,False,14,13,90,5,2,0,2,10,4,6,-8,-2
Shelvey,317,2,87,2018-10-20T14:00:00Z,True,14,2,90,2,2,0,2,8,7,1,-6,-1
Shelvey,317,2,97,2018-10-27T14:00:00Z,False,14,15,90,3,2,0,2,6,2,4,-4,0
Shelvey,317,2,107,2018-11-03T15:00:00Z,True,14,17,50,1,3,0,3,19,12,7,-16,-7
Shelvey,317,2,118,2018-11-10T15:00:00Z,True,14,1,0,0,6,3,3,20,11,9,-14,-6
Shelvey,317,2,122,2018-11-26T20:30:00Z,False,14,3,0,0,9,6,3,9,4,5,0,-1
Shelvey,317,2,138,2018-12-01T15:00:00Z,True,14,18,20,1,12,6,6,12,7,5,0,1
Shelvey,317,2,148,2018-12-05T19:45:00Z,False,14,7,0,0,12,6,6,22,16,6,-10,-10
Shelvey,317,2,158,2018-12-09T16:00:00Z,True,14,19,0,0,13,6,7,19,11,8,-6,-2
Shelvey,317,2,163,2018-12-15T15:00:00Z,False,14,9,0,0,13,6,7,10,5,5,3,2
Shelvey,317,2,177,2018-12-22T15:00:00Z,True,14,8,0,0,16,6,10,9,8,1,7,5
Shelvey,317,2,185,2018-12-26T15:00:00Z,False,14,11,0,0,17,7,10,48,22,26,-31,-12
Shelvey,317,2,199,2018-12-29T15:00:00Z,False,14,17,11,1,17,7,10,27,15,12,-10,-5
Shelvey,317,2,207,2019-01-02T20:00:00Z,True,14,13,37,1,18,7,11,35,21,14,-17,-7
Shelvey,317,2,213,2019-01-12T17:30:00Z,False,14,5,0,0,18,7,11,44,22,22,-26,-11
Shelvey,317,2,226,2019-01-19T15:00:00Z,True,14,4,0,0,18,7,11,19,14,5,-1,2
Shelvey,317,2,237,2019-01-29T20:00:00Z,True,14,12,0,0,21,10,11,56,33,23,-35,-13
Shelvey,317,2,248,2019-02-02T12:30:00Z,False,14,16,0,0,24,13,11,54,21,33,-30,-10
Shelvey,317,2,259,2019-02-11T20:00:00Z,False,14,19,0,0,24,13,11,38,20,18,-14,-9
Shelvey,317,2,268,2019-02-23T15:00:00Z,True,14,9,0,0,25,13,12,11,5,6,14,7
Shelvey,317,2,278,2019-02-26T20:00:00Z,True,14,3,0,0,28,16,12,30,17,13,-2,3
Shelvey,317,2,288,2019-03-02T17:30:00Z,False,14,18,0,0,31,19,12,36,21,15,-5,-9
Shelvey,317,2,298,2019-03-09T15:00:00Z,True,14,7,11,0,31,19,12,37,22,15,-6,4
Shelvey,317,2,300,2019-03-16T15:00:00Z,False,14,1,7,1,34,22,12,37,25,12,-3,-13
Shelvey,317,2,310,2019-04-01T19:00:00Z,False,14,0,0,0,35,22,13,60,41,19,-25,-28
Shelvey,317,2,325,2019-04-06T14:00:00Z,True,14,6,14,1,35,22,13,36,16,20,-1,2
Shelvey,317,2,334,2019-04-12T19:00:00Z,False,14,10,0,0,35,22,13,47,23,24,-12,-10
Shelvey,317,2,347,2019-04-20T16:30:00Z,True,14,15,0,0,38,22,16,36,21,15,2,7
Shelvey,317,2,350,2019-04-27T16:30:00Z,False,14,2,73,3,41,25,16,34,22,12,7,-6
Shelvey,317,2,367,2019-05-04T18:45:00Z,True,14,11,0,0,42,25,17,91,50,41,-49,-16
Shelvey,317,2,373,2019-05-12T14:00:00Z,False,14,8,90,10,42,25,17,26,21,5,16,-4
Diame,318,2,6,2018-08-11T11:30:00Z,True,14,16,90,1,0,0,0,0,0,0,0,0
Diame,318,2,12,2018-08-18T11:30:00Z,False,14,4,90,3,0,0,0,0,0,0,0,0
Diame,318,2,26,2018-08-26T15:00:00Z,True,14,5,90,2,1,0,1,6,3,3,-5,-3
Diame,318,2,37,2018-09-01T16:30:00Z,False,14,12,90,2,1,0,1,7,3,4,-6,-2
Diame,318,2,45,2018-09-15T14:00:00Z,True,14,0,90,2,1,0,1,6,3,3,-5,-3
Diame,318,2,54,2018-09-22T14:00:00Z,False,14,6,90,3,1,0,1,6,0,6,-5,1
Diame,318,2,67,2018-09-29T14:00:00Z,True,14,10,90,2,2,0,2,9,6,3,-7,-3
Diame,318,2,76,2018-10-06T16:30:00Z,False,14,13,90,1,2,0,2,10,4,6,-8,-2
Diame,318,2,87,2018-10-20T14:00:00Z,True,14,2,90,2,2,0,2,8,7,1,-6,-1
Diame,318,2,97,2018-10-27T14:00:00Z,False,14,15,75,3,2,0,2,6,2,4,-4,0
Diame,318,2,107,2018-11-03T15:00:00Z,True,14,17,90,3,3,0,3,19,12,7,-16,-7
Diame,318,2,118,2018-11-10T15:00:00Z,True,14,1,79,2,6,3,3,20,11,9,-14,-6
Diame,318,2,122,2018-11-26T20:30:00Z,False,14,3,90,2,9,6,3,9,4,5,0,-1
Diame,318,2,138,2018-12-01T15:00:00Z,True,14,18,90,2,12,6,6,12,7,5,0,1
Diame,318,2,148,2018-12-05T19:45:00Z,False,14,7,90,1,12,6,6,22,16,6,-10,-10
Diame,318,2,158,2018-12-09T16:00:00Z,True,14,19,90,2,13,6,7,19,11,8,-6,-2
Diame,318,2,163,2018-12-15T15:00:00Z,False,14,9,90,3,13,6,7,10,5,5,3,2
Diame,318,2,177,2018-12-22T15:00:00Z,True,14,8,90,3,16,6,10,9,8,1,7,5
Diame,318,2,185,2018-12-26T15:00:00Z,False,14,11,90,2,17,7,10,48,22,26,-31,-12
Diame,318,2,199,2018-12-29T15:00:00Z,False,14,17,90,2,17,7,10,27,15,12,-10,-5
Diame,318,2,207,2019-01-02T20:00:00Z,True,14,13,52,1,18,7,11,35,21,14,-17,-7
Diame,318,2,213,2019-01-12T17:30:00Z,False,14,5,0,0,18,7,11,44,22,22,-26,-11
Diame,318,2,226,2019-01-19T15:00:00Z,True,14,4,0,0,18,7,11,19,14,5,-1,2
Diame,318,2,237,2019-01-29T20:00:00Z,True,14,12,0,0,21,10,11,56,33,23,-35,-13
Diame,318,2,248,2019-02-02T12:30:00Z,False,14,16,0,0,24,13,11,54,21,33,-30,-10
Diame,318,2,259,2019-02-11T20:00:00Z,False,14,19,4,1,24,13,11,38,20,18,-14,-9
Diame,318,2,268,2019-02-23T15:00:00Z,True,14,9,0,0,25,13,12,11,5,6,14,7
Diame,318,2,278,2019-02-26T20:00:00Z,True,14,3,5,1,28,16,12,30,17,13,-2,3
Diame,318,2,288,2019-03-02T17:30:00Z,False,14,18,45,1,31,19,12,36,21,15,-5,-9
Diame,318,2,298,2019-03-09T15:00:00Z,True,14,7,0,0,31,19,12,37,22,15,-6,4
Diame,318,2,300,2019-03-16T15:00:00Z,False,14,1,82,2,34,22,12,37,25,12,-3,-13
Diame,318,2,310,2019-04-01T19:00:00Z,False,14,0,90,2,35,22,13,60,41,19,-25,-28
Diame,318,2,325,2019-04-06T14:00:00Z,True,14,6,0,0,35,22,13,36,16,20,-1,2
Diame,318,2,334,2019-04-12T19:00:00Z,False,14,10,8,1,35,22,13,47,23,24,-12,-10
Diame,318,2,347,2019-04-20T16:30:00Z,True,14,15,12,1,38,22,16,36,21,15,2,7
Diame,318,2,350,2019-04-27T16:30:00Z,False,14,2,0,0,41,25,16,34,22,12,7,-6
Diame,318,2,367,2019-05-04T18:45:00Z,True,14,11,0,0,42,25,17,91,50,41,-49,-16
Diame,318,2,373,2019-05-12T14:00:00Z,False,14,8,90,3,42,25,17,26,21,5,16,-4
Atsu,319,2,6,2018-08-11T11:30:00Z,True,14,16,21,1,0,0,0,0,0,0,0,0
Atsu,319,2,12,2018-08-18T11:30:00Z,False,14,4,0,0,0,0,0,0,0,0,0,0
Atsu,319,2,26,2018-08-26T15:00:00Z,True,14,5,0,0,1,0,1,6,3,3,-5,-3
Atsu,319,2,37,2018-09-01T16:30:00Z,False,14,12,36,1,1,0,1,7,3,4,-6,-2
Atsu,319,2,45,2018-09-15T14:00:00Z,True,14,0,0,0,1,0,1,6,3,3,-5,-3
Atsu,319,2,54,2018-09-22T14:00:00Z,False,14,6,17,1,1,0,1,6,0,6,-5,1
Atsu,319,2,67,2018-09-29T14:00:00Z,True,14,10,90,2,2,0,2,9,6,3,-7,-3
Atsu,319,2,76,2018-10-06T16:30:00Z,False,14,13,12,1,2,0,2,10,4,6,-8,-2
Atsu,319,2,87,2018-10-20T14:00:00Z,True,14,2,0,0,2,0,2,8,7,1,-6,-1
Atsu,319,2,97,2018-10-27T14:00:00Z,False,14,15,10,0,2,0,2,6,2,4,-4,0
Atsu,319,2,107,2018-11-03T15:00:00Z,True,14,17,0,0,3,0,3,19,12,7,-16,-7
Atsu,319,2,118,2018-11-10T15:00:00Z,True,14,1,10,1,6,3,3,20,11,9,-14,-6
Atsu,319,2,122,2018-11-26T20:30:00Z,False,14,3,0,0,9,6,3,9,4,5,0,-1
Atsu,319,2,138,2018-12-01T15:00:00Z,True,14,18,36,1,12,6,6,12,7,5,0,1
Atsu,319,2,148,2018-12-05T19:45:00Z,False,14,7,90,1,12,6,6,22,16,6,-10,-10
Atsu,319,2,158,2018-12-09T16:00:00Z,True,14,19,88,2,13,6,7,19,11,8,-6,-2
Atsu,319,2,163,2018-12-15T15:00:00Z,False,14,9,90,3,13,6,7,10,5,5,3,2
Atsu,319,2,177,2018-12-22T15:00:00Z,True,14,8,71,3,16,6,10,9,8,1,7,5
Atsu,319,2,185,2018-12-26T15:00:00Z,False,14,11,0,0,17,7,10,48,22,26,-31,-12
Atsu,319,2,199,2018-12-29T15:00:00Z,False,14,17,90,2,17,7,10,27,15,12,-10,-5
Atsu,319,2,207,2019-01-02T20:00:00Z,True,14,13,90,2,18,7,11,35,21,14,-17,-7
Atsu,319,2,213,2019-01-12T17:30:00Z,False,14,5,90,2,18,7,11,44,22,22,-26,-11
Atsu,319,2,226,2019-01-19T15:00:00Z,True,14,4,90,3,18,7,11,19,14,5,-1,2
Atsu,319,2,237,2019-01-29T20:00:00Z,True,14,12,86,2,21,10,11,56,33,23,-35,-13
Atsu,319,2,248,2019-02-02T12:30:00Z,False,14,16,81,3,24,13,11,54,21,33,-30,-10
Atsu,319,2,259,2019-02-11T20:00:00Z,False,14,19,71,3,24,13,11,38,20,18,-14,-9
Atsu,319,2,268,2019-02-23T15:00:00Z,True,14,9,9,1,25,13,12,11,5,6,14,7
Atsu,319,2,278,2019-02-26T20:00:00Z,True,14,3,0,0,28,16,12,30,17,13,-2,3
Atsu,319,2,288,2019-03-02T17:30:00Z,False,14,18,11,1,31,19,12,36,21,15,-5,-9
Atsu,319,2,298,2019-03-09T15:00:00Z,True,14,7,0,0,31,19,12,37,22,15,-6,4
Atsu,319,2,300,2019-03-16T15:00:00Z,False,14,1,18,1,34,22,12,37,25,12,-3,-13
Atsu,319,2,310,2019-04-01T19:00:00Z,False,14,0,0,0,35,22,13,60,41,19,-25,-28
Atsu,319,2,325,2019-04-06T14:00:00Z,True,14,6,1,1,35,22,13,36,16,20,-1,2
Atsu,319,2,334,2019-04-12T19:00:00Z,False,14,10,12,1,35,22,13,47,23,24,-12,-10
Atsu,319,2,347,2019-04-20T16:30:00Z,True,14,15,26,1,38,22,16,36,21,15,2,7
Atsu,319,2,350,2019-04-27T16:30:00Z,False,14,2,80,2,41,25,16,34,22,12,7,-6
Atsu,319,2,367,2019-05-04T18:45:00Z,True,14,11,90,7,42,25,17,91,50,41,-49,-16
Atsu,319,2,373,2019-05-12T14:00:00Z,False,14,8,65,6,42,25,17,26,21,5,16,-4
Murphy,320,2,6,2018-08-11T11:30:00Z,True,14,16,0,0,0,0,0,0,0,0,0,0
Murphy,320,2,12,2018-08-18T11:30:00Z,False,14,4,20,1,0,0,0,0,0,0,0,0
Murphy,320,2,26,2018-08-26T15:00:00Z,True,14,5,72,3,1,0,1,6,3,3,-5,-3
Murphy,320,2,37,2018-09-01T16:30:00Z,False,14,12,9,1,1,0,1,7,3,4,-6,-2
Murphy,320,2,45,2018-09-15T14:00:00Z,True,14,0,68,2,1,0,1,6,3,3,-5,-3
Murphy,320,2,54,2018-09-22T14:00:00Z,False,14,6,0,0,1,0,1,6,0,6,-5,1
Murphy,320,2,67,2018-09-29T14:00:00Z,True,14,10,25,1,2,0,2,9,6,3,-7,-3
Murphy,320,2,76,2018-10-06T16:30:00Z,False,14,13,22,1,2,0,2,10,4,6,-8,-2
Murphy,320,2,87,2018-10-20T14:00:00Z,True,14,2,0,0,2,0,2,8,7,1,-6,-1
Murphy,320,2,97,2018-10-27T14:00:00Z,False,14,15,0,0,2,0,2,6,2,4,-4,0
Murphy,320,2,107,2018-11-03T15:00:00Z,True,14,17,0,0,3,0,3,19,12,7,-16,-7
Murphy,320,2,118,2018-11-10T15:00:00Z,True,14,1,0,0,6,3,3,20,11,9,-14,-6
Murphy,320,2,122,2018-11-26T20:30:00Z,False,14,3,0,0,9,6,3,9,4,5,0,-1
Murphy,320,2,138,2018-12-01T15:00:00Z,True,14,18,0,0,12,6,6,12,7,5,0,1
Murphy,320,2,148,2018-12-05T19:45:00Z,False,14,7,63,5,12,6,6,22,16,6,-10,-10
Murphy,320,2,158,2018-12-09T16:00:00Z,True,14,19,0,0,13,6,7,19,11,8,-6,-2
Murphy,320,2,163,2018-12-15T15:00:00Z,False,14,9,0,0,13,6,7,10,5,5,3,2
Murphy,320,2,177,2018-12-22T15:00:00Z,True,14,8,0,0,16,6,10,9,8,1,7,5
Murphy,320,2,185,2018-12-26T15:00:00Z,False,14,11,9,1,17,7,10,48,22,26,-31,-12
Murphy,320,2,199,2018-12-29T15:00:00Z,False,14,17,0,0,17,7,10,27,15,12,-10,-5
Murphy,320,2,207,2019-01-02T20:00:00Z,True,14,13,0,0,18,7,11,35,21,14,-17,-7
Murphy,320,2,213,2019-01-12T17:30:00Z,False,14,5,8,1,18,7,11,44,22,22,-26,-11
Murphy,320,2,226,2019-01-19T15:00:00Z,True,14,4,0,0,18,7,11,19,14,5,-1,2
Murphy,320,2,237,2019-01-29T20:00:00Z,True,14,12,0,0,21,10,11,56,33,23,-35,-13
Murphy,320,2,248,2019-02-02T12:30:00Z,False,14,16,0,0,24,13,11,54,21,33,-30,-10
Murphy,320,2,259,2019-02-11T20:00:00Z,False,14,19,0,0,24,13,11,38,20,18,-14,-9
Murphy,320,2,268,2019-02-23T15:00:00Z,True,14,9,0,0,25,13,12,11,5,6,14,7
Murphy,320,2,278,2019-02-26T20:00:00Z,True,14,3,0,0,28,16,12,30,17,13,-2,3
Murphy,320,2,288,2019-03-02T17:30:00Z,False,14,18,0,0,31,19,12,36,21,15,-5,-9
Murphy,320,2,298,2019-03-09T15:00:00Z,True,14,7,0,0,31,19,12,37,22,15,-6,4
Murphy,320,2,300,2019-03-16T15:00:00Z,False,14,1,0,0,34,22,12,37,25,12,-3,-13
Murphy,320,2,310,2019-04-01T19:00:00Z,False,14,0,0,0,35,22,13,60,41,19,-25,-28
Murphy,320,2,325,2019-04-06T14:00:00Z,True,14,6,0,0,35,22,13,36,16,20,-1,2
Murphy,320,2,334,2019-04-12T19:00:00Z,False,14,10,0,0,35,22,13,47,23,24,-12,-10
Murphy,320,2,347,2019-04-20T16:30:00Z,True,14,15,0,0,38,22,16,36,21,15,2,7
Murphy,320,2,350,2019-04-27T16:30:00Z,False,14,2,0,0,41,25,16,34,22,12,7,-6
Murphy,320,2,367,2019-05-04T18:45:00Z,True,14,11,0,0,42,25,17,91,50,41,-49,-16
Murphy,320,2,373,2019-05-12T14:00:00Z,False,14,8,0,0,42,25,17,26,21,5,16,-4
Merino,321,2,6,2018-08-11T11:30:00Z,True,14,16,0,0,0,0,0,0,0,0,0,0
Merino,321,2,12,2018-08-18T11:30:00Z,False,14,4,0,0,0,0,0,0,0,0,0,0
Merino,321,2,26,2018-08-26T15:00:00Z,True,14,5,0,0,1,0,1,6,3,3,-5,-3
Merino,321,2,37,2018-09-01T16:30:00Z,False,14,12,0,0,1,0,1,7,3,4,-6,-2
Merino,321,2,45,2018-09-15T14:00:00Z,True,14,0,0,0,1,0,1,6,3,3,-5,-3
Merino,321,2,54,2018-09-22T14:00:00Z,False,14,6,0,0,1,0,1,6,0,6,-5,1
Merino,321,2,67,2018-09-29T14:00:00Z,True,14,10,0,0,2,0,2,9,6,3,-7,-3
Merino,321,2,76,2018-10-06T16:30:00Z,False,14,13,0,0,2,0,2,10,4,6,-8,-2
Merino,321,2,87,2018-10-20T14:00:00Z,True,14,2,0,0,2,0,2,8,7,1,-6,-1
Merino,321,2,97,2018-10-27T14:00:00Z,False,14,15,0,0,2,0,2,6,2,4,-4,0
Merino,321,2,107,2018-11-03T15:00:00Z,True,14,17,0,0,3,0,3,19,12,7,-16,-7
Merino,321,2,118,2018-11-10T15:00:00Z,True,14,1,0,0,6,3,3,20,11,9,-14,-6
Merino,321,2,122,2018-11-26T20:30:00Z,False,14,3,0,0,9,6,3,9,4,5,0,-1
Merino,321,2,138,2018-12-01T15:00:00Z,True,14,18,0,0,12,6,6,12,7,5,0,1
Merino,321,2,148,2018-12-05T19:45:00Z,False,14,7,0,0,12,6,6,22,16,6,-10,-10
Merino,321,2,158,2018-12-09T16:00:00Z,True,14,19,0,0,13,6,7,19,11,8,-6,-2
Merino,321,2,163,2018-12-15T15:00:00Z,False,14,9,0,0,13,6,7,10,5,5,3,2
Merino,321,2,177,2018-12-22T15:00:00Z,True,14,8,0,0,16,6,10,9,8,1,7,5
Merino,321,2,185,2018-12-26T15:00:00Z,False,14,11,0,0,17,7,10,48,22,26,-31,-12
Merino,321,2,199,2018-12-29T15:00:00Z,False,14,17,0,0,17,7,10,27,15,12,-10,-5
Merino,321,2,207,2019-01-02T20:00:00Z,True,14,13,0,0,18,7,11,35,21,14,-17,-7
Merino,321,2,213,2019-01-12T17:30:00Z,False,14,5,0,0,18,7,11,44,22,22,-26,-11
Merino,321,2,226,2019-01-19T15:00:00Z,True,14,4,0,0,18,7,11,19,14,5,-1,2
Merino,321,2,237,2019-01-29T20:00:00Z,True,14,12,0,0,21,10,11,56,33,23,-35,-13
Merino,321,2,248,2019-02-02T12:30:00Z,False,14,16,0,0,24,13,11,54,21,33,-30,-10
Merino,321,2,259,2019-02-11T20:00:00Z,False,14,19,0,0,24,13,11,38,20,18,-14,-9
Merino,321,2,268,2019-02-23T15:00:00Z,True,14,9,0,0,25,13,12,11,5,6,14,7
Merino,321,2,278,2019-02-26T20:00:00Z,True,14,3,0,0,28,16,12,30,17,13,-2,3
Merino,321,2,288,2019-03-02T17:30:00Z,False,14,18,0,0,31,19,12,36,21,15,-5,-9
Merino,321,2,298,2019-03-09T15:00:00Z,True,14,7,0,0,31,19,12,37,22,15,-6,4
Merino,321,2,300,2019-03-16T15:00:00Z,False,14,1,0,0,34,22,12,37,25,12,-3,-13
Merino,321,2,310,2019-04-01T19:00:00Z,False,14,0,0,0,35,22,13,60,41,19,-25,-28
Merino,321,2,325,2019-04-06T14:00:00Z,True,14,6,0,0,35,22,13,36,16,20,-1,2
Merino,321,2,334,2019-04-12T19:00:00Z,False,14,10,0,0,35,22,13,47,23,24,-12,-10
Merino,321,2,347,2019-04-20T16:30:00Z,True,14,15,0,0,38,22,16,36,21,15,2,7
Merino,321,2,350,2019-04-27T16:30:00Z,False,14,2,0,0,41,25,16,34,22,12,7,-6
Merino,321,2,367,2019-05-04T18:45:00Z,True,14,11,0,0,42,25,17,91,50,41,-49,-16
Merino,321,2,373,2019-05-12T14:00:00Z,False,14,8,0,0,42,25,17,26,21,5,16,-4
Hayden,322,2,6,2018-08-11T11:30:00Z,True,14,16,0,0,0,0,0,0,0,0,0,0
Hayden,322,2,12,2018-08-18T11:30:00Z,False,14,4,20,-2,0,0,0,0,0,0,0,0
Hayden,322,2,26,2018-08-26T15:00:00Z,True,14,5,0,0,1,0,1,6,3,3,-5,-3
Hayden,322,2,37,2018-09-01T16:30:00Z,False,14,12,0,0,1,0,1,7,3,4,-6,-2
Hayden,322,2,45,2018-09-15T14:00:00Z,True,14,0,90,2,1,0,1,6,3,3,-5,-3
Hayden,322,2,54,2018-09-22T14:00:00Z,False,14,6,0,0,1,0,1,6,0,6,-5,1
Hayden,322,2,67,2018-09-29T14:00:00Z,True,14,10,0,0,2,0,2,9,6,3,-7,-3
Hayden,322,2,76,2018-10-06T16:30:00Z,False,14,13,0,0,2,0,2,10,4,6,-8,-2
Hayden,322,2,87,2018-10-20T14:00:00Z,True,14,2,0,0,2,0,2,8,7,1,-6,-1
Hayden,322,2,97,2018-10-27T14:00:00Z,False,14,15,0,0,2,0,2,6,2,4,-4,0
Hayden,322,2,107,2018-11-03T15:00:00Z,True,14,17,0,0,3,0,3,19,12,7,-16,-7
Hayden,322,2,118,2018-11-10T15:00:00Z,True,14,1,16,1,6,3,3,20,11,9,-14,-6
Hayden,322,2,122,2018-11-26T20:30:00Z,False,14,3,1,1,9,6,3,9,4,5,0,-1
Hayden,322,2,138,2018-12-01T15:00:00Z,True,14,18,0,0,12,6,6,12,7,5,0,1
Hayden,322,2,148,2018-12-05T19:45:00Z,False,14,7,0,0,12,6,6,22,16,6,-10,-10
Hayden,322,2,158,2018-12-09T16:00:00Z,True,14,19,0,0,13,6,7,19,11,8,-6,-2
Hayden,322,2,163,2018-12-15T15:00:00Z,False,14,9,18,1,13,6,7,10,5,5,3,2
Hayden,322,2,177,2018-12-22T15:00:00Z,True,14,8,0,0,16,6,10,9,8,1,7,5
Hayden,322,2,185,2018-12-26T15:00:00Z,False,14,11,90,2,17,7,10,48,22,26,-31,-12
Hayden,322,2,199,2018-12-29T15:00:00Z,False,14,17,78,3,17,7,10,27,15,12,-10,-5
Hayden,322,2,207,2019-01-02T20:00:00Z,True,14,13,90,2,18,7,11,35,21,14,-17,-7
Hayden,322,2,213,2019-01-12T17:30:00Z,False,14,5,90,2,18,7,11,44,22,22,-26,-11
Hayden,322,2,226,2019-01-19T15:00:00Z,True,14,4,90,6,18,7,11,19,14,5,-1,2
Hayden,322,2,237,2019-01-29T20:00:00Z,True,14,12,90,5,21,10,11,56,33,23,-35,-13
Hayden,322,2,248,2019-02-02T12:30:00Z,False,14,16,90,2,24,13,11,54,21,33,-30,-10
Hayden,322,2,259,2019-02-11T20:00:00Z,False,14,19,85,10,24,13,11,38,20,18,-14,-9
Hayden,322,2,268,2019-02-23T15:00:00Z,True,14,9,90,8,25,13,12,11,5,6,14,7
Hayden,322,2,278,2019-02-26T20:00:00Z,True,14,3,90,3,28,16,12,30,17,13,-2,3
Hayden,322,2,288,2019-03-02T17:30:00Z,False,14,18,78,1,31,19,12,36,21,15,-5,-9
Hayden,322,2,298,2019-03-09T15:00:00Z,True,14,7,90,2,31,19,12,37,22,15,-6,4
Hayden,322,2,300,2019-03-16T15:00:00Z,False,14,1,90,1,34,22,12,37,25,12,-3,-13
Hayden,322,2,310,2019-04-01T19:00:00Z,False,14,0,66,2,35,22,13,60,41,19,-25,-28
Hayden,322,2,325,2019-04-06T14:00:00Z,True,14,6,90,1,35,22,13,36,16,20,-1,2
Hayden,322,2,334,2019-04-12T19:00:00Z,False,14,10,90,3,35,22,13,47,23,24,-12,-10
Hayden,322,2,347,2019-04-20T16:30:00Z,True,14,15,77,5,38,22,16,36,21,15,2,7
Hayden,322,2,350,2019-04-27T16:30:00Z,False,14,2,90,3,41,25,16,34,22,12,7,-6
Hayden,322,2,367,2019-05-04T18:45:00Z,True,14,11,90,2,42,25,17,91,50,41,-49,-16
Hayden,322,2,373,2019-05-12T14:00:00Z,False,14,8,68,3,42,25,17,26,21,5,16,-4
Ki Sung-yueng,323,2,6,2018-08-11T11:30:00Z,True,14,16,0,0,0,0,0,0,0,0,0,0
Ki Sung-yueng,323,2,12,2018-08-18T11:30:00Z,False,14,4,0,0,0,0,0,0,0,0,0,0
Ki Sung-yueng,323,2,26,2018-08-26T15:00:00Z,True,14,5,90,2,1,0,1,6,3,3,-5,-3
Ki Sung-yueng,323,2,37,2018-09-01T16:30:00Z,False,14,12,90,2,1,0,1,7,3,4,-6,-2
Ki Sung-yueng,323,2,45,2018-09-15T14:00:00Z,True,14,0,0,0,1,0,1,6,3,3,-5,-3
Ki Sung-yueng,323,2,54,2018-09-22T14:00:00Z,False,14,6,0,0,1,0,1,6,0,6,-5,1
Ki Sung-yueng,323,2,67,2018-09-29T14:00:00Z,True,14,10,0,0,2,0,2,9,6,3,-7,-3
Ki Sung-yueng,323,2,76,2018-10-06T16:30:00Z,False,14,13,0,0,2,0,2,10,4,6,-8,-2
Ki Sung-yueng,323,2,87,2018-10-20T14:00:00Z,True,14,2,0,0,2,0,2,8,7,1,-6,-1
Ki Sung-yueng,323,2,97,2018-10-27T14:00:00Z,False,14,15,14,1,2,0,2,6,2,4,-4,0
Ki Sung-yueng,323,2,107,2018-11-03T15:00:00Z,True,14,17,39,4,3,0,3,19,12,7,-16,-7
Ki Sung-yueng,323,2,118,2018-11-10T15:00:00Z,True,14,1,90,2,6,3,3,20,11,9,-14,-6
Ki Sung-yueng,323,2,122,2018-11-26T20:30:00Z,False,14,3,90,2,9,6,3,9,4,5,0,-1
Ki Sung-yueng,323,2,138,2018-12-01T15:00:00Z,True,14,18,90,2,12,6,6,12,7,5,0,1
Ki Sung-yueng,323,2,148,2018-12-05T19:45:00Z,False,14,7,90,2,12,6,6,22,16,6,-10,-10
Ki Sung-yueng,323,2,158,2018-12-09T16:00:00Z,True,14,19,90,2,13,6,7,19,11,8,-6,-2
Ki Sung-yueng,323,2,163,2018-12-15T15:00:00Z,False,14,9,71,3,13,6,7,10,5,5,3,2
Ki Sung-yueng,323,2,177,2018-12-22T15:00:00Z,True,14,8,90,3,16,6,10,9,8,1,7,5
Ki Sung-yueng,323,2,185,2018-12-26T15:00:00Z,False,14,11,0,0,17,7,10,48,22,26,-31,-12
Ki Sung-yueng,323,2,199,2018-12-29T15:00:00Z,False,14,17,0,0,17,7,10,27,15,12,-10,-5
Ki Sung-yueng,323,2,207,2019-01-02T20:00:00Z,True,14,13,0,0,18,7,11,35,21,14,-17,-7
Ki Sung-yueng,323,2,213,2019-01-12T17:30:00Z,False,14,5,0,0,18,7,11,44,22,22,-26,-11
Ki Sung-yueng,323,2,226,2019-01-19T15:00:00Z,True,14,4,0,0,18,7,11,19,14,5,-1,2
Ki Sung-yueng,323,2,237,2019-01-29T20:00:00Z,True,14,12,0,0,21,10,11,56,33,23,-35,-13
Ki Sung-yueng,323,2,248,2019-02-02T12:30:00Z,False,14,16,0,0,24,13,11,54,21,33,-30,-10
Ki Sung-yueng,323,2,259,2019-02-11T20:00:00Z,False,14,19,0,0,24,13,11,38,20,18,-14,-9
Ki Sung-yueng,323,2,268,2019-02-23T15:00:00Z,True,14,9,0,0,25,13,12,11,5,6,14,7
Ki Sung-yueng,323,2,278,2019-02-26T20:00:00Z,True,14,3,0,0,28,16,12,30,17,13,-2,3
Ki Sung-yueng,323,2,288,2019-03-02T17:30:00Z,False,14,18,0,0,31,19,12,36,21,15,-5,-9
Ki Sung-yueng,323,2,298,2019-03-09T15:00:00Z,True,14,7,78,2,31,19,12,37,22,15,-6,4
Ki Sung-yueng,323,2,300,2019-03-16T15:00:00Z,False,14,1,0,0,34,22,12,37,25,12,-3,-13
Ki Sung-yueng,323,2,310,2019-04-01T19:00:00Z,False,14,0,23,1,35,22,13,60,41,19,-25,-28
Ki Sung-yueng,323,2,325,2019-04-06T14:00:00Z,True,14,6,75,3,35,22,13,36,16,20,-1,2
Ki Sung-yueng,323,2,334,2019-04-12T19:00:00Z,False,14,10,81,2,35,22,13,47,23,24,-12,-10
Ki Sung-yueng,323,2,347,2019-04-20T16:30:00Z,True,14,15,90,2,38,22,16,36,21,15,2,7
Ki Sung-yueng,323,2,350,2019-04-27T16:30:00Z,False,14,2,17,1,41,25,16,34,22,12,7,-6
Ki Sung-yueng,323,2,367,2019-05-04T18:45:00Z,True,14,11,90,2,42,25,17,91,50,41,-49,-16
Ki Sung-yueng,323,2,373,2019-05-12T14:00:00Z,False,14,8,0,0,42,25,17,26,21,5,16,-4
Gayle,324,3,6,2018-08-11T11:30:00Z,True,14,16,0,0,0,0,0,0,0,0,0,0
Gayle,324,3,12,2018-08-18T11:30:00Z,False,14,4,0,0,0,0,0,0,0,0,0,0
Gayle,324,3,26,2018-08-26T15:00:00Z,True,14,5,0,0,1,0,1,6,3,3,-5,-3
Gayle,324,3,37,2018-09-01T16:30:00Z,False,14,12,0,0,1,0,1,7,3,4,-6,-2
Gayle,324,3,45,2018-09-15T14:00:00Z,True,14,0,0,0,1,0,1,6,3,3,-5,-3
Gayle,324,3,54,2018-09-22T14:00:00Z,False,14,6,0,0,1,0,1,6,0,6,-5,1
Gayle,324,3,67,2018-09-29T14:00:00Z,True,14,10,0,0,2,0,2,9,6,3,-7,-3
Gayle,324,3,76,2018-10-06T16:30:00Z,False,14,13,0,0,2,0,2,10,4,6,-8,-2
Gayle,324,3,87,2018-10-20T14:00:00Z,True,14,2,0,0,2,0,2,8,7,1,-6,-1
Gayle,324,3,97,2018-10-27T14:00:00Z,False,14,15,0,0,2,0,2,6,2,4,-4,0
Gayle,324,3,107,2018-11-03T15:00:00Z,True,14,17,0,0,3,0,3,19,12,7,-16,-7
Gayle,324,3,118,2018-11-10T15:00:00Z,True,14,1,0,0,6,3,3,20,11,9,-14,-6
Gayle,324,3,122,2018-11-26T20:30:00Z,False,14,3,0,0,9,6,3,9,4,5,0,-1
Gayle,324,3,138,2018-12-01T15:00:00Z,True,14,18,0,0,12,6,6,12,7,5,0,1
Gayle,324,3,148,2018-12-05T19:45:00Z,False,14,7,0,0,12,6,6,22,16,6,-10,-10
Gayle,324,3,158,2018-12-09T16:00:00Z,True,14,19,0,0,13,6,7,19,11,8,-6,-2
Gayle,324,3,163,2018-12-15T15:00:00Z,False,14,9,0,0,13,6,7,10,5,5,3,2
Gayle,324,3,177,2018-12-22T15:00:00Z,True,14,8,0,0,16,6,10,9,8,1,7,5
Gayle,324,3,185,2018-12-26T15:00:00Z,False,14,11,0,0,17,7,10,48,22,26,-31,-12
Gayle,324,3,199,2018-12-29T15:00:00Z,False,14,17,0,0,17,7,10,27,15,12,-10,-5
Gayle,324,3,207,2019-01-02T20:00:00Z,True,14,13,0,0,18,7,11,35,21,14,-17,-7
Gayle,324,3,213,2019-01-12T17:30:00Z,False,14,5,0,0,18,7,11,44,22,22,-26,-11
Gayle,324,3,226,2019-01-19T15:00:00Z,True,14,4,0,0,18,7,11,19,14,5,-1,2
Gayle,324,3,237,2019-01-29T20:00:00Z,True,14,12,0,0,21,10,11,56,33,23,-35,-13
Gayle,324,3,248,2019-02-02T12:30:00Z,False,14,16,0,0,24,13,11,54,21,33,-30,-10
Gayle,324,3,259,2019-02-11T20:00:00Z,False,14,19,0,0,24,13,11,38,20,18,-14,-9
Gayle,324,3,268,2019-02-23T15:00:00Z,True,14,9,0,0,25,13,12,11,5,6,14,7
Gayle,324,3,278,2019-02-26T20:00:00Z,True,14,3,0,0,28,16,12,30,17,13,-2,3
Gayle,324,3,288,2019-03-02T17:30:00Z,False,14,18,0,0,31,19,12,36,21,15,-5,-9
Gayle,324,3,298,2019-03-09T15:00:00Z,True,14,7,0,0,31,19,12,37,22,15,-6,4
Gayle,324,3,300,2019-03-16T15:00:00Z,False,14,1,0,0,34,22,12,37,25,12,-3,-13
Gayle,324,3,310,2019-04-01T19:00:00Z,False,14,0,0,0,35,22,13,60,41,19,-25,-28
Gayle,324,3,325,2019-04-06T14:00:00Z,True,14,6,0,0,35,22,13,36,16,20,-1,2
Gayle,324,3,334,2019-04-12T19:00:00Z,False,14,10,0,0,35,22,13,47,23,24,-12,-10
Gayle,324,3,347,2019-04-20T16:30:00Z,True,14,15,0,0,38,22,16,36,21,15,2,7
Gayle,324,3,350,2019-04-27T16:30:00Z,False,14,2,0,0,41,25,16,34,22,12,7,-6
Gayle,324,3,367,2019-05-04T18:45:00Z,True,14,11,0,0,42,25,17,91,50,41,-49,-16
Gayle,324,3,373,2019-05-12T14:00:00Z,False,14,8,0,0,42,25,17,26,21,5,16,-4
Perez,325,3,6,2018-08-11T11:30:00Z,True,14,16,80,2,0,0,0,0,0,0,0,0
Perez,325,3,12,2018-08-18T11:30:00Z,False,14,4,64,2,0,0,0,0,0,0,0,0
Perez,325,3,26,2018-08-26T15:00:00Z,True,14,5,17,1,1,0,1,6,3,3,-5,-3
Perez,325,3,37,2018-09-01T16:30:00Z,False,14,12,90,2,1,0,1,7,3,4,-6,-2
Perez,325,3,45,2018-09-15T14:00:00Z,True,14,0,90,2,1,0,1,6,3,3,-5,-3
Perez,325,3,54,2018-09-22T14:00:00Z,False,14,6,80,2,1,0,1,6,0,6,-5,1
Perez,325,3,67,2018-09-29T14:00:00Z,True,14,10,68,2,2,0,2,9,6,3,-7,-3
Perez,325,3,76,2018-10-06T16:30:00Z,False,14,13,87,5,2,0,2,10,4,6,-8,-2
Perez,325,3,87,2018-10-20T14:00:00Z,True,14,2,90,2,2,0,2,8,7,1,-6,-1
Perez,325,3,97,2018-10-27T14:00:00Z,False,14,15,68,2,2,0,2,6,2,4,-4,0
Perez,325,3,107,2018-11-03T15:00:00Z,True,14,17,45,8,3,0,3,19,12,7,-16,-7
Perez,325,3,118,2018-11-10T15:00:00Z,True,14,1,90,2,6,3,3,20,11,9,-14,-6
Perez,325,3,122,2018-11-26T20:30:00Z,False,14,3,90,2,9,6,3,9,4,5,0,-1
Perez,325,3,138,2018-12-01T15:00:00Z,True,14,18,77,2,12,6,6,12,7,5,0,1
Perez,325,3,148,2018-12-05T19:45:00Z,False,14,7,26,1,12,6,6,22,16,6,-10,-10
Perez,325,3,158,2018-12-09T16:00:00Z,True,14,19,90,9,13,6,7,19,11,8,-6,-2
Perez,325,3,163,2018-12-15T15:00:00Z,False,14,9,90,2,13,6,7,10,5,5,3,2
Perez,325,3,177,2018-12-22T15:00:00Z,True,14,8,90,2,16,6,10,9,8,1,7,5
Perez,325,3,185,2018-12-26T15:00:00Z,False,14,11,0,0,17,7,10,48,22,26,-31,-12
Perez,325,3,199,2018-12-29T15:00:00Z,False,14,17,90,2,17,7,10,27,15,12,-10,-5
Perez,325,3,207,2019-01-02T20:00:00Z,True,14,13,68,2,18,7,11,35,21,14,-17,-7
Perez,325,3,213,2019-01-12T17:30:00Z,False,14,5,81,2,18,7,11,44,22,22,-26,-11
Perez,325,3,226,2019-01-19T15:00:00Z,True,14,4,90,7,18,7,11,19,14,5,-1,2
Perez,325,3,237,2019-01-29T20:00:00Z,True,14,12,90,1,21,10,11,56,33,23,-35,-13
Perez,325,3,248,2019-02-02T12:30:00Z,False,14,16,90,2,24,13,11,54,21,33,-30,-10
Perez,325,3,259,2019-02-11T20:00:00Z,False,14,19,90,2,24,13,11,38,20,18,-14,-9
Perez,325,3,268,2019-02-23T15:00:00Z,True,14,9,90,6,25,13,12,11,5,6,14,7
Perez,325,3,278,2019-02-26T20:00:00Z,True,14,3,86,2,28,16,12,30,17,13,-2,3
Perez,325,3,288,2019-03-02T17:30:00Z,False,14,18,90,2,31,19,12,36,21,15,-5,-9
Perez,325,3,298,2019-03-09T15:00:00Z,True,14,7,90,16,31,19,12,37,22,15,-6,4
Perez,325,3,300,2019-03-16T15:00:00Z,False,14,1,71,1,34,22,12,37,25,12,-3,-13
Perez,325,3,310,2019-04-01T19:00:00Z,False,14,0,76,2,35,22,13,60,41,19,-25,-28
Perez,325,3,325,2019-04-06T14:00:00Z,True,14,6,90,2,35,22,13,36,16,20,-1,2
Perez,325,3,334,2019-04-12T19:00:00Z,False,14,10,90,9,35,22,13,47,23,24,-12,-10
Perez,325,3,347,2019-04-20T16:30:00Z,True,14,15,90,17,38,22,16,36,21,15,2,7
Perez,325,3,350,2019-04-27T16:30:00Z,False,14,2,32,7,41,25,16,34,22,12,7,-6
Perez,325,3,367,2019-05-04T18:45:00Z,True,14,11,90,2,42,25,17,91,50,41,-49,-16
Perez,325,3,373,2019-05-12T14:00:00Z,False,14,8,90,7,42,25,17,26,21,5,16,-4
Joselu,326,3,6,2018-08-11T11:30:00Z,True,14,16,58,5,0,0,0,0,0,0,0,0
Joselu,326,3,12,2018-08-18T11:30:00Z,False,14,4,90,2,0,0,0,0,0,0,0,0
Joselu,326,3,26,2018-08-26T15:00:00Z,True,14,5,28,7,1,0,1,6,3,3,-5,-3
Joselu,326,3,37,2018-09-01T16:30:00Z,False,14,12,17,1,1,0,1,7,3,4,-6,-2
Joselu,326,3,45,2018-09-15T14:00:00Z,True,14,0,90,2,1,0,1,6,3,3,-5,-3
Joselu,326,3,54,2018-09-22T14:00:00Z,False,14,6,45,1,1,0,1,6,0,6,-5,1
Joselu,326,3,67,2018-09-29T14:00:00Z,True,14,10,90,2,2,0,2,9,6,3,-7,-3
Joselu,326,3,76,2018-10-06T16:30:00Z,False,14,13,2,1,2,0,2,10,4,6,-8,-2
Joselu,326,3,87,2018-10-20T14:00:00Z,True,14,2,16,1,2,0,2,8,7,1,-6,-1
Joselu,326,3,97,2018-10-27T14:00:00Z,False,14,15,0,0,2,0,2,6,2,4,-4,0
Joselu,326,3,107,2018-11-03T15:00:00Z,True,14,17,0,0,3,0,3,19,12,7,-16,-7
Joselu,326,3,118,2018-11-10T15:00:00Z,True,14,1,0,0,6,3,3,20,11,9,-14,-6
Joselu,326,3,122,2018-11-26T20:30:00Z,False,14,3,19,1,9,6,3,9,4,5,0,-1
Joselu,326,3,138,2018-12-01T15:00:00Z,True,14,18,12,1,12,6,6,12,7,5,0,1
Joselu,326,3,148,2018-12-05T19:45:00Z,False,14,7,16,1,12,6,6,22,16,6,-10,-10
Joselu,326,3,158,2018-12-09T16:00:00Z,True,14,19,4,1,13,6,7,19,11,8,-6,-2
Joselu,326,3,163,2018-12-15T15:00:00Z,False,14,9,0,0,13,6,7,10,5,5,3,2
Joselu,326,3,177,2018-12-22T15:00:00Z,True,14,8,0,0,16,6,10,9,8,1,7,5
Joselu,326,3,185,2018-12-26T15:00:00Z,False,14,11,90,2,17,7,10,48,22,26,-31,-12
Joselu,326,3,199,2018-12-29T15:00:00Z,False,14,17,0,0,17,7,10,27,15,12,-10,-5
Joselu,326,3,207,2019-01-02T20:00:00Z,True,14,13,0,0,18,7,11,35,21,14,-17,-7
Joselu,326,3,213,2019-01-12T17:30:00Z,False,14,5,0,0,18,7,11,44,22,22,-26,-11
Joselu,326,3,226,2019-01-19T15:00:00Z,True,14,4,0,0,18,7,11,19,14,5,-1,2
Joselu,326,3,237,2019-01-29T20:00:00Z,True,14,12,0,0,21,10,11,56,33,23,-35,-13
Joselu,326,3,248,2019-02-02T12:30:00Z,False,14,16,0,0,24,13,11,54,21,33,-30,-10
Joselu,326,3,259,2019-02-11T20:00:00Z,False,14,19,0,0,24,13,11,38,20,18,-14,-9
Joselu,326,3,268,2019-02-23T15:00:00Z,True,14,9,6,1,25,13,12,11,5,6,14,7
Joselu,326,3,278,2019-02-26T20:00:00Z,True,14,3,3,1,28,16,12,30,17,13,-2,3
Joselu,326,3,288,2019-03-02T17:30:00Z,False,14,18,0,0,31,19,12,36,21,15,-5,-9
Joselu,326,3,298,2019-03-09T15:00:00Z,True,14,7,0,0,31,19,12,37,22,15,-6,4
Joselu,326,3,300,2019-03-16T15:00:00Z,False,14,1,0,0,34,22,12,37,25,12,-3,-13
Joselu,326,3,310,2019-04-01T19:00:00Z,False,14,0,0,0,35,22,13,60,41,19,-25,-28
Joselu,326,3,325,2019-04-06T14:00:00Z,True,14,6,0,0,35,22,13,36,16,20,-1,2
Joselu,326,3,334,2019-04-12T19:00:00Z,False,14,10,0,0,35,22,13,47,23,24,-12,-10
Joselu,326,3,347,2019-04-20T16:30:00Z,True,14,15,0,0,38,22,16,36,21,15,2,7
Joselu,326,3,350,2019-04-27T16:30:00Z,False,14,2,0,0,41,25,16,34,22,12,7,-6
Joselu,326,3,367,2019-05-04T18:45:00Z,True,14,11,0,0,42,25,17,91,50,41,-49,-16
Joselu,326,3,373,2019-05-12T14:00:00Z,False,14,8,0,0,42,25,17,26,21,5,16,-4
McCarthy,327,0,7,2018-08-12T12:30:00Z,True,15,3,90,11,0,0,0,0,0,0,0,0
McCarthy,327,0,15,2018-08-18T14:00:00Z,False,15,7,90,2,1,1,0,1,0,1,0,0
McCarthy,327,0,27,2018-08-25T14:00:00Z,True,15,10,90,2,1,1,0,3,3,0,-2,1
McCarthy,327,0,34,2018-09-01T14:00:00Z,False,15,6,90,8,1,1,0,3,0,3,-2,0
McCarthy,327,0,46,2018-09-17T19:00:00Z,True,15,2,90,0,4,1,3,4,4,0,0,1
McCarthy,327,0,57,2018-09-22T14:00:00Z,False,15,11,90,1,5,2,3,15,6,9,-10,-3
McCarthy,327,0,69,2018-09-29T14:00:00Z,False,15,19,90,2,5,2,3,9,5,4,-4,-2
McCarthy,327,0,77,2018-10-07T13:15:00Z,True,15,5,90,2,5,2,3,17,10,7,-12,-5
McCarthy,327,0,81,2018-10-20T14:00:00Z,False,15,1,90,6,5,2,3,16,10,6,-11,-7
McCarthy,327,0,97,2018-10-27T14:00:00Z,True,15,14,90,6,6,2,4,2,0,2,4,0
McCarthy,327,0,106,2018-11-04T15:00:00Z,False,15,12,90,0,7,3,4,26,15,11,-19,-11
McCarthy,327,0,119,2018-11-10T15:00:00Z,True,15,17,90,5,7,3,4,19,12,7,-12,-4
McCarthy,327,0,124,2018-11-24T15:00:00Z,False,15,8,90,1,8,4,4,5,4,1,3,0
McCarthy,327,0,139,2018-12-01T17:30:00Z,True,15,13,90,2,8,4,4,21,11,10,-13,-6
McCarthy,327,0,149,2018-12-05T20:00:00Z,False,15,16,90,2,9,5,4,30,9,21,-21,-5
McCarthy,327,0,153,2018-12-08T15:00:00Z,False,15,4,90,3,9,5,4,11,10,1,-2,-6
McCarthy,327,0,166,2018-12-16T13:30:00Z,True,15,0,90,1,9,5,4,34,20,14,-25,-9
McCarthy,327,0,175,2018-12-22T15:00:00Z,False,15,9,90,3,12,8,4,10,5,5,2,-1
McCarthy,327,0,187,2018-12-27T19:45:00Z,True,15,18,90,2,15,8,7,24,13,11,-9,-3
McCarthy,327,0,197,2018-12-30T14:15:00Z,True,15,12,90,2,15,8,7,44,27,17,-29,-9
McCarthy,327,0,203,2019-01-02T19:45:00Z,False,15,5,0,0,15,8,7,43,21,22,-28,-14
McCarthy,327,0,216,2019-01-12T15:00:00Z,False,15,10,90,3,16,8,8,31,14,17,-15,-6
McCarthy,327,0,227,2019-01-19T15:00:00Z,True,15,7,90,2,19,8,11,30,21,9,-11,-1
McCarthy,327,0,238,2019-01-30T19:45:00Z,True,15,6,90,2,22,11,11,22,9,13,0,-2
McCarthy,327,0,241,2019-02-02T15:00:00Z,False,15,3,90,4,23,12,11,23,13,10,0,-2
McCarthy,327,0,256,2019-02-09T15:00:00Z,True,15,4,90,1,24,12,12,22,17,5,2,7
McCarthy,327,0,260,2019-02-24T14:05:00Z,False,15,0,0,0,24,12,12,50,32,18,-26,-20
McCarthy,327,0,279,2019-02-27T19:45:00Z,True,15,8,0,0,24,12,12,17,15,2,7,10
McCarthy,327,0,285,2019-03-02T15:00:00Z,False,15,13,0,0,27,15,12,55,26,29,-28,-14
McCarthy,327,0,299,2019-03-09T15:00:00Z,True,15,16,0,0,27,15,12,61,28,33,-34,-18
McCarthy,327,0,311,2019-03-30T15:00:00Z,False,15,2,0,0,30,18,12,33,22,11,-3,-10
McCarthy,327,0,326,2019-04-05T19:00:00Z,True,15,11,0,0,33,18,15,79,44,35,-46,-17
McCarthy,327,0,337,2019-04-13T14:00:00Z,True,15,19,0,0,33,18,15,47,27,20,-14,-2
McCarthy,327,0,347,2019-04-20T16:30:00Z,False,15,14,0,0,36,21,15,38,22,16,-2,-7
McCarthy,327,0,307,2019-04-23T18:45:00Z,False,15,17,0,0,36,21,15,49,26,23,-13,-11
McCarthy,327,0,357,2019-04-27T14:00:00Z,True,15,1,0,0,37,21,16,41,26,15,-4,6
McCarthy,327,0,368,2019-05-04T14:00:00Z,False,15,18,0,0,38,22,16,46,28,18,-8,-12
McCarthy,327,0,377,2019-05-12T14:00:00Z,True,15,9,0,0,38,22,16,15,9,6,23,16
Forster,328,0,7,2018-08-12T12:30:00Z,True,15,3,0,0,0,0,0,0,0,0,0,0
Forster,328,0,15,2018-08-18T14:00:00Z,False,15,7,0,0,1,1,0,1,0,1,0,0
Forster,328,0,27,2018-08-25T14:00:00Z,True,15,10,0,0,1,1,0,3,3,0,-2,1
Forster,328,0,34,2018-09-01T14:00:00Z,False,15,6,0,0,1,1,0,3,0,3,-2,0
Forster,328,0,46,2018-09-17T19:00:00Z,True,15,2,0,0,4,1,3,4,4,0,0,1
Forster,328,0,57,2018-09-22T14:00:00Z,False,15,11,0,0,5,2,3,15,6,9,-10,-3
Forster,328,0,69,2018-09-29T14:00:00Z,False,15,19,0,0,5,2,3,9,5,4,-4,-2
Forster,328,0,77,2018-10-07T13:15:00Z,True,15,5,0,0,5,2,3,17,10,7,-12,-5
Forster,328,0,81,2018-10-20T14:00:00Z,False,15,1,0,0,5,2,3,16,10,6,-11,-7
Forster,328,0,97,2018-10-27T14:00:00Z,True,15,14,0,0,6,2,4,2,0,2,4,0
Forster,328,0,106,2018-11-04T15:00:00Z,False,15,12,0,0,7,3,4,26,15,11,-19,-11
Forster,328,0,119,2018-11-10T15:00:00Z,True,15,17,0,0,7,3,4,19,12,7,-12,-4
Forster,328,0,124,2018-11-24T15:00:00Z,False,15,8,0,0,8,4,4,5,4,1,3,0
Forster,328,0,139,2018-12-01T17:30:00Z,True,15,13,0,0,8,4,4,21,11,10,-13,-6
Forster,328,0,149,2018-12-05T20:00:00Z,False,15,16,0,0,9,5,4,30,9,21,-21,-5
Forster,328,0,153,2018-12-08T15:00:00Z,False,15,4,0,0,9,5,4,11,10,1,-2,-6
Forster,328,0,166,2018-12-16T13:30:00Z,True,15,0,0,0,9,5,4,34,20,14,-25,-9
Forster,328,0,175,2018-12-22T15:00:00Z,False,15,9,0,0,12,8,4,10,5,5,2,-1
Forster,328,0,187,2018-12-27T19:45:00Z,True,15,18,0,0,15,8,7,24,13,11,-9,-3
Forster,328,0,197,2018-12-30T14:15:00Z,True,15,12,0,0,15,8,7,44,27,17,-29,-9
Forster,328,0,203,2019-01-02T19:45:00Z,False,15,5,0,0,15,8,7,43,21,22,-28,-14
Forster,328,0,216,2019-01-12T15:00:00Z,False,15,10,0,0,16,8,8,31,14,17,-15,-6
Forster,328,0,227,2019-01-19T15:00:00Z,True,15,7,0,0,19,8,11,30,21,9,-11,-1
Forster,328,0,238,2019-01-30T19:45:00Z,True,15,6,0,0,22,11,11,22,9,13,0,-2
Forster,328,0,241,2019-02-02T15:00:00Z,False,15,3,0,0,23,12,11,23,13,10,0,-2
Forster,328,0,256,2019-02-09T15:00:00Z,True,15,4,0,0,24,12,12,22,17,5,2,7
Forster,328,0,260,2019-02-24T14:05:00Z,False,15,0,0,0,24,12,12,50,32,18,-26,-20
Forster,328,0,279,2019-02-27T19:45:00Z,True,15,8,0,0,24,12,12,17,15,2,7,10
Forster,328,0,285,2019-03-02T15:00:00Z,False,15,13,0,0,27,15,12,55,26,29,-28,-14
Forster,328,0,299,2019-03-09T15:00:00Z,True,15,16,0,0,27,15,12,61,28,33,-34,-18
Forster,328,0,311,2019-03-30T15:00:00Z,False,15,2,0,0,30,18,12,33,22,11,-3,-10
Forster,328,0,326,2019-04-05T19:00:00Z,True,15,11,0,0,33,18,15,79,44,35,-46,-17
Forster,328,0,337,2019-04-13T14:00:00Z,True,15,19,0,0,33,18,15,47,27,20,-14,-2
Forster,328,0,347,2019-04-20T16:30:00Z,False,15,14,0,0,36,21,15,38,22,16,-2,-7
Forster,328,0,307,2019-04-23T18:45:00Z,False,15,17,0,0,36,21,15,49,26,23,-13,-11
Forster,328,0,357,2019-04-27T14:00:00Z,True,15,1,0,0,37,21,16,41,26,15,-4,6
Forster,328,0,368,2019-05-04T14:00:00Z,False,15,18,90,2,38,22,16,46,28,18,-8,-12
Forster,328,0,377,2019-05-12T14:00:00Z,True,15,9,0,0,38,22,16,15,9,6,23,16
Bertrand,329,1,7,2018-08-12T12:30:00Z,True,15,3,90,6,0,0,0,0,0,0,0,0
Bertrand,329,1,15,2018-08-18T14:00:00Z,False,15,7,90,1,1,1,0,1,0,1,0,0
Bertrand,329,1,27,2018-08-25T14:00:00Z,True,15,10,90,7,1,1,0,3,3,0,-2,1
Bertrand,329,1,34,2018-09-01T14:00:00Z,False,15,6,90,6,1,1,0,3,0,3,-2,0
Bertrand,329,1,46,2018-09-17T19:00:00Z,True,15,2,90,1,4,1,3,4,4,0,0,1
Bertrand,329,1,57,2018-09-22T14:00:00Z,False,15,11,90,1,5,2,3,15,6,9,-10,-3
Bertrand,329,1,69,2018-09-29T14:00:00Z,False,15,19,90,0,5,2,3,9,5,4,-4,-2
Bertrand,329,1,77,2018-10-07T13:15:00Z,True,15,5,90,0,5,2,3,17,10,7,-12,-5
Bertrand,329,1,81,2018-10-20T14:00:00Z,False,15,1,90,5,5,2,3,16,10,6,-11,-7
Bertrand,329,1,97,2018-10-27T14:00:00Z,True,15,14,90,6,6,2,4,2,0,2,4,0
Bertrand,329,1,106,2018-11-04T15:00:00Z,False,15,12,90,-1,7,3,4,26,15,11,-19,-11
Bertrand,329,1,119,2018-11-10T15:00:00Z,True,15,17,90,1,7,3,4,19,12,7,-12,-4
Bertrand,329,1,124,2018-11-24T15:00:00Z,False,15,8,0,0,8,4,4,5,4,1,3,0
Bertrand,329,1,139,2018-12-01T17:30:00Z,True,15,13,0,0,8,4,4,21,11,10,-13,-6
Bertrand,329,1,149,2018-12-05T20:00:00Z,False,15,16,0,0,9,5,4,30,9,21,-21,-5
Bertrand,329,1,153,2018-12-08T15:00:00Z,False,15,4,0,0,9,5,4,11,10,1,-2,-6
Bertrand,329,1,166,2018-12-16T13:30:00Z,True,15,0,0,0,9,5,4,34,20,14,-25,-9
Bertrand,329,1,175,2018-12-22T15:00:00Z,False,15,9,0,0,12,8,4,10,5,5,2,-1
Bertrand,329,1,187,2018-12-27T19:45:00Z,True,15,18,0,0,15,8,7,24,13,11,-9,-3
Bertrand,329,1,197,2018-12-30T14:15:00Z,True,15,12,0,0,15,8,7,44,27,17,-29,-9
Bertrand,329,1,203,2019-01-02T19:45:00Z,False,15,5,0,0,15,8,7,43,21,22,-28,-14
Bertrand,329,1,216,2019-01-12T15:00:00Z,False,15,10,0,0,16,8,8,31,14,17,-15,-6
Bertrand,329,1,227,2019-01-19T15:00:00Z,True,15,7,0,0,19,8,11,30,21,9,-11,-1
Bertrand,329,1,238,2019-01-30T19:45:00Z,True,15,6,0,0,22,11,11,22,9,13,0,-2
Bertrand,329,1,241,2019-02-02T15:00:00Z,False,15,3,0,0,23,12,11,23,13,10,0,-2
Bertrand,329,1,256,2019-02-09T15:00:00Z,True,15,4,90,1,24,12,12,22,17,5,2,7
Bertrand,329,1,260,2019-02-24T14:05:00Z,False,15,0,0,0,24,12,12,50,32,18,-26,-20
Bertrand,329,1,279,2019-02-27T19:45:00Z,True,15,8,90,6,24,12,12,17,15,2,7,10
Bertrand,329,1,285,2019-03-02T15:00:00Z,False,15,13,90,0,27,15,12,55,26,29,-28,-14
Bertrand,329,1,299,2019-03-09T15:00:00Z,True,15,16,90,2,27,15,12,61,28,33,-34,-18
Bertrand,329,1,311,2019-03-30T15:00:00Z,False,15,2,90,6,30,18,12,33,22,11,-3,-10
Bertrand,329,1,326,2019-04-05T19:00:00Z,True,15,11,90,0,33,18,15,79,44,35,-46,-17
Bertrand,329,1,337,2019-04-13T14:00:00Z,True,15,19,90,1,33,18,15,47,27,20,-14,-2
Bertrand,329,1,347,2019-04-20T16:30:00Z,False,15,14,90,1,36,21,15,38,22,16,-2,-7
Bertrand,329,1,307,2019-04-23T18:45:00Z,False,15,17,90,2,36,21,15,49,26,23,-13,-11
Bertrand,329,1,357,2019-04-27T14:00:00Z,True,15,1,90,1,37,21,16,41,26,15,-4,6
Bertrand,329,1,368,2019-05-04T14:00:00Z,False,15,18,90,1,38,22,16,46,28,18,-8,-12
Bertrand,329,1,377,2019-05-12T14:00:00Z,True,15,9,90,2,38,22,16,15,9,6,23,16
Yoshida,330,1,7,2018-08-12T12:30:00Z,True,15,3,0,0,0,0,0,0,0,0,0,0
Yoshida,330,1,15,2018-08-18T14:00:00Z,False,15,7,0,0,1,1,0,1,0,1,0,0
Yoshida,330,1,27,2018-08-25T14:00:00Z,True,15,10,0,0,1,1,0,3,3,0,-2,1
Yoshida,330,1,34,2018-09-01T14:00:00Z,False,15,6,0,0,1,1,0,3,0,3,-2,0
Yoshida,330,1,46,2018-09-17T19:00:00Z,True,15,2,0,0,4,1,3,4,4,0,0,1
Yoshida,330,1,57,2018-09-22T14:00:00Z,False,15,11,0,0,5,2,3,15,6,9,-10,-3
Yoshida,330,1,69,2018-09-29T14:00:00Z,False,15,19,0,0,5,2,3,9,5,4,-4,-2
Yoshida,330,1,77,2018-10-07T13:15:00Z,True,15,5,90,1,5,2,3,17,10,7,-12,-5
Yoshida,330,1,81,2018-10-20T14:00:00Z,False,15,1,0,0,5,2,3,16,10,6,-11,-7
Yoshida,330,1,97,2018-10-27T14:00:00Z,True,15,14,0,0,6,2,4,2,0,2,4,0
Yoshida,330,1,106,2018-11-04T15:00:00Z,False,15,12,0,0,7,3,4,26,15,11,-19,-11
Yoshida,330,1,119,2018-11-10T15:00:00Z,True,15,17,90,2,7,3,4,19,12,7,-12,-4
Yoshida,330,1,124,2018-11-24T15:00:00Z,False,15,8,90,1,8,4,4,5,4,1,3,0
Yoshida,330,1,139,2018-12-01T17:30:00Z,True,15,13,90,1,8,4,4,21,11,10,-13,-6
Yoshida,330,1,149,2018-12-05T20:00:00Z,False,15,16,90,1,9,5,4,30,9,21,-21,-5
Yoshida,330,1,153,2018-12-08T15:00:00Z,False,15,4,0,0,9,5,4,11,10,1,-2,-6
Yoshida,330,1,166,2018-12-16T13:30:00Z,True,15,0,90,1,9,5,4,34,20,14,-25,-9
Yoshida,330,1,175,2018-12-22T15:00:00Z,False,15,9,90,2,12,8,4,10,5,5,2,-1
Yoshida,330,1,187,2018-12-27T19:45:00Z,True,15,18,79,1,15,8,7,24,13,11,-9,-3
Yoshida,330,1,197,2018-12-30T14:15:00Z,True,15,12,0,0,15,8,7,44,27,17,-29,-9
Yoshida,330,1,203,2019-01-02T19:45:00Z,False,15,5,90,6,15,8,7,43,21,22,-28,-14
Yoshida,330,1,216,2019-01-12T15:00:00Z,False,15,10,0,0,16,8,8,31,14,17,-15,-6
Yoshida,330,1,227,2019-01-19T15:00:00Z,True,15,7,0,0,19,8,11,30,21,9,-11,-1
Yoshida,330,1,238,2019-01-30T19:45:00Z,True,15,6,0,0,22,11,11,22,9,13,0,-2
Yoshida,330,1,241,2019-02-02T15:00:00Z,False,15,3,0,0,23,12,11,23,13,10,0,-2
Yoshida,330,1,256,2019-02-09T15:00:00Z,True,15,4,0,0,24,12,12,22,17,5,2,7
Yoshida,330,1,260,2019-02-24T14:05:00Z,False,15,0,0,0,24,12,12,50,32,18,-26,-20
Yoshida,330,1,279,2019-02-27T19:45:00Z,True,15,8,90,8,24,12,12,17,15,2,7,10
Yoshida,330,1,285,2019-03-02T15:00:00Z,False,15,13,89,1,27,15,12,55,26,29,-28,-14
Yoshida,330,1,299,2019-03-09T15:00:00Z,True,15,16,90,2,27,15,12,61,28,33,-34,-18
Yoshida,330,1,311,2019-03-30T15:00:00Z,False,15,2,90,8,30,18,12,33,22,11,-3,-10
Yoshida,330,1,326,2019-04-05T19:00:00Z,True,15,11,90,1,33,18,15,79,44,35,-46,-17
Yoshida,330,1,337,2019-04-13T14:00:00Z,True,15,19,90,5,33,18,15,47,27,20,-14,-2
Yoshida,330,1,347,2019-04-20T16:30:00Z,False,15,14,90,1,36,21,15,38,22,16,-2,-7
Yoshida,330,1,307,2019-04-23T18:45:00Z,False,15,17,90,2,36,21,15,49,26,23,-13,-11
Yoshida,330,1,357,2019-04-27T14:00:00Z,True,15,1,0,0,37,21,16,41,26,15,-4,6
Yoshida,330,1,368,2019-05-04T14:00:00Z,False,15,18,0,0,38,22,16,46,28,18,-8,-12
Yoshida,330,1,377,2019-05-12T14:00:00Z,True,15,9,0,0,38,22,16,15,9,6,23,16
Cedric,331,1,7,2018-08-12T12:30:00Z,True,15,3,55,1,0,0,0,0,0,0,0,0
Cedric,331,1,15,2018-08-18T14:00:00Z,False,15,7,90,0,1,1,0,1,0,1,0,0
Cedric,331,1,27,2018-08-25T14:00:00Z,True,15,10,90,1,1,1,0,3,3,0,-2,1
Cedric,331,1,34,2018-09-01T14:00:00Z,False,15,6,90,12,1,1,0,3,0,3,-2,0
Cedric,331,1,46,2018-09-17T19:00:00Z,True,15,2,90,0,4,1,3,4,4,0,0,1
Cedric,331,1,57,2018-09-22T14:00:00Z,False,15,11,90,1,5,2,3,15,6,9,-10,-3
Cedric,331,1,69,2018-09-29T14:00:00Z,False,15,19,90,1,5,2,3,9,5,4,-4,-2
Cedric,331,1,77,2018-10-07T13:15:00Z,True,15,5,90,0,5,2,3,17,10,7,-12,-5
Cedric,331,1,81,2018-10-20T14:00:00Z,False,15,1,90,9,5,2,3,16,10,6,-11,-7
Cedric,331,1,97,2018-10-27T14:00:00Z,True,15,14,90,7,6,2,4,2,0,2,4,0
Cedric,331,1,106,2018-11-04T15:00:00Z,False,15,12,90,-1,7,3,4,26,15,11,-19,-11
Cedric,331,1,119,2018-11-10T15:00:00Z,True,15,17,90,1,7,3,4,19,12,7,-12,-4
Cedric,331,1,124,2018-11-24T15:00:00Z,False,15,8,90,4,8,4,4,5,4,1,3,0
Cedric,331,1,139,2018-12-01T17:30:00Z,True,15,13,90,7,8,4,4,21,11,10,-13,-6
Cedric,331,1,149,2018-12-05T20:00:00Z,False,15,16,90,1,9,5,4,30,9,21,-21,-5
Cedric,331,1,153,2018-12-08T15:00:00Z,False,15,4,0,0,9,5,4,11,10,1,-2,-6
Cedric,331,1,166,2018-12-16T13:30:00Z,True,15,0,0,0,9,5,4,34,20,14,-25,-9
Cedric,331,1,175,2018-12-22T15:00:00Z,False,15,9,0,0,12,8,4,10,5,5,2,-1
Cedric,331,1,187,2018-12-27T19:45:00Z,True,15,18,0,0,15,8,7,24,13,11,-9,-3
Cedric,331,1,197,2018-12-30T14:15:00Z,True,15,12,0,0,15,8,7,44,27,17,-29,-9
Cedric,331,1,203,2019-01-02T19:45:00Z,False,15,5,90,6,15,8,7,43,21,22,-28,-14
Cedric,331,1,216,2019-01-12T15:00:00Z,False,15,10,33,1,16,8,8,31,14,17,-15,-6
Cedric,331,1,227,2019-01-19T15:00:00Z,True,15,7,55,1,19,8,11,30,21,9,-11,-1
Cedric,331,1,238,2019-01-30T19:45:00Z,True,15,6,0,0,22,11,11,22,9,13,0,-2
Cedric,331,1,241,2019-02-02T15:00:00Z,False,15,3,0,0,23,12,11,23,13,10,0,-2
Cedric,331,1,256,2019-02-09T15:00:00Z,True,15,4,0,0,24,12,12,22,17,5,2,7
Cedric,331,1,260,2019-02-24T14:05:00Z,False,15,0,0,0,24,12,12,50,32,18,-26,-20
Cedric,331,1,279,2019-02-27T19:45:00Z,True,15,8,0,0,24,12,12,17,15,2,7,10
Cedric,331,1,285,2019-03-02T15:00:00Z,False,15,13,0,0,27,15,12,55,26,29,-28,-14
Cedric,331,1,299,2019-03-09T15:00:00Z,True,15,16,0,0,27,15,12,61,28,33,-34,-18
Cedric,331,1,311,2019-03-30T15:00:00Z,False,15,2,0,0,30,18,12,33,22,11,-3,-10
Cedric,331,1,326,2019-04-05T19:00:00Z,True,15,11,0,0,33,18,15,79,44,35,-46,-17
Cedric,331,1,337,2019-04-13T14:00:00Z,True,15,19,0,0,33,18,15,47,27,20,-14,-2
Cedric,331,1,347,2019-04-20T16:30:00Z,False,15,14,0,0,36,21,15,38,22,16,-2,-7
Cedric,331,1,307,2019-04-23T18:45:00Z,False,15,17,0,0,36,21,15,49,26,23,-13,-11
Cedric,331,1,357,2019-04-27T14:00:00Z,True,15,1,0,0,37,21,16,41,26,15,-4,6
Cedric,331,1,368,2019-05-04T14:00:00Z,False,15,18,0,0,38,22,16,46,28,18,-8,-12
Cedric,331,1,377,2019-05-12T14:00:00Z,True,15,9,0,0,38,22,16,15,9,6,23,16
Stephens,332,1,7,2018-08-12T12:30:00Z,True,15,3,90,6,0,0,0,0,0,0,0,0
Stephens,332,1,15,2018-08-18T14:00:00Z,False,15,7,90,0,1,1,0,1,0,1,0,0
Stephens,332,1,27,2018-08-25T14:00:00Z,True,15,10,0,0,1,1,0,3,3,0,-2,1
Stephens,332,1,34,2018-09-01T14:00:00Z,False,15,6,0,0,1,1,0,3,0,3,-2,0
Stephens,332,1,46,2018-09-17T19:00:00Z,True,15,2,0,0,4,1,3,4,4,0,0,1
Stephens,332,1,57,2018-09-22T14:00:00Z,False,15,11,0,0,5,2,3,15,6,9,-10,-3
Stephens,332,1,69,2018-09-29T14:00:00Z,False,15,19,0,0,5,2,3,9,5,4,-4,-2
Stephens,332,1,77,2018-10-07T13:15:00Z,True,15,5,0,0,5,2,3,17,10,7,-12,-5
Stephens,332,1,81,2018-10-20T14:00:00Z,False,15,1,90,6,5,2,3,16,10,6,-11,-7
Stephens,332,1,97,2018-10-27T14:00:00Z,True,15,14,90,7,6,2,4,2,0,2,4,0
Stephens,332,1,106,2018-11-04T15:00:00Z,False,15,12,90,-1,7,3,4,26,15,11,-19,-11
Stephens,332,1,119,2018-11-10T15:00:00Z,True,15,17,0,0,7,3,4,19,12,7,-12,-4
Stephens,332,1,124,2018-11-24T15:00:00Z,False,15,8,0,0,8,4,4,5,4,1,3,0
Stephens,332,1,139,2018-12-01T17:30:00Z,True,15,13,90,1,8,4,4,21,11,10,-13,-6
Stephens,332,1,149,2018-12-05T20:00:00Z,False,15,16,90,1,9,5,4,30,9,21,-21,-5
Stephens,332,1,153,2018-12-08T15:00:00Z,False,15,4,45,1,9,5,4,11,10,1,-2,-6
Stephens,332,1,166,2018-12-16T13:30:00Z,True,15,0,0,0,9,5,4,34,20,14,-25,-9
Stephens,332,1,175,2018-12-22T15:00:00Z,False,15,9,11,0,12,8,4,10,5,5,2,-1
Stephens,332,1,187,2018-12-27T19:45:00Z,True,15,18,0,0,15,8,7,24,13,11,-9,-3
Stephens,332,1,197,2018-12-30T14:15:00Z,True,15,12,90,1,15,8,7,44,27,17,-29,-9
Stephens,332,1,203,2019-01-02T19:45:00Z,False,15,5,1,1,15,8,7,43,21,22,-28,-14
Stephens,332,1,216,2019-01-12T15:00:00Z,False,15,10,90,1,16,8,8,31,14,17,-15,-6
Stephens,332,1,227,2019-01-19T15:00:00Z,True,15,7,90,2,19,8,11,30,21,9,-11,-1
Stephens,332,1,238,2019-01-30T19:45:00Z,True,15,6,90,2,22,11,11,22,9,13,0,-2
Stephens,332,1,241,2019-02-02T15:00:00Z,False,15,3,90,2,23,12,11,23,13,10,0,-2
Stephens,332,1,256,2019-02-09T15:00:00Z,True,15,4,90,10,24,12,12,22,17,5,2,7
Stephens,332,1,260,2019-02-24T14:05:00Z,False,15,0,45,0,24,12,12,50,32,18,-26,-20
Stephens,332,1,279,2019-02-27T19:45:00Z,True,15,8,0,0,24,12,12,17,15,2,7,10
Stephens,332,1,285,2019-03-02T15:00:00Z,False,15,13,0,0,27,15,12,55,26,29,-28,-14
Stephens,332,1,299,2019-03-09T15:00:00Z,True,15,16,0,0,27,15,12,61,28,33,-34,-18
Stephens,332,1,311,2019-03-30T15:00:00Z,False,15,2,14,0,30,18,12,33,22,11,-3,-10
Stephens,332,1,326,2019-04-05T19:00:00Z,True,15,11,0,0,33,18,15,79,44,35,-46,-17
Stephens,332,1,337,2019-04-13T14:00:00Z,True,15,19,6,1,33,18,15,47,27,20,-14,-2
Stephens,332,1,347,2019-04-20T16:30:00Z,False,15,14,45,0,36,21,15,38,22,16,-2,-7
Stephens,332,1,307,2019-04-23T18:45:00Z,False,15,17,90,2,36,21,15,49,26,23,-13,-11
Stephens,332,1,357,2019-04-27T14:00:00Z,True,15,1,90,1,37,21,16,41,26,15,-4,6
Stephens,332,1,368,2019-05-04T14:00:00Z,False,15,18,90,1,38,22,16,46,28,18,-8,-12
Stephens,332,1,377,2019-05-12T14:00:00Z,True,15,9,90,2,38,22,16,15,9,6,23,16
McQueen,333,1,7,2018-08-12T12:30:00Z,True,15,3,0,0,0,0,0,0,0,0,0,0
McQueen,333,1,15,2018-08-18T14:00:00Z,False,15,7,0,0,1,1,0,1,0,1,0,0
McQueen,333,1,27,2018-08-25T14:00:00Z,True,15,10,0,0,1,1,0,3,3,0,-2,1
McQueen,333,1,34,2018-09-01T14:00:00Z,False,15,6,0,0,1,1,0,3,0,3,-2,0
McQueen,333,1,46,2018-09-17T19:00:00Z,True,15,2,0,0,4,1,3,4,4,0,0,1
McQueen,333,1,57,2018-09-22T14:00:00Z,False,15,11,0,0,5,2,3,15,6,9,-10,-3
McQueen,333,1,69,2018-09-29T14:00:00Z,False,15,19,0,0,5,2,3,9,5,4,-4,-2
McQueen,333,1,77,2018-10-07T13:15:00Z,True,15,5,0,0,5,2,3,17,10,7,-12,-5
McQueen,333,1,81,2018-10-20T14:00:00Z,False,15,1,0,0,5,2,3,16,10,6,-11,-7
McQueen,333,1,97,2018-10-27T14:00:00Z,True,15,14,0,0,6,2,4,2,0,2,4,0
McQueen,333,1,106,2018-11-04T15:00:00Z,False,15,12,0,0,7,3,4,26,15,11,-19,-11
McQueen,333,1,119,2018-11-10T15:00:00Z,True,15,17,0,0,7,3,4,19,12,7,-12,-4
McQueen,333,1,124,2018-11-24T15:00:00Z,False,15,8,0,0,8,4,4,5,4,1,3,0
McQueen,333,1,139,2018-12-01T17:30:00Z,True,15,13,0,0,8,4,4,21,11,10,-13,-6
McQueen,333,1,149,2018-12-05T20:00:00Z,False,15,16,0,0,9,5,4,30,9,21,-21,-5
McQueen,333,1,153,2018-12-08T15:00:00Z,False,15,4,0,0,9,5,4,11,10,1,-2,-6
McQueen,333,1,166,2018-12-16T13:30:00Z,True,15,0,0,0,9,5,4,34,20,14,-25,-9
McQueen,333,1,175,2018-12-22T15:00:00Z,False,15,9,0,0,12,8,4,10,5,5,2,-1
McQueen,333,1,187,2018-12-27T19:45:00Z,True,15,18,0,0,15,8,7,24,13,11,-9,-3
McQueen,333,1,197,2018-12-30T14:15:00Z,True,15,12,0,0,15,8,7,44,27,17,-29,-9
McQueen,333,1,203,2019-01-02T19:45:00Z,False,15,5,0,0,15,8,7,43,21,22,-28,-14
McQueen,333,1,216,2019-01-12T15:00:00Z,False,15,10,0,0,16,8,8,31,14,17,-15,-6
McQueen,333,1,227,2019-01-19T15:00:00Z,True,15,7,0,0,19,8,11,30,21,9,-11,-1
McQueen,333,1,238,2019-01-30T19:45:00Z,True,15,6,0,0,22,11,11,22,9,13,0,-2
McQueen,333,1,241,2019-02-02T15:00:00Z,False,15,3,0,0,23,12,11,23,13,10,0,-2
McQueen,333,1,256,2019-02-09T15:00:00Z,True,15,4,0,0,24,12,12,22,17,5,2,7
McQueen,333,1,260,2019-02-24T14:05:00Z,False,15,0,0,0,24,12,12,50,32,18,-26,-20
McQueen,333,1,279,2019-02-27T19:45:00Z,True,15,8,0,0,24,12,12,17,15,2,7,10
McQueen,333,1,285,2019-03-02T15:00:00Z,False,15,13,0,0,27,15,12,55,26,29,-28,-14
McQueen,333,1,299,2019-03-09T15:00:00Z,True,15,16,0,0,27,15,12,61,28,33,-34,-18
McQueen,333,1,311,2019-03-30T15:00:00Z,False,15,2,0,0,30,18,12,33,22,11,-3,-10
McQueen,333,1,326,2019-04-05T19:00:00Z,True,15,11,0,0,33,18,15,79,44,35,-46,-17
McQueen,333,1,337,2019-04-13T14:00:00Z,True,15,19,0,0,33,18,15,47,27,20,-14,-2
McQueen,333,1,347,2019-04-20T16:30:00Z,False,15,14,0,0,36,21,15,38,22,16,-2,-7
McQueen,333,1,307,2019-04-23T18:45:00Z,False,15,17,0,0,36,21,15,49,26,23,-13,-11
McQueen,333,1,357,2019-04-27T14:00:00Z,True,15,1,0,0,37,21,16,41,26,15,-4,6
McQueen,333,1,368,2019-05-04T14:00:00Z,False,15,18,0,0,38,22,16,46,28,18,-8,-12
McQueen,333,1,377,2019-05-12T14:00:00Z,True,15,9,0,0,38,22,16,15,9,6,23,16
Bednarek,334,1,7,2018-08-12T12:30:00Z,True,15,3,0,0,0,0,0,0,0,0,0,0
Bednarek,334,1,15,2018-08-18T14:00:00Z,False,15,7,0,0,1,1,0,1,0,1,0,0
Bednarek,334,1,27,2018-08-25T14:00:00Z,True,15,10,0,0,1,1,0,3,3,0,-2,1
Bednarek,334,1,34,2018-09-01T14:00:00Z,False,15,6,0,0,1,1,0,3,0,3,-2,0
Bednarek,334,1,46,2018-09-17T19:00:00Z,True,15,2,0,0,4,1,3,4,4,0,0,1
Bednarek,334,1,57,2018-09-22T14:00:00Z,False,15,11,35,1,5,2,3,15,6,9,-10,-3
Bednarek,334,1,69,2018-09-29T14:00:00Z,False,15,19,0,0,5,2,3,9,5,4,-4,-2
Bednarek,334,1,77,2018-10-07T13:15:00Z,True,15,5,45,1,5,2,3,17,10,7,-12,-5
Bednarek,334,1,81,2018-10-20T14:00:00Z,False,15,1,0,0,5,2,3,16,10,6,-11,-7
Bednarek,334,1,97,2018-10-27T14:00:00Z,True,15,14,0,0,6,2,4,2,0,2,4,0
Bednarek,334,1,106,2018-11-04T15:00:00Z,False,15,12,0,0,7,3,4,26,15,11,-19,-11
Bednarek,334,1,119,2018-11-10T15:00:00Z,True,15,17,0,0,7,3,4,19,12,7,-12,-4
Bednarek,334,1,124,2018-11-24T15:00:00Z,False,15,8,0,0,8,4,4,5,4,1,3,0
Bednarek,334,1,139,2018-12-01T17:30:00Z,True,15,13,0,0,8,4,4,21,11,10,-13,-6
Bednarek,334,1,149,2018-12-05T20:00:00Z,False,15,16,0,0,9,5,4,30,9,21,-21,-5
Bednarek,334,1,153,2018-12-08T15:00:00Z,False,15,4,90,2,9,5,4,11,10,1,-2,-6
Bednarek,334,1,166,2018-12-16T13:30:00Z,True,15,0,90,0,9,5,4,34,20,14,-25,-9
Bednarek,334,1,175,2018-12-22T15:00:00Z,False,15,9,90,2,12,8,4,10,5,5,2,-1
Bednarek,334,1,187,2018-12-27T19:45:00Z,True,15,18,90,0,15,8,7,24,13,11,-9,-3
Bednarek,334,1,197,2018-12-30T14:15:00Z,True,15,12,90,0,15,8,7,44,27,17,-29,-9
Bednarek,334,1,203,2019-01-02T19:45:00Z,False,15,5,90,5,15,8,7,43,21,22,-28,-14
Bednarek,334,1,216,2019-01-12T15:00:00Z,False,15,10,90,2,16,8,8,31,14,17,-15,-6
Bednarek,334,1,227,2019-01-19T15:00:00Z,True,15,7,90,2,19,8,11,30,21,9,-11,-1
Bednarek,334,1,238,2019-01-30T19:45:00Z,True,15,6,90,1,22,11,11,22,9,13,0,-2
Bednarek,334,1,241,2019-02-02T15:00:00Z,False,15,3,90,7,23,12,11,23,13,10,0,-2
Bednarek,334,1,256,2019-02-09T15:00:00Z,True,15,4,90,1,24,12,12,22,17,5,2,7
Bednarek,334,1,260,2019-02-24T14:05:00Z,False,15,0,90,1,24,12,12,50,32,18,-26,-20
Bednarek,334,1,279,2019-02-27T19:45:00Z,True,15,8,90,6,24,12,12,17,15,2,7,10
Bednarek,334,1,285,2019-03-02T15:00:00Z,False,15,13,90,1,27,15,12,55,26,29,-28,-14
Bednarek,334,1,299,2019-03-09T15:00:00Z,True,15,16,90,2,27,15,12,61,28,33,-34,-18
Bednarek,334,1,311,2019-03-30T15:00:00Z,False,15,2,90,7,30,18,12,33,22,11,-3,-10
Bednarek,334,1,326,2019-04-05T19:00:00Z,True,15,11,90,0,33,18,15,79,44,35,-46,-17
Bednarek,334,1,337,2019-04-13T14:00:00Z,True,15,19,90,2,33,18,15,47,27,20,-14,-2
Bednarek,334,1,347,2019-04-20T16:30:00Z,False,15,14,90,1,36,21,15,38,22,16,-2,-7
Bednarek,334,1,307,2019-04-23T18:45:00Z,False,15,17,90,1,36,21,15,49,26,23,-13,-11
Bednarek,334,1,357,2019-04-27T14:00:00Z,True,15,1,90,1,37,21,16,41,26,15,-4,6
Bednarek,334,1,368,2019-05-04T14:00:00Z,False,15,18,90,1,38,22,16,46,28,18,-8,-12
Bednarek,334,1,377,2019-05-12T14:00:00Z,True,15,9,90,2,38,22,16,15,9,6,23,16
Hoedt,335,1,7,2018-08-12T12:30:00Z,True,15,3,90,6,0,0,0,0,0,0,0,0
Hoedt,335,1,15,2018-08-18T14:00:00Z,False,15,7,90,0,1,1,0,1,0,1,0,0
Hoedt,335,1,27,2018-08-25T14:00:00Z,True,15,10,90,1,1,1,0,3,3,0,-2,1
Hoedt,335,1,34,2018-09-01T14:00:00Z,False,15,6,90,6,1,1,0,3,0,3,-2,0
Hoedt,335,1,46,2018-09-17T19:00:00Z,True,15,2,90,1,4,1,3,4,4,0,0,1
Hoedt,335,1,57,2018-09-22T14:00:00Z,False,15,11,90,-1,5,2,3,15,6,9,-10,-3
Hoedt,335,1,69,2018-09-29T14:00:00Z,False,15,19,90,1,5,2,3,9,5,4,-4,-2
Hoedt,335,1,77,2018-10-07T13:15:00Z,True,15,5,90,1,5,2,3,17,10,7,-12,-5
Hoedt,335,1,81,2018-10-20T14:00:00Z,False,15,1,90,8,5,2,3,16,10,6,-11,-7
Hoedt,335,1,97,2018-10-27T14:00:00Z,True,15,14,90,7,6,2,4,2,0,2,4,0
Hoedt,335,1,106,2018-11-04T15:00:00Z,False,15,12,90,-3,7,3,4,26,15,11,-19,-11
Hoedt,335,1,119,2018-11-10T15:00:00Z,True,15,17,90,2,7,3,4,19,12,7,-12,-4
Hoedt,335,1,124,2018-11-24T15:00:00Z,False,15,8,90,0,8,4,4,5,4,1,3,0
Hoedt,335,1,139,2018-12-01T17:30:00Z,True,15,13,0,0,8,4,4,21,11,10,-13,-6
Hoedt,335,1,149,2018-12-05T20:00:00Z,False,15,16,0,0,9,5,4,30,9,21,-21,-5
Hoedt,335,1,153,2018-12-08T15:00:00Z,False,15,4,0,0,9,5,4,11,10,1,-2,-6
Hoedt,335,1,166,2018-12-16T13:30:00Z,True,15,0,0,0,9,5,4,34,20,14,-25,-9
Hoedt,335,1,175,2018-12-22T15:00:00Z,False,15,9,0,0,12,8,4,10,5,5,2,-1
Hoedt,335,1,187,2018-12-27T19:45:00Z,True,15,18,0,0,15,8,7,24,13,11,-9,-3
Hoedt,335,1,197,2018-12-30T14:15:00Z,True,15,12,0,0,15,8,7,44,27,17,-29,-9
Hoedt,335,1,203,2019-01-02T19:45:00Z,False,15,5,0,0,15,8,7,43,21,22,-28,-14
Hoedt,335,1,216,2019-01-12T15:00:00Z,False,15,10,0,0,16,8,8,31,14,17,-15,-6
Hoedt,335,1,227,2019-01-19T15:00:00Z,True,15,7,0,0,19,8,11,30,21,9,-11,-1
Hoedt,335,1,238,2019-01-30T19:45:00Z,True,15,6,0,0,22,11,11,22,9,13,0,-2
Hoedt,335,1,241,2019-02-02T15:00:00Z,False,15,3,0,0,23,12,11,23,13,10,0,-2
Hoedt,335,1,256,2019-02-09T15:00:00Z,True,15,4,0,0,24,12,12,22,17,5,2,7
Hoedt,335,1,260,2019-02-24T14:05:00Z,False,15,0,0,0,24,12,12,50,32,18,-26,-20
Hoedt,335,1,279,2019-02-27T19:45:00Z,True,15,8,0,0,24,12,12,17,15,2,7,10
Hoedt,335,1,285,2019-03-02T15:00:00Z,False,15,13,0,0,27,15,12,55,26,29,-28,-14
Hoedt,335,1,299,2019-03-09T15:00:00Z,True,15,16,0,0,27,15,12,61,28,33,-34,-18
Hoedt,335,1,311,2019-03-30T15:00:00Z,False,15,2,0,0,30,18,12,33,22,11,-3,-10
Hoedt,335,1,326,2019-04-05T19:00:00Z,True,15,11,0,0,33,18,15,79,44,35,-46,-17
Hoedt,335,1,337,2019-04-13T14:00:00Z,True,15,19,0,0,33,18,15,47,27,20,-14,-2
Hoedt,335,1,347,2019-04-20T16:30:00Z,False,15,14,0,0,36,21,15,38,22,16,-2,-7
Hoedt,335,1,307,2019-04-23T18:45:00Z,False,15,17,0,0,36,21,15,49,26,23,-13,-11
Hoedt,335,1,357,2019-04-27T14:00:00Z,True,15,1,0,0,37,21,16,41,26,15,-4,6
Hoedt,335,1,368,2019-05-04T14:00:00Z,False,15,18,0,0,38,22,16,46,28,18,-8,-12
Hoedt,335,1,377,2019-05-12T14:00:00Z,True,15,9,0,0,38,22,16,15,9,6,23,16
Davis,336,2,7,2018-08-12T12:30:00Z,True,15,3,0,0,0,0,0,0,0,0,0,0
Davis,336,2,15,2018-08-18T14:00:00Z,False,15,7,0,0,1,1,0,1,0,1,0,0
Davis,336,2,27,2018-08-25T14:00:00Z,True,15,10,0,0,1,1,0,3,3,0,-2,1
Davis,336,2,34,2018-09-01T14:00:00Z,False,15,6,0,0,1,1,0,3,0,3,-2,0
Davis,336,2,46,2018-09-17T19:00:00Z,True,15,2,6,1,4,1,3,4,4,0,0,1
Davis,336,2,57,2018-09-22T14:00:00Z,False,15,11,0,0,5,2,3,15,6,9,-10,-3
Davis,336,2,69,2018-09-29T14:00:00Z,False,15,19,0,0,5,2,3,9,5,4,-4,-2
Davis,336,2,77,2018-10-07T13:15:00Z,True,15,5,0,0,5,2,3,17,10,7,-12,-5
Davis,336,2,81,2018-10-20T14:00:00Z,False,15,1,0,0,5,2,3,16,10,6,-11,-7
Davis,336,2,97,2018-10-27T14:00:00Z,True,15,14,0,0,6,2,4,2,0,2,4,0
Davis,336,2,106,2018-11-04T15:00:00Z,False,15,12,0,0,7,3,4,26,15,11,-19,-11
Davis,336,2,119,2018-11-10T15:00:00Z,True,15,17,0,0,7,3,4,19,12,7,-12,-4
Davis,336,2,124,2018-11-24T15:00:00Z,False,15,8,0,0,8,4,4,5,4,1,3,0
Davis,336,2,139,2018-12-01T17:30:00Z,True,15,13,1,1,8,4,4,21,11,10,-13,-6
Davis,336,2,149,2018-12-05T20:00:00Z,False,15,16,90,7,9,5,4,30,9,21,-21,-5
Davis,336,2,153,2018-12-08T15:00:00Z,False,15,4,0,0,9,5,4,11,10,1,-2,-6
Davis,336,2,166,2018-12-16T13:30:00Z,True,15,0,0,0,9,5,4,34,20,14,-25,-9
Davis,336,2,175,2018-12-22T15:00:00Z,False,15,9,0,0,12,8,4,10,5,5,2,-1
Davis,336,2,187,2018-12-27T19:45:00Z,True,15,18,0,0,15,8,7,24,13,11,-9,-3
Davis,336,2,197,2018-12-30T14:15:00Z,True,15,12,0,0,15,8,7,44,27,17,-29,-9
Davis,336,2,203,2019-01-02T19:45:00Z,False,15,5,0,0,15,8,7,43,21,22,-28,-14
Davis,336,2,216,2019-01-12T15:00:00Z,False,15,10,0,0,16,8,8,31,14,17,-15,-6
Davis,336,2,227,2019-01-19T15:00:00Z,True,15,7,0,0,19,8,11,30,21,9,-11,-1
Davis,336,2,238,2019-01-30T19:45:00Z,True,15,6,0,0,22,11,11,22,9,13,0,-2
Davis,336,2,241,2019-02-02T15:00:00Z,False,15,3,0,0,23,12,11,23,13,10,0,-2
Davis,336,2,256,2019-02-09T15:00:00Z,True,15,4,0,0,24,12,12,22,17,5,2,7
Davis,336,2,260,2019-02-24T14:05:00Z,False,15,0,0,0,24,12,12,50,32,18,-26,-20
Davis,336,2,279,2019-02-27T19:45:00Z,True,15,8,0,0,24,12,12,17,15,2,7,10
Davis,336,2,285,2019-03-02T15:00:00Z,False,15,13,0,0,27,15,12,55,26,29,-28,-14
Davis,336,2,299,2019-03-09T15:00:00Z,True,15,16,0,0,27,15,12,61,28,33,-34,-18
Davis,336,2,311,2019-03-30T15:00:00Z,False,15,2,0,0,30,18,12,33,22,11,-3,-10
Davis,336,2,326,2019-04-05T19:00:00Z,True,15,11,0,0,33,18,15,79,44,35,-46,-17
Davis,336,2,337,2019-04-13T14:00:00Z,True,15,19,0,0,33,18,15,47,27,20,-14,-2
Davis,336,2,347,2019-04-20T16:30:00Z,False,15,14,0,0,36,21,15,38,22,16,-2,-7
Davis,336,2,307,2019-04-23T18:45:00Z,False,15,17,0,0,36,21,15,49,26,23,-13,-11
Davis,336,2,357,2019-04-27T14:00:00Z,True,15,1,0,0,37,21,16,41,26,15,-4,6
Davis,336,2,368,2019-05-04T14:00:00Z,False,15,18,0,0,38,22,16,46,28,18,-8,-12
Davis,336,2,377,2019-05-12T14:00:00Z,True,15,9,0,0,38,22,16,15,9,6,23,16
Ward-Prowse,337,2,7,2018-08-12T12:30:00Z,True,15,3,0,0,0,0,0,0,0,0,0,0
Ward-Prowse,337,2,15,2018-08-18T14:00:00Z,False,15,7,83,2,1,1,0,1,0,1,0,0
Ward-Prowse,337,2,27,2018-08-25T14:00:00Z,True,15,10,0,0,1,1,0,3,3,0,-2,1
Ward-Prowse,337,2,34,2018-09-01T14:00:00Z,False,15,6,0,0,1,1,0,3,0,3,-2,0
Ward-Prowse,337,2,46,2018-09-17T19:00:00Z,True,15,2,14,1,4,1,3,4,4,0,0,1
Ward-Prowse,337,2,57,2018-09-22T14:00:00Z,False,15,11,0,0,5,2,3,15,6,9,-10,-3
Ward-Prowse,337,2,69,2018-09-29T14:00:00Z,False,15,19,0,0,5,2,3,9,5,4,-4,-2
Ward-Prowse,337,2,77,2018-10-07T13:15:00Z,True,15,5,0,0,5,2,3,17,10,7,-12,-5
Ward-Prowse,337,2,81,2018-10-20T14:00:00Z,False,15,1,0,0,5,2,3,16,10,6,-11,-7
Ward-Prowse,337,2,97,2018-10-27T14:00:00Z,True,15,14,12,1,6,2,4,2,0,2,4,0
Ward-Prowse,337,2,106,2018-11-04T15:00:00Z,False,15,12,72,1,7,3,4,26,15,11,-19,-11
Ward-Prowse,337,2,119,2018-11-10T15:00:00Z,True,15,17,16,1,7,3,4,19,12,7,-12,-4
Ward-Prowse,337,2,124,2018-11-24T15:00:00Z,False,15,8,0,0,8,4,4,5,4,1,3,0
Ward-Prowse,337,2,139,2018-12-01T17:30:00Z,True,15,13,0,0,8,4,4,21,11,10,-13,-6
Ward-Prowse,337,2,149,2018-12-05T20:00:00Z,False,15,16,90,2,9,5,4,30,9,21,-21,-5
Ward-Prowse,337,2,153,2018-12-08T15:00:00Z,False,15,4,10,1,9,5,4,11,10,1,-2,-6
Ward-Prowse,337,2,166,2018-12-16T13:30:00Z,True,15,0,0,0,9,5,4,34,20,14,-25,-9
Ward-Prowse,337,2,175,2018-12-22T15:00:00Z,False,15,9,0,0,12,8,4,10,5,5,2,-1
Ward-Prowse,337,2,187,2018-12-27T19:45:00Z,True,15,18,0,0,15,8,7,24,13,11,-9,-3
Ward-Prowse,337,2,197,2018-12-30T14:15:00Z,True,15,12,90,0,15,8,7,44,27,17,-29,-9
Ward-Prowse,337,2,203,2019-01-02T19:45:00Z,False,15,5,90,3,15,8,7,43,21,22,-28,-14
Ward-Prowse,337,2,216,2019-01-12T15:00:00Z,False,15,10,90,9,16,8,8,31,14,17,-15,-6
Ward-Prowse,337,2,227,2019-01-19T15:00:00Z,True,15,7,90,10,19,8,11,30,21,9,-11,-1
Ward-Prowse,337,2,238,2019-01-30T19:45:00Z,True,15,6,90,10,22,11,11,22,9,13,0,-2
Ward-Prowse,337,2,241,2019-02-02T15:00:00Z,False,15,3,90,2,23,12,11,23,13,10,0,-2
Ward-Prowse,337,2,256,2019-02-09T15:00:00Z,True,15,4,90,1,24,12,12,22,17,5,2,7
Ward-Prowse,337,2,260,2019-02-24T14:05:00Z,False,15,0,90,2,24,12,12,50,32,18,-26,-20
Ward-Prowse,337,2,279,2019-02-27T19:45:00Z,True,15,8,90,9,24,12,12,17,15,2,7,10
Ward-Prowse,337,2,285,2019-03-02T15:00:00Z,False,15,13,90,8,27,15,12,55,26,29,-28,-14
Ward-Prowse,337,2,299,2019-03-09T15:00:00Z,True,15,16,90,10,27,15,12,61,28,33,-34,-18
Ward-Prowse,337,2,311,2019-03-30T15:00:00Z,False,15,2,90,2,30,18,12,33,22,11,-3,-10
Ward-Prowse,337,2,326,2019-04-05T19:00:00Z,True,15,11,90,2,33,18,15,79,44,35,-46,-17
Ward-Prowse,337,2,337,2019-04-13T14:00:00Z,True,15,19,90,2,33,18,15,47,27,20,-14,-2
Ward-Prowse,337,2,347,2019-04-20T16:30:00Z,False,15,14,90,1,36,21,15,38,22,16,-2,-7
Ward-Prowse,337,2,307,2019-04-23T18:45:00Z,False,15,17,90,2,36,21,15,49,26,23,-13,-11
Ward-Prowse,337,2,357,2019-04-27T14:00:00Z,True,15,1,90,9,37,21,16,41,26,15,-4,6
Ward-Prowse,337,2,368,2019-05-04T14:00:00Z,False,15,18,23,1,38,22,16,46,28,18,-8,-12
Ward-Prowse,337,2,377,2019-05-12T14:00:00Z,True,15,9,90,2,38,22,16,15,9,6,23,16
Oriol Romeu,338,2,7,2018-08-12T12:30:00Z,True,15,3,90,3,0,0,0,0,0,0,0,0
Oriol Romeu,338,2,15,2018-08-18T14:00:00Z,False,15,7,71,1,1,1,0,1,0,1,0,0
Oriol Romeu,338,2,27,2018-08-25T14:00:00Z,True,15,10,11,1,1,1,0,3,3,0,-2,1
Oriol Romeu,338,2,34,2018-09-01T14:00:00Z,False,15,6,12,1,1,1,0,3,0,3,-2,0
Oriol Romeu,338,2,46,2018-09-17T19:00:00Z,True,15,2,0,0,4,1,3,4,4,0,0,1
Oriol Romeu,338,2,57,2018-09-22T14:00:00Z,False,15,11,54,0,5,2,3,15,6,9,-10,-3
Oriol Romeu,338,2,69,2018-09-29T14:00:00Z,False,15,19,0,0,5,2,3,9,5,4,-4,-2
Oriol Romeu,338,2,77,2018-10-07T13:15:00Z,True,15,5,45,0,5,2,3,17,10,7,-12,-5
Oriol Romeu,338,2,81,2018-10-20T14:00:00Z,False,15,1,0,0,5,2,3,16,10,6,-11,-7
Oriol Romeu,338,2,97,2018-10-27T14:00:00Z,True,15,14,77,3,6,2,4,2,0,2,4,0
Oriol Romeu,338,2,106,2018-11-04T15:00:00Z,False,15,12,0,0,7,3,4,26,15,11,-19,-11
Oriol Romeu,338,2,119,2018-11-10T15:00:00Z,True,15,17,0,0,7,3,4,19,12,7,-12,-4
Oriol Romeu,338,2,124,2018-11-24T15:00:00Z,False,15,8,0,0,8,4,4,5,4,1,3,0
Oriol Romeu,338,2,139,2018-12-01T17:30:00Z,True,15,13,0,0,8,4,4,21,11,10,-13,-6
Oriol Romeu,338,2,149,2018-12-05T20:00:00Z,False,15,16,2,1,9,5,4,30,9,21,-21,-5
Oriol Romeu,338,2,153,2018-12-08T15:00:00Z,False,15,4,79,1,9,5,4,11,10,1,-2,-6
Oriol Romeu,338,2,166,2018-12-16T13:30:00Z,True,15,0,90,2,9,5,4,34,20,14,-25,-9
Oriol Romeu,338,2,175,2018-12-22T15:00:00Z,False,15,9,90,2,12,8,4,10,5,5,2,-1
Oriol Romeu,338,2,187,2018-12-27T19:45:00Z,True,15,18,90,2,15,8,7,24,13,11,-9,-3
Oriol Romeu,338,2,197,2018-12-30T14:15:00Z,True,15,12,58,1,15,8,7,44,27,17,-29,-9
Oriol Romeu,338,2,203,2019-01-02T19:45:00Z,False,15,5,90,2,15,8,7,43,21,22,-28,-14
Oriol Romeu,338,2,216,2019-01-12T15:00:00Z,False,15,10,90,2,16,8,8,31,14,17,-15,-6
Oriol Romeu,338,2,227,2019-01-19T15:00:00Z,True,15,7,90,2,19,8,11,30,21,9,-11,-1
Oriol Romeu,338,2,238,2019-01-30T19:45:00Z,True,15,6,90,2,22,11,11,22,9,13,0,-2
Oriol Romeu,338,2,241,2019-02-02T15:00:00Z,False,15,3,90,2,23,12,11,23,13,10,0,-2
Oriol Romeu,338,2,256,2019-02-09T15:00:00Z,True,15,4,90,1,24,12,12,22,17,5,2,7
Oriol Romeu,338,2,260,2019-02-24T14:05:00Z,False,15,0,90,2,24,12,12,50,32,18,-26,-20
Oriol Romeu,338,2,279,2019-02-27T19:45:00Z,True,15,8,90,11,24,12,12,17,15,2,7,10
Oriol Romeu,338,2,285,2019-03-02T15:00:00Z,False,15,13,90,2,27,15,12,55,26,29,-28,-14
Oriol Romeu,338,2,299,2019-03-09T15:00:00Z,True,15,16,45,0,27,15,12,61,28,33,-34,-18
Oriol Romeu,338,2,311,2019-03-30T15:00:00Z,False,15,2,90,3,30,18,12,33,22,11,-3,-10
Oriol Romeu,338,2,326,2019-04-05T19:00:00Z,True,15,11,82,2,33,18,15,79,44,35,-46,-17
Oriol Romeu,338,2,337,2019-04-13T14:00:00Z,True,15,19,29,1,33,18,15,47,27,20,-14,-2
Oriol Romeu,338,2,347,2019-04-20T16:30:00Z,False,15,14,90,1,36,21,15,38,22,16,-2,-7
Oriol Romeu,338,2,307,2019-04-23T18:45:00Z,False,15,17,73,2,36,21,15,49,26,23,-13,-11
Oriol Romeu,338,2,357,2019-04-27T14:00:00Z,True,15,1,45,0,37,21,16,41,26,15,-4,6
Oriol Romeu,338,2,368,2019-05-04T14:00:00Z,False,15,18,15,0,38,22,16,46,28,18,-8,-12
Oriol Romeu,338,2,377,2019-05-12T14:00:00Z,True,15,9,83,2,38,22,16,15,9,6,23,16
Hjbjerg,339,2,7,2018-08-12T12:30:00Z,True,15,3,0,0,0,0,0,0,0,0,0,0
Hjbjerg,339,2,15,2018-08-18T14:00:00Z,False,15,7,0,0,1,1,0,1,0,1,0,0
Hjbjerg,339,2,27,2018-08-25T14:00:00Z,True,15,10,76,-1,1,1,0,3,3,0,-2,1
Hjbjerg,339,2,34,2018-09-01T14:00:00Z,False,15,6,90,9,1,1,0,3,0,3,-2,0
Hjbjerg,339,2,46,2018-09-17T19:00:00Z,True,15,2,90,10,4,1,3,4,4,0,0,1
Hjbjerg,339,2,57,2018-09-22T14:00:00Z,False,15,11,90,2,5,2,3,15,6,9,-10,-3
Hjbjerg,339,2,69,2018-09-29T14:00:00Z,False,15,19,90,2,5,2,3,9,5,4,-4,-2
Hjbjerg,339,2,77,2018-10-07T13:15:00Z,True,15,5,90,1,5,2,3,17,10,7,-12,-5
Hjbjerg,339,2,81,2018-10-20T14:00:00Z,False,15,1,90,3,5,2,3,16,10,6,-11,-7
Hjbjerg,339,2,97,2018-10-27T14:00:00Z,True,15,14,0,0,6,2,4,2,0,2,4,0
Hjbjerg,339,2,106,2018-11-04T15:00:00Z,False,15,12,90,2,7,3,4,26,15,11,-19,-11
Hjbjerg,339,2,119,2018-11-10T15:00:00Z,True,15,17,90,1,7,3,4,19,12,7,-12,-4
Hjbjerg,339,2,124,2018-11-24T15:00:00Z,False,15,8,90,1,8,4,4,5,4,1,3,0
Hjbjerg,339,2,139,2018-12-01T17:30:00Z,True,15,13,90,1,8,4,4,21,11,10,-13,-6
Hjbjerg,339,2,149,2018-12-05T20:00:00Z,False,15,16,87,2,9,5,4,30,9,21,-21,-5
Hjbjerg,339,2,153,2018-12-08T15:00:00Z,False,15,4,90,2,9,5,4,11,10,1,-2,-6
Hjbjerg,339,2,166,2018-12-16T13:30:00Z,True,15,0,90,2,9,5,4,34,20,14,-25,-9
Hjbjerg,339,2,175,2018-12-22T15:00:00Z,False,15,9,90,4,12,8,4,10,5,5,2,-1
Hjbjerg,339,2,187,2018-12-27T19:45:00Z,True,15,18,0,0,15,8,7,24,13,11,-9,-3
Hjbjerg,339,2,197,2018-12-30T14:15:00Z,True,15,12,84,4,15,8,7,44,27,17,-29,-9
Hjbjerg,339,2,203,2019-01-02T19:45:00Z,False,15,5,0,0,15,8,7,43,21,22,-28,-14
Hjbjerg,339,2,216,2019-01-12T15:00:00Z,False,15,10,0,0,16,8,8,31,14,17,-15,-6
Hjbjerg,339,2,227,2019-01-19T15:00:00Z,True,15,7,90,2,19,8,11,30,21,9,-11,-1
Hjbjerg,339,2,238,2019-01-30T19:45:00Z,True,15,6,83,1,22,11,11,22,9,13,0,-2
Hjbjerg,339,2,241,2019-02-02T15:00:00Z,False,15,3,0,0,23,12,11,23,13,10,0,-2
Hjbjerg,339,2,256,2019-02-09T15:00:00Z,True,15,4,90,2,24,12,12,22,17,5,2,7
Hjbjerg,339,2,260,2019-02-24T14:05:00Z,False,15,0,90,2,24,12,12,50,32,18,-26,-20
Hjbjerg,339,2,279,2019-02-27T19:45:00Z,True,15,8,90,3,24,12,12,17,15,2,7,10
Hjbjerg,339,2,285,2019-03-02T15:00:00Z,False,15,13,90,2,27,15,12,55,26,29,-28,-14
Hjbjerg,339,2,299,2019-03-09T15:00:00Z,True,15,16,90,1,27,15,12,61,28,33,-34,-18
Hjbjerg,339,2,311,2019-03-30T15:00:00Z,False,15,2,90,11,30,18,12,33,22,11,-3,-10
Hjbjerg,339,2,326,2019-04-05T19:00:00Z,True,15,11,90,5,33,18,15,79,44,35,-46,-17
Hjbjerg,339,2,337,2019-04-13T14:00:00Z,True,15,19,90,2,33,18,15,47,27,20,-14,-2
Hjbjerg,339,2,347,2019-04-20T16:30:00Z,False,15,14,90,2,36,21,15,38,22,16,-2,-7
Hjbjerg,339,2,307,2019-04-23T18:45:00Z,False,15,17,90,2,36,21,15,49,26,23,-13,-11
Hjbjerg,339,2,357,2019-04-27T14:00:00Z,True,15,1,90,6,37,21,16,41,26,15,-4,6
Hjbjerg,339,2,368,2019-05-04T14:00:00Z,False,15,18,90,2,38,22,16,46,28,18,-8,-12
Hjbjerg,339,2,377,2019-05-12T14:00:00Z,True,15,9,90,2,38,22,16,15,9,6,23,16
Boufal,340,2,7,2018-08-12T12:30:00Z,True,15,3,0,0,0,0,0,0,0,0,0,0
Boufal,340,2,15,2018-08-18T14:00:00Z,False,15,7,0,0,1,1,0,1,0,1,0,0
Boufal,340,2,27,2018-08-25T14:00:00Z,True,15,10,0,0,1,1,0,3,3,0,-2,1
Boufal,340,2,34,2018-09-01T14:00:00Z,False,15,6,0,0,1,1,0,3,0,3,-2,0
Boufal,340,2,46,2018-09-17T19:00:00Z,True,15,2,0,0,4,1,3,4,4,0,0,1
Boufal,340,2,57,2018-09-22T14:00:00Z,False,15,11,0,0,5,2,3,15,6,9,-10,-3
Boufal,340,2,69,2018-09-29T14:00:00Z,False,15,19,0,0,5,2,3,9,5,4,-4,-2
Boufal,340,2,77,2018-10-07T13:15:00Z,True,15,5,0,0,5,2,3,17,10,7,-12,-5
Boufal,340,2,81,2018-10-20T14:00:00Z,False,15,1,0,0,5,2,3,16,10,6,-11,-7
Boufal,340,2,97,2018-10-27T14:00:00Z,True,15,14,0,0,6,2,4,2,0,2,4,0
Boufal,340,2,106,2018-11-04T15:00:00Z,False,15,12,0,0,7,3,4,26,15,11,-19,-11
Boufal,340,2,119,2018-11-10T15:00:00Z,True,15,17,0,0,7,3,4,19,12,7,-12,-4
Boufal,340,2,124,2018-11-24T15:00:00Z,False,15,8,0,0,8,4,4,5,4,1,3,0
Boufal,340,2,139,2018-12-01T17:30:00Z,True,15,13,0,0,8,4,4,21,11,10,-13,-6
Boufal,340,2,149,2018-12-05T20:00:00Z,False,15,16,0,0,9,5,4,30,9,21,-21,-5
Boufal,340,2,153,2018-12-08T15:00:00Z,False,15,4,0,0,9,5,4,11,10,1,-2,-6
Boufal,340,2,166,2018-12-16T13:30:00Z,True,15,0,0,0,9,5,4,34,20,14,-25,-9
Boufal,340,2,175,2018-12-22T15:00:00Z,False,15,9,0,0,12,8,4,10,5,5,2,-1
Boufal,340,2,187,2018-12-27T19:45:00Z,True,15,18,0,0,15,8,7,24,13,11,-9,-3
Boufal,340,2,197,2018-12-30T14:15:00Z,True,15,12,0,0,15,8,7,44,27,17,-29,-9
Boufal,340,2,203,2019-01-02T19:45:00Z,False,15,5,0,0,15,8,7,43,21,22,-28,-14
Boufal,340,2,216,2019-01-12T15:00:00Z,False,15,10,0,0,16,8,8,31,14,17,-15,-6
Boufal,340,2,227,2019-01-19T15:00:00Z,True,15,7,0,0,19,8,11,30,21,9,-11,-1
Boufal,340,2,238,2019-01-30T19:45:00Z,True,15,6,0,0,22,11,11,22,9,13,0,-2
Boufal,340,2,241,2019-02-02T15:00:00Z,False,15,3,0,0,23,12,11,23,13,10,0,-2
Boufal,340,2,256,2019-02-09T15:00:00Z,True,15,4,0,0,24,12,12,22,17,5,2,7
Boufal,340,2,260,2019-02-24T14:05:00Z,False,15,0,0,0,24,12,12,50,32,18,-26,-20
Boufal,340,2,279,2019-02-27T19:45:00Z,True,15,8,0,0,24,12,12,17,15,2,7,10
Boufal,340,2,285,2019-03-02T15:00:00Z,False,15,13,0,0,27,15,12,55,26,29,-28,-14
Boufal,340,2,299,2019-03-09T15:00:00Z,True,15,16,0,0,27,15,12,61,28,33,-34,-18
Boufal,340,2,311,2019-03-30T15:00:00Z,False,15,2,0,0,30,18,12,33,22,11,-3,-10
Boufal,340,2,326,2019-04-05T19:00:00Z,True,15,11,0,0,33,18,15,79,44,35,-46,-17
Boufal,340,2,337,2019-04-13T14:00:00Z,True,15,19,0,0,33,18,15,47,27,20,-14,-2
Boufal,340,2,347,2019-04-20T16:30:00Z,False,15,14,0,0,36,21,15,38,22,16,-2,-7
Boufal,340,2,307,2019-04-23T18:45:00Z,False,15,17,0,0,36,21,15,49,26,23,-13,-11
Boufal,340,2,357,2019-04-27T14:00:00Z,True,15,1,0,0,37,21,16,41,26,15,-4,6
Boufal,340,2,368,2019-05-04T14:00:00Z,False,15,18,0,0,38,22,16,46,28,18,-8,-12
Boufal,340,2,377,2019-05-12T14:00:00Z,True,15,9,0,0,38,22,16,15,9,6,23,16
Sims,341,2,7,2018-08-12T12:30:00Z,True,15,3,0,0,0,0,0,0,0,0,0,0
Sims,341,2,15,2018-08-18T14:00:00Z,False,15,7,0,0,1,1,0,1,0,1,0,0
Sims,341,2,27,2018-08-25T14:00:00Z,True,15,10,0,0,1,1,0,3,3,0,-2,1
Sims,341,2,34,2018-09-01T14:00:00Z,False,15,6,0,0,1,1,0,3,0,3,-2,0
Sims,341,2,46,2018-09-17T19:00:00Z,True,15,2,0,0,4,1,3,4,4,0,0,1
Sims,341,2,57,2018-09-22T14:00:00Z,False,15,11,0,0,5,2,3,15,6,9,-10,-3
Sims,341,2,69,2018-09-29T14:00:00Z,False,15,19,0,0,5,2,3,9,5,4,-4,-2
Sims,341,2,77,2018-10-07T13:15:00Z,True,15,5,0,0,5,2,3,17,10,7,-12,-5
Sims,341,2,81,2018-10-20T14:00:00Z,False,15,1,0,0,5,2,3,16,10,6,-11,-7
Sims,341,2,97,2018-10-27T14:00:00Z,True,15,14,0,0,6,2,4,2,0,2,4,0
Sims,341,2,106,2018-11-04T15:00:00Z,False,15,12,0,0,7,3,4,26,15,11,-19,-11
Sims,341,2,119,2018-11-10T15:00:00Z,True,15,17,0,0,7,3,4,19,12,7,-12,-4
Sims,341,2,124,2018-11-24T15:00:00Z,False,15,8,0,0,8,4,4,5,4,1,3,0
Sims,341,2,139,2018-12-01T17:30:00Z,True,15,13,0,0,8,4,4,21,11,10,-13,-6
Sims,341,2,149,2018-12-05T20:00:00Z,False,15,16,0,0,9,5,4,30,9,21,-21,-5
Sims,341,2,153,2018-12-08T15:00:00Z,False,15,4,0,0,9,5,4,11,10,1,-2,-6
Sims,341,2,166,2018-12-16T13:30:00Z,True,15,0,0,0,9,5,4,34,20,14,-25,-9
Sims,341,2,175,2018-12-22T15:00:00Z,False,15,9,0,0,12,8,4,10,5,5,2,-1
Sims,341,2,187,2018-12-27T19:45:00Z,True,15,18,0,0,15,8,7,24,13,11,-9,-3
Sims,341,2,197,2018-12-30T14:15:00Z,True,15,12,0,0,15,8,7,44,27,17,-29,-9
Sims,341,2,203,2019-01-02T19:45:00Z,False,15,5,0,0,15,8,7,43,21,22,-28,-14
Sims,341,2,216,2019-01-12T15:00:00Z,False,15,10,0,0,16,8,8,31,14,17,-15,-6
Sims,341,2,227,2019-01-19T15:00:00Z,True,15,7,0,0,19,8,11,30,21,9,-11,-1
Sims,341,2,238,2019-01-30T19:45:00Z,True,15,6,0,0,22,11,11,22,9,13,0,-2
Sims,341,2,241,2019-02-02T15:00:00Z,False,15,3,0,0,23,12,11,23,13,10,0,-2
Sims,341,2,256,2019-02-09T15:00:00Z,True,15,4,0,0,24,12,12,22,17,5,2,7
Sims,341,2,260,2019-02-24T14:05:00Z,False,15,0,0,0,24,12,12,50,32,18,-26,-20
Sims,341,2,279,2019-02-27T19:45:00Z,True,15,8,0,0,24,12,12,17,15,2,7,10
Sims,341,2,285,2019-03-02T15:00:00Z,False,15,13,0,0,27,15,12,55,26,29,-28,-14
Sims,341,2,299,2019-03-09T15:00:00Z,True,15,16,45,1,27,15,12,61,28,33,-34,-18
Sims,341,2,311,2019-03-30T15:00:00Z,False,15,2,1,1,30,18,12,33,22,11,-3,-10
Sims,341,2,326,2019-04-05T19:00:00Z,True,15,11,28,1,33,18,15,79,44,35,-46,-17
Sims,341,2,337,2019-04-13T14:00:00Z,True,15,19,60,5,33,18,15,47,27,20,-14,-2
Sims,341,2,347,2019-04-20T16:30:00Z,False,15,14,45,1,36,21,15,38,22,16,-2,-7
Sims,341,2,307,2019-04-23T18:45:00Z,False,15,17,23,1,36,21,15,49,26,23,-13,-11
Sims,341,2,357,2019-04-27T14:00:00Z,True,15,1,0,0,37,21,16,41,26,15,-4,6
Sims,341,2,368,2019-05-04T14:00:00Z,False,15,18,0,0,38,22,16,46,28,18,-8,-12
Sims,341,2,377,2019-05-12T14:00:00Z,True,15,9,6,1,38,22,16,15,9,6,23,16
Redmond,342,2,7,2018-08-12T12:30:00Z,True,15,3,90,3,0,0,0,0,0,0,0,0
Redmond,342,2,15,2018-08-18T14:00:00Z,False,15,7,90,2,1,1,0,1,0,1,0,0
Redmond,342,2,27,2018-08-25T14:00:00Z,True,15,10,90,2,1,1,0,3,3,0,-2,1
Redmond,342,2,34,2018-09-01T14:00:00Z,False,15,6,90,3,1,1,0,3,0,3,-2,0
Redmond,342,2,46,2018-09-17T19:00:00Z,True,15,2,90,2,4,1,3,4,4,0,0,1
Redmond,342,2,57,2018-09-22T14:00:00Z,False,15,11,90,2,5,2,3,15,6,9,-10,-3
Redmond,342,2,69,2018-09-29T14:00:00Z,False,15,19,90,2,5,2,3,9,5,4,-4,-2
Redmond,342,2,77,2018-10-07T13:15:00Z,True,15,5,90,2,5,2,3,17,10,7,-12,-5
Redmond,342,2,81,2018-10-20T14:00:00Z,False,15,1,90,3,5,2,3,16,10,6,-11,-7
Redmond,342,2,97,2018-10-27T14:00:00Z,True,15,14,90,3,6,2,4,2,0,2,4,0
Redmond,342,2,106,2018-11-04T15:00:00Z,False,15,12,72,2,7,3,4,26,15,11,-19,-11
Redmond,342,2,119,2018-11-10T15:00:00Z,True,15,17,89,2,7,3,4,19,12,7,-12,-4
Redmond,342,2,124,2018-11-24T15:00:00Z,False,15,8,90,2,8,4,4,5,4,1,3,0
Redmond,342,2,139,2018-12-01T17:30:00Z,True,15,13,90,2,8,4,4,21,11,10,-13,-6
Redmond,342,2,149,2018-12-05T20:00:00Z,False,15,16,90,2,9,5,4,30,9,21,-21,-5
Redmond,342,2,153,2018-12-08T15:00:00Z,False,15,4,90,2,9,5,4,11,10,1,-2,-6
Redmond,342,2,166,2018-12-16T13:30:00Z,True,15,0,62,5,9,5,4,34,20,14,-25,-9
Redmond,342,2,175,2018-12-22T15:00:00Z,False,15,9,90,13,12,8,4,10,5,5,2,-1
Redmond,342,2,187,2018-12-27T19:45:00Z,True,15,18,90,7,15,8,7,24,13,11,-9,-3
Redmond,342,2,197,2018-12-30T14:15:00Z,True,15,12,45,1,15,8,7,44,27,17,-29,-9
Redmond,342,2,203,2019-01-02T19:45:00Z,False,15,5,90,3,15,8,7,43,21,22,-28,-14
Redmond,342,2,216,2019-01-12T15:00:00Z,False,15,10,90,2,16,8,8,31,14,17,-15,-6
Redmond,342,2,227,2019-01-19T15:00:00Z,True,15,7,85,2,19,8,11,30,21,9,-11,-1
Redmond,342,2,238,2019-01-30T19:45:00Z,True,15,6,90,2,22,11,11,22,9,13,0,-2
Redmond,342,2,241,2019-02-02T15:00:00Z,False,15,3,86,11,23,12,11,23,13,10,0,-2
Redmond,342,2,256,2019-02-09T15:00:00Z,True,15,4,90,1,24,12,12,22,17,5,2,7
Redmond,342,2,260,2019-02-24T14:05:00Z,False,15,0,90,2,24,12,12,50,32,18,-26,-20
Redmond,342,2,279,2019-02-27T19:45:00Z,True,15,8,90,6,24,12,12,17,15,2,7,10
Redmond,342,2,285,2019-03-02T15:00:00Z,False,15,13,90,2,27,15,12,55,26,29,-28,-14
Redmond,342,2,299,2019-03-09T15:00:00Z,True,15,16,90,1,27,15,12,61,28,33,-34,-18
Redmond,342,2,311,2019-03-30T15:00:00Z,False,15,2,88,6,30,18,12,33,22,11,-3,-10
Redmond,342,2,326,2019-04-05T19:00:00Z,True,15,11,90,2,33,18,15,79,44,35,-46,-17
Redmond,342,2,337,2019-04-13T14:00:00Z,True,15,19,90,15,33,18,15,47,27,20,-14,-2
Redmond,342,2,347,2019-04-20T16:30:00Z,False,15,14,90,2,36,21,15,38,22,16,-2,-7
Redmond,342,2,307,2019-04-23T18:45:00Z,False,15,17,90,2,36,21,15,49,26,23,-13,-11
Redmond,342,2,357,2019-04-27T14:00:00Z,True,15,1,90,5,37,21,16,41,26,15,-4,6
Redmond,342,2,368,2019-05-04T14:00:00Z,False,15,18,45,1,38,22,16,46,28,18,-8,-12
Redmond,342,2,377,2019-05-12T14:00:00Z,True,15,9,90,10,38,22,16,15,9,6,23,16
Lemina,343,2,7,2018-08-12T12:30:00Z,True,15,3,90,3,0,0,0,0,0,0,0,0
Lemina,343,2,15,2018-08-18T14:00:00Z,False,15,7,90,4,1,1,0,1,0,1,0,0
Lemina,343,2,27,2018-08-25T14:00:00Z,True,15,10,90,2,1,1,0,3,3,0,-2,1
Lemina,343,2,34,2018-09-01T14:00:00Z,False,15,6,90,3,1,1,0,3,0,3,-2,0
Lemina,343,2,46,2018-09-17T19:00:00Z,True,15,2,90,2,4,1,3,4,4,0,0,1
Lemina,343,2,57,2018-09-22T14:00:00Z,False,15,11,90,1,5,2,3,15,6,9,-10,-3
Lemina,343,2,69,2018-09-29T14:00:00Z,False,15,19,90,2,5,2,3,9,5,4,-4,-2
Lemina,343,2,77,2018-10-07T13:15:00Z,True,15,5,90,1,5,2,3,17,10,7,-12,-5
Lemina,343,2,81,2018-10-20T14:00:00Z,False,15,1,65,2,5,2,3,16,10,6,-11,-7
Lemina,343,2,97,2018-10-27T14:00:00Z,True,15,14,90,3,6,2,4,2,0,2,4,0
Lemina,343,2,106,2018-11-04T15:00:00Z,False,15,12,90,2,7,3,4,26,15,11,-19,-11
Lemina,343,2,119,2018-11-10T15:00:00Z,True,15,17,90,2,7,3,4,19,12,7,-12,-4
Lemina,343,2,124,2018-11-24T15:00:00Z,False,15,8,90,2,8,4,4,5,4,1,3,0
Lemina,343,2,139,2018-12-01T17:30:00Z,True,15,13,90,5,8,4,4,21,11,10,-13,-6
Lemina,343,2,149,2018-12-05T20:00:00Z,False,15,16,0,0,9,5,4,30,9,21,-21,-5
Lemina,343,2,153,2018-12-08T15:00:00Z,False,15,4,90,2,9,5,4,11,10,1,-2,-6
Lemina,343,2,166,2018-12-16T13:30:00Z,True,15,0,0,0,9,5,4,34,20,14,-25,-9
Lemina,343,2,175,2018-12-22T15:00:00Z,False,15,9,21,1,12,8,4,10,5,5,2,-1
Lemina,343,2,187,2018-12-27T19:45:00Z,True,15,18,86,2,15,8,7,24,13,11,-9,-3
Lemina,343,2,197,2018-12-30T14:15:00Z,True,15,12,45,1,15,8,7,44,27,17,-29,-9
Lemina,343,2,203,2019-01-02T19:45:00Z,False,15,5,0,0,15,8,7,43,21,22,-28,-14
Lemina,343,2,216,2019-01-12T15:00:00Z,False,15,10,0,0,16,8,8,31,14,17,-15,-6
Lemina,343,2,227,2019-01-19T15:00:00Z,True,15,7,0,0,19,8,11,30,21,9,-11,-1
Lemina,343,2,238,2019-01-30T19:45:00Z,True,15,6,0,0,22,11,11,22,9,13,0,-2
Lemina,343,2,241,2019-02-02T15:00:00Z,False,15,3,0,0,23,12,11,23,13,10,0,-2
Lemina,343,2,256,2019-02-09T15:00:00Z,True,15,4,0,0,24,12,12,22,17,5,2,7
Lemina,343,2,260,2019-02-24T14:05:00Z,False,15,0,0,0,24,12,12,50,32,18,-26,-20
Lemina,343,2,279,2019-02-27T19:45:00Z,True,15,8,0,0,24,12,12,17,15,2,7,10
Lemina,343,2,285,2019-03-02T15:00:00Z,False,15,13,0,0,27,15,12,55,26,29,-28,-14
Lemina,343,2,299,2019-03-09T15:00:00Z,True,15,16,0,0,27,15,12,61,28,33,-34,-18
Lemina,343,2,311,2019-03-30T15:00:00Z,False,15,2,0,0,30,18,12,33,22,11,-3,-10
Lemina,343,2,326,2019-04-05T19:00:00Z,True,15,11,0,0,33,18,15,79,44,35,-46,-17
Lemina,343,2,337,2019-04-13T14:00:00Z,True,15,19,0,0,33,18,15,47,27,20,-14,-2
Lemina,343,2,347,2019-04-20T16:30:00Z,False,15,14,45,7,36,21,15,38,22,16,-2,-7
Lemina,343,2,307,2019-04-23T18:45:00Z,False,15,17,16,1,36,21,15,49,26,23,-13,-11
Lemina,343,2,357,2019-04-27T14:00:00Z,True,15,1,0,0,37,21,16,41,26,15,-4,6
Lemina,343,2,368,2019-05-04T14:00:00Z,False,15,18,74,2,38,22,16,46,28,18,-8,-12
Lemina,343,2,377,2019-05-12T14:00:00Z,True,15,9,0,0,38,22,16,15,9,6,23,16
Armstrong,344,2,7,2018-08-12T12:30:00Z,True,15,3,55,1,0,0,0,0,0,0,0,0
Armstrong,344,2,15,2018-08-18T14:00:00Z,False,15,7,6,1,1,1,0,1,0,1,0,0
Armstrong,344,2,27,2018-08-25T14:00:00Z,True,15,10,4,1,1,1,0,3,3,0,-2,1
Armstrong,344,2,34,2018-09-01T14:00:00Z,False,15,6,0,0,1,1,0,3,0,3,-2,0
Armstrong,344,2,46,2018-09-17T19:00:00Z,True,15,2,0,0,4,1,3,4,4,0,0,1
Armstrong,344,2,57,2018-09-22T14:00:00Z,False,15,11,35,1,5,2,3,15,6,9,-10,-3
Armstrong,344,2,69,2018-09-29T14:00:00Z,False,15,19,19,1,5,2,3,9,5,4,-4,-2
Armstrong,344,2,77,2018-10-07T13:15:00Z,True,15,5,0,0,5,2,3,17,10,7,-12,-5
Armstrong,344,2,81,2018-10-20T14:00:00Z,False,15,1,24,1,5,2,3,16,10,6,-11,-7
Armstrong,344,2,97,2018-10-27T14:00:00Z,True,15,14,0,0,6,2,4,2,0,2,4,0
Armstrong,344,2,106,2018-11-04T15:00:00Z,False,15,12,8,1,7,3,4,26,15,11,-19,-11
Armstrong,344,2,119,2018-11-10T15:00:00Z,True,15,17,73,3,7,3,4,19,12,7,-12,-4
Armstrong,344,2,124,2018-11-24T15:00:00Z,False,15,8,80,14,8,4,4,5,4,1,3,0
Armstrong,344,2,139,2018-12-01T17:30:00Z,True,15,13,90,6,8,4,4,21,11,10,-13,-6
Armstrong,344,2,149,2018-12-05T20:00:00Z,False,15,16,80,2,9,5,4,30,9,21,-21,-5
Armstrong,344,2,153,2018-12-08T15:00:00Z,False,15,4,90,2,9,5,4,11,10,1,-2,-6
Armstrong,344,2,166,2018-12-16T13:30:00Z,True,15,0,90,1,9,5,4,34,20,14,-25,-9
Armstrong,344,2,175,2018-12-22T15:00:00Z,False,15,9,68,2,12,8,4,10,5,5,2,-1
Armstrong,344,2,187,2018-12-27T19:45:00Z,True,15,18,90,2,15,8,7,24,13,11,-9,-3
Armstrong,344,2,197,2018-12-30T14:15:00Z,True,15,12,0,0,15,8,7,44,27,17,-29,-9
Armstrong,344,2,203,2019-01-02T19:45:00Z,False,15,5,88,3,15,8,7,43,21,22,-28,-14
Armstrong,344,2,216,2019-01-12T15:00:00Z,False,15,10,56,1,16,8,8,31,14,17,-15,-6
Armstrong,344,2,227,2019-01-19T15:00:00Z,True,15,7,4,1,19,8,11,30,21,9,-11,-1
Armstrong,344,2,238,2019-01-30T19:45:00Z,True,15,6,28,1,22,11,11,22,9,13,0,-2
Armstrong,344,2,241,2019-02-02T15:00:00Z,False,15,3,76,3,23,12,11,23,13,10,0,-2
Armstrong,344,2,256,2019-02-09T15:00:00Z,True,15,4,0,0,24,12,12,22,17,5,2,7
Armstrong,344,2,260,2019-02-24T14:05:00Z,False,15,0,45,1,24,12,12,50,32,18,-26,-20
Armstrong,344,2,279,2019-02-27T19:45:00Z,True,15,8,0,0,24,12,12,17,15,2,7,10
Armstrong,344,2,285,2019-03-02T15:00:00Z,False,15,13,27,4,27,15,12,55,26,29,-28,-14
Armstrong,344,2,299,2019-03-09T15:00:00Z,True,15,16,17,8,27,15,12,61,28,33,-34,-18
Armstrong,344,2,311,2019-03-30T15:00:00Z,False,15,2,75,3,30,18,12,33,22,11,-3,-10
Armstrong,344,2,326,2019-04-05T19:00:00Z,True,15,11,7,1,33,18,15,79,44,35,-46,-17
Armstrong,344,2,337,2019-04-13T14:00:00Z,True,15,19,0,0,33,18,15,47,27,20,-14,-2
Armstrong,344,2,347,2019-04-20T16:30:00Z,False,15,14,45,4,36,21,15,38,22,16,-2,-7
Armstrong,344,2,307,2019-04-23T18:45:00Z,False,15,17,66,3,36,21,15,49,26,23,-13,-11
Armstrong,344,2,357,2019-04-27T14:00:00Z,True,15,1,9,1,37,21,16,41,26,15,-4,6
Armstrong,344,2,368,2019-05-04T14:00:00Z,False,15,18,66,2,38,22,16,46,28,18,-8,-12
Armstrong,344,2,377,2019-05-12T14:00:00Z,True,15,9,0,0,38,22,16,15,9,6,23,16
Elyounoussi,345,2,7,2018-08-12T12:30:00Z,True,15,3,34,1,0,0,0,0,0,0,0,0
Elyounoussi,345,2,15,2018-08-18T14:00:00Z,False,15,7,0,0,1,1,0,1,0,1,0,0
Elyounoussi,345,2,27,2018-08-25T14:00:00Z,True,15,10,78,2,1,1,0,3,3,0,-2,1
Elyounoussi,345,2,34,2018-09-01T14:00:00Z,False,15,6,72,3,1,1,0,3,0,3,-2,0
Elyounoussi,345,2,46,2018-09-17T19:00:00Z,True,15,2,75,2,4,1,3,4,4,0,0,1
Elyounoussi,345,2,57,2018-09-22T14:00:00Z,False,15,11,0,0,5,2,3,15,6,9,-10,-3
Elyounoussi,345,2,69,2018-09-29T14:00:00Z,False,15,19,70,3,5,2,3,9,5,4,-4,-2
Elyounoussi,345,2,77,2018-10-07T13:15:00Z,True,15,5,0,0,5,2,3,17,10,7,-12,-5
Elyounoussi,345,2,81,2018-10-20T14:00:00Z,False,15,1,90,3,5,2,3,16,10,6,-11,-7
Elyounoussi,345,2,97,2018-10-27T14:00:00Z,True,15,14,77,3,6,2,4,2,0,2,4,0
Elyounoussi,345,2,106,2018-11-04T15:00:00Z,False,15,12,17,1,7,3,4,26,15,11,-19,-11
Elyounoussi,345,2,119,2018-11-10T15:00:00Z,True,15,17,0,0,7,3,4,19,12,7,-12,-4
Elyounoussi,345,2,124,2018-11-24T15:00:00Z,False,15,8,22,1,8,4,4,5,4,1,3,0
Elyounoussi,345,2,139,2018-12-01T17:30:00Z,True,15,13,0,0,8,4,4,21,11,10,-13,-6
Elyounoussi,345,2,149,2018-12-05T20:00:00Z,False,15,16,9,1,9,5,4,30,9,21,-21,-5
Elyounoussi,345,2,153,2018-12-08T15:00:00Z,False,15,4,0,0,9,5,4,11,10,1,-2,-6
Elyounoussi,345,2,166,2018-12-16T13:30:00Z,True,15,0,0,0,9,5,4,34,20,14,-25,-9
Elyounoussi,345,2,175,2018-12-22T15:00:00Z,False,15,9,0,0,12,8,4,10,5,5,2,-1
Elyounoussi,345,2,187,2018-12-27T19:45:00Z,True,15,18,3,1,15,8,7,24,13,11,-9,-3
Elyounoussi,345,2,197,2018-12-30T14:15:00Z,True,15,12,90,2,15,8,7,44,27,17,-29,-9
Elyounoussi,345,2,203,2019-01-02T19:45:00Z,False,15,5,0,0,15,8,7,43,21,22,-28,-14
Elyounoussi,345,2,216,2019-01-12T15:00:00Z,False,15,10,0,0,16,8,8,31,14,17,-15,-6
Elyounoussi,345,2,227,2019-01-19T15:00:00Z,True,15,7,0,0,19,8,11,30,21,9,-11,-1
Elyounoussi,345,2,238,2019-01-30T19:45:00Z,True,15,6,15,1,22,11,11,22,9,13,0,-2
Elyounoussi,345,2,241,2019-02-02T15:00:00Z,False,15,3,0,0,23,12,11,23,13,10,0,-2
Elyounoussi,345,2,256,2019-02-09T15:00:00Z,True,15,4,18,1,24,12,12,22,17,5,2,7
Elyounoussi,345,2,260,2019-02-24T14:05:00Z,False,15,0,25,1,24,12,12,50,32,18,-26,-20
Elyounoussi,345,2,279,2019-02-27T19:45:00Z,True,15,8,0,0,24,12,12,17,15,2,7,10
Elyounoussi,345,2,285,2019-03-02T15:00:00Z,False,15,13,0,0,27,15,12,55,26,29,-28,-14
Elyounoussi,345,2,299,2019-03-09T15:00:00Z,True,15,16,0,0,27,15,12,61,28,33,-34,-18
Elyounoussi,345,2,311,2019-03-30T15:00:00Z,False,15,2,0,0,30,18,12,33,22,11,-3,-10
Elyounoussi,345,2,326,2019-04-05T19:00:00Z,True,15,11,0,0,33,18,15,79,44,35,-46,-17
Elyounoussi,345,2,337,2019-04-13T14:00:00Z,True,15,19,0,0,33,18,15,47,27,20,-14,-2
Elyounoussi,345,2,347,2019-04-20T16:30:00Z,False,15,14,0,0,36,21,15,38,22,16,-2,-7
Elyounoussi,345,2,307,2019-04-23T18:45:00Z,False,15,17,0,0,36,21,15,49,26,23,-13,-11
Elyounoussi,345,2,357,2019-04-27T14:00:00Z,True,15,1,0,0,37,21,16,41,26,15,-4,6
Elyounoussi,345,2,368,2019-05-04T14:00:00Z,False,15,18,90,2,38,22,16,46,28,18,-8,-12
Elyounoussi,345,2,377,2019-05-12T14:00:00Z,True,15,9,0,0,38,22,16,15,9,6,23,16
Long,346,3,7,2018-08-12T12:30:00Z,True,15,3,0,0,0,0,0,0,0,0,0,0
Long,346,3,15,2018-08-18T14:00:00Z,False,15,7,32,1,1,1,0,1,0,1,0,0
Long,346,3,27,2018-08-25T14:00:00Z,True,15,10,85,2,1,1,0,3,3,0,-2,1
Long,346,3,34,2018-09-01T14:00:00Z,False,15,6,61,2,1,1,0,3,0,3,-2,0
Long,346,3,46,2018-09-17T19:00:00Z,True,15,2,75,2,4,1,3,4,4,0,0,1
Long,346,3,57,2018-09-22T14:00:00Z,False,15,11,78,2,5,2,3,15,6,9,-10,-3
Long,346,3,69,2018-09-29T14:00:00Z,False,15,19,0,0,5,2,3,9,5,4,-4,-2
Long,346,3,77,2018-10-07T13:15:00Z,True,15,5,12,1,5,2,3,17,10,7,-12,-5
Long,346,3,81,2018-10-20T14:00:00Z,False,15,1,12,1,5,2,3,16,10,6,-11,-7
Long,346,3,97,2018-10-27T14:00:00Z,True,15,14,12,1,6,2,4,2,0,2,4,0
Long,346,3,106,2018-11-04T15:00:00Z,False,15,12,90,2,7,3,4,26,15,11,-19,-11
Long,346,3,119,2018-11-10T15:00:00Z,True,15,17,0,0,7,3,4,19,12,7,-12,-4
Long,346,3,124,2018-11-24T15:00:00Z,False,15,8,0,0,8,4,4,5,4,1,3,0
Long,346,3,139,2018-12-01T17:30:00Z,True,15,13,0,0,8,4,4,21,11,10,-13,-6
Long,346,3,149,2018-12-05T20:00:00Z,False,15,16,0,0,9,5,4,30,9,21,-21,-5
Long,346,3,153,2018-12-08T15:00:00Z,False,15,4,0,0,9,5,4,11,10,1,-2,-6
Long,346,3,166,2018-12-16T13:30:00Z,True,15,0,27,3,9,5,4,34,20,14,-25,-9
Long,346,3,175,2018-12-22T15:00:00Z,False,15,9,0,0,12,8,4,10,5,5,2,-1
Long,346,3,187,2018-12-27T19:45:00Z,True,15,18,28,1,15,8,7,24,13,11,-9,-3
Long,346,3,197,2018-12-30T14:15:00Z,True,15,12,22,1,15,8,7,44,27,17,-29,-9
Long,346,3,203,2019-01-02T19:45:00Z,False,15,5,45,1,15,8,7,43,21,22,-28,-14
Long,346,3,216,2019-01-12T15:00:00Z,False,15,10,75,12,16,8,8,31,14,17,-15,-6
Long,346,3,227,2019-01-19T15:00:00Z,True,15,7,16,0,19,8,11,30,21,9,-11,-1
Long,346,3,238,2019-01-30T19:45:00Z,True,15,6,0,0,22,11,11,22,9,13,0,-2
Long,346,3,241,2019-02-02T15:00:00Z,False,15,3,63,2,23,12,11,23,13,10,0,-2
Long,346,3,256,2019-02-09T15:00:00Z,True,15,4,71,2,24,12,12,22,17,5,2,7
Long,346,3,260,2019-02-24T14:05:00Z,False,15,0,0,0,24,12,12,50,32,18,-26,-20
Long,346,3,279,2019-02-27T19:45:00Z,True,15,8,26,1,24,12,12,17,15,2,7,10
Long,346,3,285,2019-03-02T15:00:00Z,False,15,13,0,0,27,15,12,55,26,29,-28,-14
Long,346,3,299,2019-03-09T15:00:00Z,True,15,16,27,1,27,15,12,61,28,33,-34,-18
Long,346,3,311,2019-03-30T15:00:00Z,False,15,2,0,0,30,18,12,33,22,11,-3,-10
Long,346,3,326,2019-04-05T19:00:00Z,True,15,11,61,6,33,18,15,79,44,35,-46,-17
Long,346,3,337,2019-04-13T14:00:00Z,True,15,19,29,6,33,18,15,47,27,20,-14,-2
Long,346,3,347,2019-04-20T16:30:00Z,False,15,14,14,1,36,21,15,38,22,16,-2,-7
Long,346,3,307,2019-04-23T18:45:00Z,False,15,17,77,7,36,21,15,49,26,23,-13,-11
Long,346,3,357,2019-04-27T14:00:00Z,True,15,1,87,5,37,21,16,41,26,15,-4,6
Long,346,3,368,2019-05-04T14:00:00Z,False,15,18,90,2,38,22,16,46,28,18,-8,-12
Long,346,3,377,2019-05-12T14:00:00Z,True,15,9,45,1,38,22,16,15,9,6,23,16
Austin,347,3,7,2018-08-12T12:30:00Z,True,15,3,71,2,0,0,0,0,0,0,0,0
Austin,347,3,15,2018-08-18T14:00:00Z,False,15,7,57,1,1,1,0,1,0,1,0,0
Austin,347,3,27,2018-08-25T14:00:00Z,True,15,10,21,1,1,1,0,3,3,0,-2,1
Austin,347,3,34,2018-09-01T14:00:00Z,False,15,6,28,-1,1,1,0,3,0,3,-2,0
Austin,347,3,46,2018-09-17T19:00:00Z,True,15,2,0,0,4,1,3,4,4,0,0,1
Austin,347,3,57,2018-09-22T14:00:00Z,False,15,11,11,1,5,2,3,15,6,9,-10,-3
Austin,347,3,69,2018-09-29T14:00:00Z,False,15,19,76,2,5,2,3,9,5,4,-4,-2
Austin,347,3,77,2018-10-07T13:15:00Z,True,15,5,0,0,5,2,3,17,10,7,-12,-5
Austin,347,3,81,2018-10-20T14:00:00Z,False,15,1,77,2,5,2,3,16,10,6,-11,-7
Austin,347,3,97,2018-10-27T14:00:00Z,True,15,14,62,2,6,2,4,2,0,2,4,0
Austin,347,3,106,2018-11-04T15:00:00Z,False,15,12,0,0,7,3,4,26,15,11,-19,-11
Austin,347,3,119,2018-11-10T15:00:00Z,True,15,17,50,1,7,3,4,19,12,7,-12,-4
Austin,347,3,124,2018-11-24T15:00:00Z,False,15,8,67,2,8,4,4,5,4,1,3,0
Austin,347,3,139,2018-12-01T17:30:00Z,True,15,13,0,0,8,4,4,21,11,10,-13,-6
Austin,347,3,149,2018-12-05T20:00:00Z,False,15,16,20,5,9,5,4,30,9,21,-21,-5
Austin,347,3,153,2018-12-08T15:00:00Z,False,15,4,74,2,9,5,4,11,10,1,-2,-6
Austin,347,3,166,2018-12-16T13:30:00Z,True,15,0,19,6,9,5,4,34,20,14,-25,-9
Austin,347,3,175,2018-12-22T15:00:00Z,False,15,9,0,0,12,8,4,10,5,5,2,-1
Austin,347,3,187,2018-12-27T19:45:00Z,True,15,18,10,1,15,8,7,24,13,11,-9,-3
Austin,347,3,197,2018-12-30T14:15:00Z,True,15,12,67,1,15,8,7,44,27,17,-29,-9
Austin,347,3,203,2019-01-02T19:45:00Z,False,15,5,1,1,15,8,7,43,21,22,-28,-14
Austin,347,3,216,2019-01-12T15:00:00Z,False,15,10,0,0,16,8,8,31,14,17,-15,-6
Austin,347,3,227,2019-01-19T15:00:00Z,True,15,7,0,0,19,8,11,30,21,9,-11,-1
Austin,347,3,238,2019-01-30T19:45:00Z,True,15,6,0,0,22,11,11,22,9,13,0,-2
Austin,347,3,241,2019-02-02T15:00:00Z,False,15,3,3,1,23,12,11,23,13,10,0,-2
Austin,347,3,256,2019-02-09T15:00:00Z,True,15,4,18,4,24,12,12,22,17,5,2,7
Austin,347,3,260,2019-02-24T14:05:00Z,False,15,0,45,1,24,12,12,50,32,18,-26,-20
Austin,347,3,279,2019-02-27T19:45:00Z,True,15,8,63,2,24,12,12,17,15,2,7,10
Austin,347,3,285,2019-03-02T15:00:00Z,False,15,13,62,5,27,15,12,55,26,29,-28,-14
Austin,347,3,299,2019-03-09T15:00:00Z,True,15,16,45,1,27,15,12,61,28,33,-34,-18
Austin,347,3,311,2019-03-30T15:00:00Z,False,15,2,0,0,30,18,12,33,22,11,-3,-10
Austin,347,3,326,2019-04-05T19:00:00Z,True,15,11,7,1,33,18,15,79,44,35,-46,-17
Austin,347,3,337,2019-04-13T14:00:00Z,True,15,19,0,0,33,18,15,47,27,20,-14,-2
Austin,347,3,347,2019-04-20T16:30:00Z,False,15,14,0,0,36,21,15,38,22,16,-2,-7
Austin,347,3,307,2019-04-23T18:45:00Z,False,15,17,0,0,36,21,15,49,26,23,-13,-11
Austin,347,3,357,2019-04-27T14:00:00Z,True,15,1,2,1,37,21,16,41,26,15,-4,6
Austin,347,3,368,2019-05-04T14:00:00Z,False,15,18,0,0,38,22,16,46,28,18,-8,-12
Austin,347,3,377,2019-05-12T14:00:00Z,True,15,9,14,1,38,22,16,15,9,6,23,16
Gabbiadini,348,3,7,2018-08-12T12:30:00Z,True,15,3,18,1,0,0,0,0,0,0,0,0
Gabbiadini,348,3,15,2018-08-18T14:00:00Z,False,15,7,18,1,1,1,0,1,0,1,0,0
Gabbiadini,348,3,27,2018-08-25T14:00:00Z,True,15,10,0,0,1,1,0,3,3,0,-2,1
Gabbiadini,348,3,34,2018-09-01T14:00:00Z,False,15,6,0,0,1,1,0,3,0,3,-2,0
Gabbiadini,348,3,46,2018-09-17T19:00:00Z,True,15,2,14,1,4,1,3,4,4,0,0,1
Gabbiadini,348,3,57,2018-09-22T14:00:00Z,False,15,11,0,0,5,2,3,15,6,9,-10,-3
Gabbiadini,348,3,69,2018-09-29T14:00:00Z,False,15,19,13,1,5,2,3,9,5,4,-4,-2
Gabbiadini,348,3,77,2018-10-07T13:15:00Z,True,15,5,77,2,5,2,3,17,10,7,-12,-5
Gabbiadini,348,3,81,2018-10-20T14:00:00Z,False,15,1,11,1,5,2,3,16,10,6,-11,-7
Gabbiadini,348,3,97,2018-10-27T14:00:00Z,True,15,14,27,1,6,2,4,2,0,2,4,0
Gabbiadini,348,3,106,2018-11-04T15:00:00Z,False,15,12,0,0,7,3,4,26,15,11,-19,-11
Gabbiadini,348,3,119,2018-11-10T15:00:00Z,True,15,17,90,9,7,3,4,19,12,7,-12,-4
Gabbiadini,348,3,124,2018-11-24T15:00:00Z,False,15,8,90,2,8,4,4,5,4,1,3,0
Gabbiadini,348,3,139,2018-12-01T17:30:00Z,True,15,13,26,1,8,4,4,21,11,10,-13,-6
Gabbiadini,348,3,149,2018-12-05T20:00:00Z,False,15,16,69,2,9,5,4,30,9,21,-21,-5
Gabbiadini,348,3,153,2018-12-08T15:00:00Z,False,15,4,15,1,9,5,4,11,10,1,-2,-6
Gabbiadini,348,3,166,2018-12-16T13:30:00Z,True,15,0,0,0,9,5,4,34,20,14,-25,-9
Gabbiadini,348,3,175,2018-12-22T15:00:00Z,False,15,9,0,0,12,8,4,10,5,5,2,-1
Gabbiadini,348,3,187,2018-12-27T19:45:00Z,True,15,18,0,0,15,8,7,24,13,11,-9,-3
Gabbiadini,348,3,197,2018-12-30T14:15:00Z,True,15,12,0,0,15,8,7,44,27,17,-29,-9
Gabbiadini,348,3,203,2019-01-02T19:45:00Z,False,15,5,0,0,15,8,7,43,21,22,-28,-14
Gabbiadini,348,3,216,2019-01-12T15:00:00Z,False,15,10,0,0,16,8,8,31,14,17,-15,-6
Gabbiadini,348,3,227,2019-01-19T15:00:00Z,True,15,7,0,0,19,8,11,30,21,9,-11,-1
Gabbiadini,348,3,238,2019-01-30T19:45:00Z,True,15,6,0,0,22,11,11,22,9,13,0,-2
Gabbiadini,348,3,241,2019-02-02T15:00:00Z,False,15,3,0,0,23,12,11,23,13,10,0,-2
Gabbiadini,348,3,256,2019-02-09T15:00:00Z,True,15,4,0,0,24,12,12,22,17,5,2,7
Gabbiadini,348,3,260,2019-02-24T14:05:00Z,False,15,0,0,0,24,12,12,50,32,18,-26,-20
Gabbiadini,348,3,279,2019-02-27T19:45:00Z,True,15,8,0,0,24,12,12,17,15,2,7,10
Gabbiadini,348,3,285,2019-03-02T15:00:00Z,False,15,13,0,0,27,15,12,55,26,29,-28,-14
Gabbiadini,348,3,299,2019-03-09T15:00:00Z,True,15,16,0,0,27,15,12,61,28,33,-34,-18
Gabbiadini,348,3,311,2019-03-30T15:00:00Z,False,15,2,0,0,30,18,12,33,22,11,-3,-10
Gabbiadini,348,3,326,2019-04-05T19:00:00Z,True,15,11,0,0,33,18,15,79,44,35,-46,-17
Gabbiadini,348,3,337,2019-04-13T14:00:00Z,True,15,19,0,0,33,18,15,47,27,20,-14,-2
Gabbiadini,348,3,347,2019-04-20T16:30:00Z,False,15,14,0,0,36,21,15,38,22,16,-2,-7
Gabbiadini,348,3,307,2019-04-23T18:45:00Z,False,15,17,0,0,36,21,15,49,26,23,-13,-11
Gabbiadini,348,3,357,2019-04-27T14:00:00Z,True,15,1,0,0,37,21,16,41,26,15,-4,6
Gabbiadini,348,3,368,2019-05-04T14:00:00Z,False,15,18,0,0,38,22,16,46,28,18,-8,-12
Gabbiadini,348,3,377,2019-05-12T14:00:00Z,True,15,9,0,0,38,22,16,15,9,6,23,16
Carrillo,349,3,7,2018-08-12T12:30:00Z,True,15,3,0,0,0,0,0,0,0,0,0,0
Carrillo,349,3,15,2018-08-18T14:00:00Z,False,15,7,0,0,1,1,0,1,0,1,0,0
Carrillo,349,3,27,2018-08-25T14:00:00Z,True,15,10,0,0,1,1,0,3,3,0,-2,1
Carrillo,349,3,34,2018-09-01T14:00:00Z,False,15,6,0,0,1,1,0,3,0,3,-2,0
Carrillo,349,3,46,2018-09-17T19:00:00Z,True,15,2,0,0,4,1,3,4,4,0,0,1
Carrillo,349,3,57,2018-09-22T14:00:00Z,False,15,11,0,0,5,2,3,15,6,9,-10,-3
Carrillo,349,3,69,2018-09-29T14:00:00Z,False,15,19,0,0,5,2,3,9,5,4,-4,-2
Carrillo,349,3,77,2018-10-07T13:15:00Z,True,15,5,0,0,5,2,3,17,10,7,-12,-5
Carrillo,349,3,81,2018-10-20T14:00:00Z,False,15,1,0,0,5,2,3,16,10,6,-11,-7
Carrillo,349,3,97,2018-10-27T14:00:00Z,True,15,14,0,0,6,2,4,2,0,2,4,0
Carrillo,349,3,106,2018-11-04T15:00:00Z,False,15,12,0,0,7,3,4,26,15,11,-19,-11
Carrillo,349,3,119,2018-11-10T15:00:00Z,True,15,17,0,0,7,3,4,19,12,7,-12,-4
Carrillo,349,3,124,2018-11-24T15:00:00Z,False,15,8,0,0,8,4,4,5,4,1,3,0
Carrillo,349,3,139,2018-12-01T17:30:00Z,True,15,13,0,0,8,4,4,21,11,10,-13,-6
Carrillo,349,3,149,2018-12-05T20:00:00Z,False,15,16,0,0,9,5,4,30,9,21,-21,-5
Carrillo,349,3,153,2018-12-08T15:00:00Z,False,15,4,0,0,9,5,4,11,10,1,-2,-6
Carrillo,349,3,166,2018-12-16T13:30:00Z,True,15,0,0,0,9,5,4,34,20,14,-25,-9
Carrillo,349,3,175,2018-12-22T15:00:00Z,False,15,9,0,0,12,8,4,10,5,5,2,-1
Carrillo,349,3,187,2018-12-27T19:45:00Z,True,15,18,0,0,15,8,7,24,13,11,-9,-3
Carrillo,349,3,197,2018-12-30T14:15:00Z,True,15,12,0,0,15,8,7,44,27,17,-29,-9
Carrillo,349,3,203,2019-01-02T19:45:00Z,False,15,5,0,0,15,8,7,43,21,22,-28,-14
Carrillo,349,3,216,2019-01-12T15:00:00Z,False,15,10,0,0,16,8,8,31,14,17,-15,-6
Carrillo,349,3,227,2019-01-19T15:00:00Z,True,15,7,0,0,19,8,11,30,21,9,-11,-1
Carrillo,349,3,238,2019-01-30T19:45:00Z,True,15,6,0,0,22,11,11,22,9,13,0,-2
Carrillo,349,3,241,2019-02-02T15:00:00Z,False,15,3,0,0,23,12,11,23,13,10,0,-2
Carrillo,349,3,256,2019-02-09T15:00:00Z,True,15,4,0,0,24,12,12,22,17,5,2,7
Carrillo,349,3,260,2019-02-24T14:05:00Z,False,15,0,0,0,24,12,12,50,32,18,-26,-20
Carrillo,349,3,279,2019-02-27T19:45:00Z,True,15,8,0,0,24,12,12,17,15,2,7,10
Carrillo,349,3,285,2019-03-02T15:00:00Z,False,15,13,0,0,27,15,12,55,26,29,-28,-14
Carrillo,349,3,299,2019-03-09T15:00:00Z,True,15,16,0,0,27,15,12,61,28,33,-34,-18
Carrillo,349,3,311,2019-03-30T15:00:00Z,False,15,2,0,0,30,18,12,33,22,11,-3,-10
Carrillo,349,3,326,2019-04-05T19:00:00Z,True,15,11,0,0,33,18,15,79,44,35,-46,-17
Carrillo,349,3,337,2019-04-13T14:00:00Z,True,15,19,0,0,33,18,15,47,27,20,-14,-2
Carrillo,349,3,347,2019-04-20T16:30:00Z,False,15,14,0,0,36,21,15,38,22,16,-2,-7
Carrillo,349,3,307,2019-04-23T18:45:00Z,False,15,17,0,0,36,21,15,49,26,23,-13,-11
Carrillo,349,3,357,2019-04-27T14:00:00Z,True,15,1,0,0,37,21,16,41,26,15,-4,6
Carrillo,349,3,368,2019-05-04T14:00:00Z,False,15,18,0,0,38,22,16,46,28,18,-8,-12
Carrillo,349,3,377,2019-05-12T14:00:00Z,True,15,9,0,0,38,22,16,15,9,6,23,16
Lloris,350,0,6,2018-08-11T11:30:00Z,False,16,14,90,2,0,0,0,0,0,0,0,0
Lloris,350,0,18,2018-08-18T14:00:00Z,True,16,8,90,2,3,0,3,0,0,0,3,0
Lloris,350,0,25,2018-08-27T19:00:00Z,False,16,13,90,7,6,3,3,3,3,0,3,0
Lloris,350,0,38,2018-09-02T15:00:00Z,False,16,17,0,0,9,3,6,9,6,3,0,0
Lloris,350,0,47,2018-09-15T11:30:00Z,True,16,11,0,0,9,3,6,12,6,6,-3,-3
Lloris,350,0,51,2018-09-22T16:30:00Z,False,16,2,0,0,9,3,6,5,4,1,4,2
Lloris,350,0,65,2018-09-29T14:00:00Z,False,16,9,0,0,12,3,9,2,1,1,10,8
Lloris,350,0,78,2018-10-06T14:00:00Z,True,16,4,90,9,15,3,12,2,1,1,13,2
Lloris,350,0,88,2018-10-20T14:00:00Z,False,16,18,90,8,18,6,12,7,4,3,11,8
Lloris,350,0,98,2018-10-29T20:00:00Z,True,16,12,90,3,21,6,15,23,15,8,-2,-2
Lloris,350,0,109,2018-11-03T19:45:00Z,False,16,19,90,2,21,6,15,15,8,7,6,7
Lloris,350,0,113,2018-11-10T17:30:00Z,False,16,6,90,9,24,6,18,8,2,6,16,16
Lloris,350,0,126,2018-11-24T17:30:00Z,True,16,5,90,2,27,6,21,28,15,13,-1,-7
Lloris,350,0,130,2018-12-02T14:05:00Z,False,16,0,90,0,30,9,21,27,14,13,3,7
Lloris,350,0,149,2018-12-05T20:00:00Z,True,16,15,90,3,30,9,21,9,5,4,21,5
Lloris,350,0,156,2018-12-08T19:45:00Z,False,16,10,90,7,33,12,21,22,11,11,11,10
Lloris,350,0,167,2018-12-15T15:00:00Z,True,16,3,90,6,36,12,24,12,7,5,24,7
Lloris,350,0,174,2018-12-23T16:00:00Z,False,16,7,90,1,39,15,24,24,18,6,15,6
Lloris,350,0,188,2018-12-26T15:00:00Z,True,16,1,90,7,42,15,27,26,17,9,16,6
Lloris,350,0,198,2018-12-29T15:00:00Z,True,16,19,90,1,45,18,27,26,14,12,19,6
Lloris,350,0,202,2019-01-01T17:30:00Z,False,16,4,90,7,45,18,27,18,13,5,27,14
Lloris,350,0,218,2019-01-13T16:30:00Z,True,16,13,90,4,48,18,30,38,21,17,10,1
Lloris,350,0,222,2019-01-20T16:00:00Z,False,16,8,90,3,48,18,30,14,12,2,34,18
Lloris,350,0,239,2019-01-30T20:00:00Z,True,16,17,90,2,51,18,33,33,17,16,18,2
Lloris,350,0,248,2019-02-02T12:30:00Z,True,16,14,90,6,54,21,33,24,13,11,30,10
Lloris,350,0,257,2019-02-10T13:30:00Z,True,16,10,90,12,57,24,33,32,14,18,25,6
Lloris,350,0,262,2019-02-23T12:30:00Z,False,16,3,90,1,60,27,33,27,14,13,33,19
Lloris,350,0,275,2019-02-27T20:00:00Z,False,16,5,90,1,60,27,33,50,28,22,10,5
Lloris,350,0,286,2019-03-02T12:30:00Z,True,16,0,90,10,60,27,33,56,38,18,4,9
Lloris,350,0,299,2019-03-09T15:00:00Z,False,16,15,90,1,61,28,33,27,15,12,34,18
Lloris,350,0,317,2019-03-31T15:30:00Z,False,16,11,90,1,61,28,33,76,41,35,-15,-8
Lloris,350,0,306,2019-04-03T18:45:00Z,True,16,6,90,6,61,28,33,36,16,20,25,8
Lloris,350,0,338,2019-04-13T11:30:00Z,True,16,9,90,6,64,31,33,14,8,6,50,25
Lloris,350,0,346,2019-04-20T11:30:00Z,False,16,12,0,0,67,34,33,83,48,35,-16,-15
Lloris,350,0,327,2019-04-23T18:45:00Z,True,16,2,90,6,67,34,33,34,22,12,33,22
Lloris,350,0,358,2019-04-27T11:30:00Z,True,16,18,90,4,70,37,33,43,28,15,27,22
Lloris,350,0,361,2019-05-04T11:30:00Z,False,16,1,90,3,70,37,33,42,26,16,28,7
Lloris,350,0,378,2019-05-12T14:00:00Z,True,16,7,90,3,70,37,33,53,34,19,17,18
Vorm,351,0,6,2018-08-11T11:30:00Z,False,16,14,0,0,0,0,0,0,0,0,0,0
Vorm,351,0,18,2018-08-18T14:00:00Z,True,16,8,0,0,3,0,3,0,0,0,3,0
Vorm,351,0,25,2018-08-27T19:00:00Z,False,16,13,0,0,6,3,3,3,3,0,3,0
Vorm,351,0,38,2018-09-02T15:00:00Z,False,16,17,90,1,9,3,6,9,6,3,0,0
Vorm,351,0,47,2018-09-15T11:30:00Z,True,16,11,90,4,9,3,6,12,6,6,-3,-3
Vorm,351,0,51,2018-09-22T16:30:00Z,False,16,2,0,0,9,3,6,5,4,1,4,2
Vorm,351,0,65,2018-09-29T14:00:00Z,False,16,9,0,0,12,3,9,2,1,1,10,8
Vorm,351,0,78,2018-10-06T14:00:00Z,True,16,4,0,0,15,3,12,2,1,1,13,2
Vorm,351,0,88,2018-10-20T14:00:00Z,False,16,18,0,0,18,6,12,7,4,3,11,8
Vorm,351,0,98,2018-10-29T20:00:00Z,True,16,12,0,0,21,6,15,23,15,8,-2,-2
Vorm,351,0,109,2018-11-03T19:45:00Z,False,16,19,0,0,21,6,15,15,8,7,6,7
Vorm,351,0,113,2018-11-10T17:30:00Z,False,16,6,0,0,24,6,18,8,2,6,16,16
Vorm,351,0,126,2018-11-24T17:30:00Z,True,16,5,0,0,27,6,21,28,15,13,-1,-7
Vorm,351,0,130,2018-12-02T14:05:00Z,False,16,0,0,0,30,9,21,27,14,13,3,7
Vorm,351,0,149,2018-12-05T20:00:00Z,True,16,15,0,0,30,9,21,9,5,4,21,5
Vorm,351,0,156,2018-12-08T19:45:00Z,False,16,10,0,0,33,12,21,22,11,11,11,10
Vorm,351,0,167,2018-12-15T15:00:00Z,True,16,3,0,0,36,12,24,12,7,5,24,7
Vorm,351,0,174,2018-12-23T16:00:00Z,False,16,7,0,0,39,15,24,24,18,6,15,6
Vorm,351,0,188,2018-12-26T15:00:00Z,True,16,1,0,0,42,15,27,26,17,9,16,6
Vorm,351,0,198,2018-12-29T15:00:00Z,True,16,19,0,0,45,18,27,26,14,12,19,6
Vorm,351,0,202,2019-01-01T17:30:00Z,False,16,4,0,0,45,18,27,18,13,5,27,14
Vorm,351,0,218,2019-01-13T16:30:00Z,True,16,13,0,0,48,18,30,38,21,17,10,1
Vorm,351,0,222,2019-01-20T16:00:00Z,False,16,8,0,0,48,18,30,14,12,2,34,18
Vorm,351,0,239,2019-01-30T20:00:00Z,True,16,17,0,0,51,18,33,33,17,16,18,2
Vorm,351,0,248,2019-02-02T12:30:00Z,True,16,14,0,0,54,21,33,24,13,11,30,10
Vorm,351,0,257,2019-02-10T13:30:00Z,True,16,10,0,0,57,24,33,32,14,18,25,6
Vorm,351,0,262,2019-02-23T12:30:00Z,False,16,3,0,0,60,27,33,27,14,13,33,19
Vorm,351,0,275,2019-02-27T20:00:00Z,False,16,5,0,0,60,27,33,50,28,22,10,5
Vorm,351,0,286,2019-03-02T12:30:00Z,True,16,0,0,0,60,27,33,56,38,18,4,9
Vorm,351,0,299,2019-03-09T15:00:00Z,False,16,15,0,0,61,28,33,27,15,12,34,18
Vorm,351,0,317,2019-03-31T15:30:00Z,False,16,11,0,0,61,28,33,76,41,35,-15,-8
Vorm,351,0,306,2019-04-03T18:45:00Z,True,16,6,0,0,61,28,33,36,16,20,25,8
Vorm,351,0,338,2019-04-13T11:30:00Z,True,16,9,0,0,64,31,33,14,8,6,50,25
Vorm,351,0,346,2019-04-20T11:30:00Z,False,16,12,0,0,67,34,33,83,48,35,-16,-15
Vorm,351,0,327,2019-04-23T18:45:00Z,True,16,2,0,0,67,34,33,34,22,12,33,22
Vorm,351,0,358,2019-04-27T11:30:00Z,True,16,18,0,0,70,37,33,43,28,15,27,22
Vorm,351,0,361,2019-05-04T11:30:00Z,False,16,1,0,0,70,37,33,42,26,16,28,7
Vorm,351,0,378,2019-05-12T14:00:00Z,True,16,7,0,0,70,37,33,53,34,19,17,18
Alderweireld,352,1,6,2018-08-11T11:30:00Z,False,16,14,0,0,0,0,0,0,0,0,0,0
Alderweireld,352,1,18,2018-08-18T14:00:00Z,True,16,8,90,2,3,0,3,0,0,0,3,0
Alderweireld,352,1,25,2018-08-27T19:00:00Z,False,16,13,90,6,6,3,3,3,3,0,3,0
Alderweireld,352,1,38,2018-09-02T15:00:00Z,False,16,17,80,1,9,3,6,9,6,3,0,0
Alderweireld,352,1,47,2018-09-15T11:30:00Z,True,16,11,90,1,9,3,6,12,6,6,-3,-3
Alderweireld,352,1,51,2018-09-22T16:30:00Z,False,16,2,90,2,9,3,6,5,4,1,4,2
Alderweireld,352,1,65,2018-09-29T14:00:00Z,False,16,9,90,6,12,3,9,2,1,1,10,8
Alderweireld,352,1,78,2018-10-06T14:00:00Z,True,16,4,90,5,15,3,12,2,1,1,13,2
Alderweireld,352,1,88,2018-10-20T14:00:00Z,False,16,18,90,7,18,6,12,7,4,3,11,8
Alderweireld,352,1,98,2018-10-29T20:00:00Z,True,16,12,90,2,21,6,15,23,15,8,-2,-2
Alderweireld,352,1,109,2018-11-03T19:45:00Z,False,16,19,90,1,21,6,15,15,8,7,6,7
Alderweireld,352,1,113,2018-11-10T17:30:00Z,False,16,6,90,7,24,6,18,8,2,6,16,16
Alderweireld,352,1,126,2018-11-24T17:30:00Z,True,16,5,90,2,27,6,21,28,15,13,-1,-7
Alderweireld,352,1,130,2018-12-02T14:05:00Z,False,16,0,0,0,30,9,21,27,14,13,3,7
Alderweireld,352,1,149,2018-12-05T20:00:00Z,True,16,15,90,2,30,9,21,9,5,4,21,5
Alderweireld,352,1,156,2018-12-08T19:45:00Z,False,16,10,90,6,33,12,21,22,11,11,11,10
Alderweireld,352,1,167,2018-12-15T15:00:00Z,True,16,3,90,9,36,12,24,12,7,5,24,7
Alderweireld,352,1,174,2018-12-23T16:00:00Z,False,16,7,90,1,39,15,24,24,18,6,15,6
Alderweireld,352,1,188,2018-12-26T15:00:00Z,True,16,1,90,6,42,15,27,26,17,9,16,6
Alderweireld,352,1,198,2018-12-29T15:00:00Z,True,16,19,90,1,45,18,27,26,14,12,19,6
Alderweireld,352,1,202,2019-01-01T17:30:00Z,False,16,4,90,6,45,18,27,18,13,5,27,14
Alderweireld,352,1,218,2019-01-13T16:30:00Z,True,16,13,90,2,48,18,30,38,21,17,10,1
Alderweireld,352,1,222,2019-01-20T16:00:00Z,False,16,8,90,1,48,18,30,14,12,2,34,18
Alderweireld,352,1,239,2019-01-30T20:00:00Z,True,16,17,90,2,51,18,33,33,17,16,18,2
Alderweireld,352,1,248,2019-02-02T12:30:00Z,True,16,14,90,6,54,21,33,24,13,11,30,10
Alderweireld,352,1,257,2019-02-10T13:30:00Z,True,16,10,19,1,57,24,33,32,14,18,25,6
Alderweireld,352,1,262,2019-02-23T12:30:00Z,False,16,3,90,1,60,27,33,27,14,13,33,19
Alderweireld,352,1,275,2019-02-27T20:00:00Z,False,16,5,90,1,60,27,33,50,28,22,10,5
Alderweireld,352,1,286,2019-03-02T12:30:00Z,True,16,0,90,2,60,27,33,56,38,18,4,9
Alderweireld,352,1,299,2019-03-09T15:00:00Z,False,16,15,0,0,61,28,33,27,15,12,34,18
Alderweireld,352,1,317,2019-03-31T15:30:00Z,False,16,11,90,-1,61,28,33,76,41,35,-15,-8
Alderweireld,352,1,306,2019-04-03T18:45:00Z,True,16,6,90,6,61,28,33,36,16,20,25,8
Alderweireld,352,1,338,2019-04-13T11:30:00Z,True,16,9,0,0,64,31,33,14,8,6,50,25
Alderweireld,352,1,346,2019-04-20T11:30:00Z,False,16,12,77,2,67,34,33,83,48,35,-16,-15
Alderweireld,352,1,327,2019-04-23T18:45:00Z,True,16,2,90,8,67,34,33,34,22,12,33,22
Alderweireld,352,1,358,2019-04-27T11:30:00Z,True,16,18,90,2,70,37,33,43,28,15,27,22
Alderweireld,352,1,361,2019-05-04T11:30:00Z,False,16,1,45,0,70,37,33,42,26,16,28,7
Alderweireld,352,1,378,2019-05-12T14:00:00Z,True,16,7,90,1,70,37,33,53,34,19,17,18
Rose,353,1,6,2018-08-11T11:30:00Z,False,16,14,0,0,0,0,0,0,0,0,0,0
Rose,353,1,18,2018-08-18T14:00:00Z,True,16,8,0,0,3,0,3,0,0,0,3,0
Rose,353,1,25,2018-08-27T19:00:00Z,False,16,13,81,5,6,3,3,3,3,0,3,0
Rose,353,1,38,2018-09-02T15:00:00Z,False,16,17,1,1,9,3,6,9,6,3,0,0
Rose,353,1,47,2018-09-15T11:30:00Z,True,16,11,90,1,9,3,6,12,6,6,-3,-3
Rose,353,1,51,2018-09-22T16:30:00Z,False,16,2,90,7,9,3,6,5,4,1,4,2
Rose,353,1,65,2018-09-29T14:00:00Z,False,16,9,90,8,12,3,9,2,1,1,10,8
Rose,353,1,78,2018-10-06T14:00:00Z,True,16,4,87,6,15,3,12,2,1,1,13,2
Rose,353,1,88,2018-10-20T14:00:00Z,False,16,18,0,0,18,6,12,7,4,3,11,8
Rose,353,1,98,2018-10-29T20:00:00Z,True,16,12,0,0,21,6,15,23,15,8,-2,-2
Rose,353,1,109,2018-11-03T19:45:00Z,False,16,19,0,0,21,6,15,15,8,7,6,7
Rose,353,1,113,2018-11-10T17:30:00Z,False,16,6,0,0,24,6,18,8,2,6,16,16
Rose,353,1,126,2018-11-24T17:30:00Z,True,16,5,0,0,27,6,21,28,15,13,-1,-7
Rose,353,1,130,2018-12-02T14:05:00Z,False,16,0,8,1,30,9,21,27,14,13,3,7
Rose,353,1,149,2018-12-05T20:00:00Z,True,16,15,90,2,30,9,21,9,5,4,21,5
Rose,353,1,156,2018-12-08T19:45:00Z,False,16,10,0,0,33,12,21,22,11,11,11,10
Rose,353,1,167,2018-12-15T15:00:00Z,True,16,3,90,6,36,12,24,12,7,5,24,7
Rose,353,1,174,2018-12-23T16:00:00Z,False,16,7,0,0,39,15,24,24,18,6,15,6
Rose,353,1,188,2018-12-26T15:00:00Z,True,16,1,90,6,42,15,27,26,17,9,16,6
Rose,353,1,198,2018-12-29T15:00:00Z,True,16,19,0,0,45,18,27,26,14,12,19,6
Rose,353,1,202,2019-01-01T17:30:00Z,False,16,4,90,6,45,18,27,18,13,5,27,14
Rose,353,1,218,2019-01-13T16:30:00Z,True,16,13,0,0,48,18,30,38,21,17,10,1
Rose,353,1,222,2019-01-20T16:00:00Z,False,16,8,90,1,48,18,30,14,12,2,34,18
Rose,353,1,239,2019-01-30T20:00:00Z,True,16,17,90,7,51,18,33,33,17,16,18,2
Rose,353,1,248,2019-02-02T12:30:00Z,True,16,14,12,1,54,21,33,24,13,11,30,10
Rose,353,1,257,2019-02-10T13:30:00Z,True,16,10,87,1,57,24,33,32,14,18,25,6
Rose,353,1,262,2019-02-23T12:30:00Z,False,16,3,90,5,60,27,33,27,14,13,33,19
Rose,353,1,275,2019-02-27T20:00:00Z,False,16,5,5,1,60,27,33,50,28,22,10,5
Rose,353,1,286,2019-03-02T12:30:00Z,True,16,0,90,1,60,27,33,56,38,18,4,9
Rose,353,1,299,2019-03-09T15:00:00Z,False,16,15,81,1,61,28,33,27,15,12,34,18
Rose,353,1,317,2019-03-31T15:30:00Z,False,16,11,90,1,61,28,33,76,41,35,-15,-8
Rose,353,1,306,2019-04-03T18:45:00Z,True,16,6,68,6,61,28,33,36,16,20,25,8
Rose,353,1,338,2019-04-13T11:30:00Z,True,16,9,5,1,64,31,33,14,8,6,50,25
Rose,353,1,346,2019-04-20T11:30:00Z,False,16,12,21,1,67,34,33,83,48,35,-16,-15
Rose,353,1,327,2019-04-23T18:45:00Z,True,16,2,90,6,67,34,33,34,22,12,33,22
Rose,353,1,358,2019-04-27T11:30:00Z,True,16,18,76,2,70,37,33,43,28,15,27,22
Rose,353,1,361,2019-05-04T11:30:00Z,False,16,1,90,2,70,37,33,42,26,16,28,7
Rose,353,1,378,2019-05-12T14:00:00Z,True,16,7,0,0,70,37,33,53,34,19,17,18
Vertonghen,354,1,6,2018-08-11T11:30:00Z,False,16,14,90,11,0,0,0,0,0,0,0,0
Vertonghen,354,1,18,2018-08-18T14:00:00Z,True,16,8,90,2,3,0,3,0,0,0,3,0
Vertonghen,354,1,25,2018-08-27T19:00:00Z,False,16,13,90,6,6,3,3,3,3,0,3,0
Vertonghen,354,1,38,2018-09-02T15:00:00Z,False,16,17,90,1,9,3,6,9,6,3,0,0
Vertonghen,354,1,47,2018-09-15T11:30:00Z,True,16,11,90,1,9,3,6,12,6,6,-3,-3
Vertonghen,354,1,51,2018-09-22T16:30:00Z,False,16,2,90,2,9,3,6,5,4,1,4,2
Vertonghen,354,1,65,2018-09-29T14:00:00Z,False,16,9,45,1,12,3,9,2,1,1,10,8
Vertonghen,354,1,78,2018-10-06T14:00:00Z,True,16,4,0,0,15,3,12,2,1,1,13,2
Vertonghen,354,1,88,2018-10-20T14:00:00Z,False,16,18,0,0,18,6,12,7,4,3,11,8
Vertonghen,354,1,98,2018-10-29T20:00:00Z,True,16,12,0,0,21,6,15,23,15,8,-2,-2
Vertonghen,354,1,109,2018-11-03T19:45:00Z,False,16,19,0,0,21,6,15,15,8,7,6,7
Vertonghen,354,1,113,2018-11-10T17:30:00Z,False,16,6,0,0,24,6,18,8,2,6,16,16
Vertonghen,354,1,126,2018-11-24T17:30:00Z,True,16,5,0,0,27,6,21,28,15,13,-1,-7
Vertonghen,354,1,130,2018-12-02T14:05:00Z,False,16,0,84,-3,30,9,21,27,14,13,3,7
Vertonghen,354,1,149,2018-12-05T20:00:00Z,True,16,15,0,0,30,9,21,9,5,4,21,5
Vertonghen,354,1,156,2018-12-08T19:45:00Z,False,16,10,90,7,33,12,21,22,11,11,11,10
Vertonghen,354,1,167,2018-12-15T15:00:00Z,True,16,3,0,0,36,12,24,12,7,5,24,7
Vertonghen,354,1,174,2018-12-23T16:00:00Z,False,16,7,0,0,39,15,24,24,18,6,15,6
Vertonghen,354,1,188,2018-12-26T15:00:00Z,True,16,1,0,0,42,15,27,26,17,9,16,6
Vertonghen,354,1,198,2018-12-29T15:00:00Z,True,16,19,0,0,45,18,27,26,14,12,19,6
Vertonghen,354,1,202,2019-01-01T17:30:00Z,False,16,4,0,0,45,18,27,18,13,5,27,14
Vertonghen,354,1,218,2019-01-13T16:30:00Z,True,16,13,90,2,48,18,30,38,21,17,10,1
Vertonghen,354,1,222,2019-01-20T16:00:00Z,False,16,8,90,2,48,18,30,14,12,2,34,18
Vertonghen,354,1,239,2019-01-30T20:00:00Z,True,16,17,78,2,51,18,33,33,17,16,18,2
Vertonghen,354,1,248,2019-02-02T12:30:00Z,True,16,14,90,8,54,21,33,24,13,11,30,10
Vertonghen,354,1,257,2019-02-10T13:30:00Z,True,16,10,90,1,57,24,33,32,14,18,25,6
Vertonghen,354,1,262,2019-02-23T12:30:00Z,False,16,3,90,1,60,27,33,27,14,13,33,19
Vertonghen,354,1,275,2019-02-27T20:00:00Z,False,16,5,0,0,60,27,33,50,28,22,10,5
Vertonghen,354,1,286,2019-03-02T12:30:00Z,True,16,0,90,2,60,27,33,56,38,18,4,9
Vertonghen,354,1,299,2019-03-09T15:00:00Z,False,16,15,90,1,61,28,33,27,15,12,34,18
Vertonghen,354,1,317,2019-03-31T15:30:00Z,False,16,11,90,1,61,28,33,76,41,35,-15,-8
Vertonghen,354,1,306,2019-04-03T18:45:00Z,True,16,6,90,6,61,28,33,36,16,20,25,8
Vertonghen,354,1,338,2019-04-13T11:30:00Z,True,16,9,84,5,64,31,33,14,8,6,50,25
Vertonghen,354,1,346,2019-04-20T11:30:00Z,False,16,12,90,1,67,34,33,83,48,35,-16,-15
Vertonghen,354,1,327,2019-04-23T18:45:00Z,True,16,2,90,7,67,34,33,34,22,12,33,22
Vertonghen,354,1,358,2019-04-27T11:30:00Z,True,16,18,0,0,70,37,33,43,28,15,27,22
Vertonghen,354,1,361,2019-05-04T11:30:00Z,False,16,1,0,0,70,37,33,42,26,16,28,7
Vertonghen,354,1,378,2019-05-12T14:00:00Z,True,16,7,0,0,70,37,33,53,34,19,17,18
Davies,355,1,6,2018-08-11T11:30:00Z,False,16,14,90,2,0,0,0,0,0,0,0,0
Davies,355,1,18,2018-08-18T14:00:00Z,True,16,8,90,2,3,0,3,0,0,0,3,0
Davies,355,1,25,2018-08-27T19:00:00Z,False,16,13,8,1,6,3,3,3,3,0,3,0
Davies,355,1,38,2018-09-02T15:00:00Z,False,16,17,88,1,9,3,6,9,6,3,0,0
Davies,355,1,47,2018-09-15T11:30:00Z,True,16,11,0,0,9,3,6,12,6,6,-3,-3
Davies,355,1,51,2018-09-22T16:30:00Z,False,16,2,0,0,9,3,6,5,4,1,4,2
Davies,355,1,65,2018-09-29T14:00:00Z,False,16,9,0,0,12,3,9,2,1,1,10,8
Davies,355,1,78,2018-10-06T14:00:00Z,True,16,4,2,1,15,3,12,2,1,1,13,2
Davies,355,1,88,2018-10-20T14:00:00Z,False,16,18,90,6,18,6,12,7,4,3,11,8
Davies,355,1,98,2018-10-29T20:00:00Z,True,16,12,90,1,21,6,15,23,15,8,-2,-2
Davies,355,1,109,2018-11-03T19:45:00Z,False,16,19,90,1,21,6,15,15,8,7,6,7
Davies,355,1,113,2018-11-10T17:30:00Z,False,16,6,90,6,24,6,18,8,2,6,16,16
Davies,355,1,126,2018-11-24T17:30:00Z,True,16,5,90,2,27,6,21,28,15,13,-1,-7
Davies,355,1,130,2018-12-02T14:05:00Z,False,16,0,81,0,30,9,21,27,14,13,3,7
Davies,355,1,149,2018-12-05T20:00:00Z,True,16,15,0,0,30,9,21,9,5,4,21,5
Davies,355,1,156,2018-12-08T19:45:00Z,False,16,10,90,8,33,12,21,22,11,11,11,10
Davies,355,1,167,2018-12-15T15:00:00Z,True,16,3,90,8,36,12,24,12,7,5,24,7
Davies,355,1,174,2018-12-23T16:00:00Z,False,16,7,90,1,39,15,24,24,18,6,15,6
Davies,355,1,188,2018-12-26T15:00:00Z,True,16,1,6,1,42,15,27,26,17,9,16,6
Davies,355,1,198,2018-12-29T15:00:00Z,True,16,19,90,0,45,18,27,26,14,12,19,6
Davies,355,1,202,2019-01-01T17:30:00Z,False,16,4,0,0,45,18,27,18,13,5,27,14
Davies,355,1,218,2019-01-13T16:30:00Z,True,16,13,90,2,48,18,30,38,21,17,10,1
Davies,355,1,222,2019-01-20T16:00:00Z,False,16,8,0,0,48,18,30,14,12,2,34,18
Davies,355,1,239,2019-01-30T20:00:00Z,True,16,17,0,0,51,18,33,33,17,16,18,2
Davies,355,1,248,2019-02-02T12:30:00Z,True,16,14,0,0,54,21,33,24,13,11,30,10
Davies,355,1,257,2019-02-10T13:30:00Z,True,16,10,0,0,57,24,33,32,14,18,25,6
Davies,355,1,262,2019-02-23T12:30:00Z,False,16,3,0,0,60,27,33,27,14,13,33,19
Davies,355,1,275,2019-02-27T20:00:00Z,False,16,5,90,1,60,27,33,50,28,22,10,5
Davies,355,1,286,2019-03-02T12:30:00Z,True,16,0,0,0,60,27,33,56,38,18,4,9
Davies,355,1,299,2019-03-09T15:00:00Z,False,16,15,8,1,61,28,33,27,15,12,34,18
Davies,355,1,317,2019-03-31T15:30:00Z,False,16,11,8,1,61,28,33,76,41,35,-15,-8
Davies,355,1,306,2019-04-03T18:45:00Z,True,16,6,90,6,61,28,33,36,16,20,25,8
Davies,355,1,338,2019-04-13T11:30:00Z,True,16,9,90,6,64,31,33,14,8,6,50,25
Davies,355,1,346,2019-04-20T11:30:00Z,False,16,12,90,2,67,34,33,83,48,35,-16,-15
Davies,355,1,327,2019-04-23T18:45:00Z,True,16,2,8,1,67,34,33,34,22,12,33,22
Davies,355,1,358,2019-04-27T11:30:00Z,True,16,18,90,3,70,37,33,43,28,15,27,22
Davies,355,1,361,2019-05-04T11:30:00Z,False,16,1,8,1,70,37,33,42,26,16,28,7
Davies,355,1,378,2019-05-12T14:00:00Z,True,16,7,90,1,70,37,33,53,34,19,17,18
Trippier,356,1,6,2018-08-11T11:30:00Z,False,16,14,0,0,0,0,0,0,0,0,0,0
Trippier,356,1,18,2018-08-18T14:00:00Z,True,16,8,90,11,3,0,3,0,0,0,3,0
Trippier,356,1,25,2018-08-27T19:00:00Z,False,16,13,75,11,6,3,3,3,3,0,3,0
Trippier,356,1,38,2018-09-02T15:00:00Z,False,16,17,90,1,9,3,6,9,6,3,0,0
Trippier,356,1,47,2018-09-15T11:30:00Z,True,16,11,90,1,9,3,6,12,6,6,-3,-3
Trippier,356,1,51,2018-09-22T16:30:00Z,False,16,2,90,4,9,3,6,5,4,1,4,2
Trippier,356,1,65,2018-09-29T14:00:00Z,False,16,9,90,11,12,3,9,2,1,1,10,8
Trippier,356,1,78,2018-10-06T14:00:00Z,True,16,4,90,7,15,3,12,2,1,1,13,2
Trippier,356,1,88,2018-10-20T14:00:00Z,False,16,18,90,6,18,6,12,7,4,3,11,8
Trippier,356,1,98,2018-10-29T20:00:00Z,True,16,12,90,2,21,6,15,23,15,8,-2,-2
Trippier,356,1,109,2018-11-03T19:45:00Z,False,16,19,90,4,21,6,15,15,8,7,6,7
Trippier,356,1,113,2018-11-10T17:30:00Z,False,16,6,23,1,24,6,18,8,2,6,16,16
Trippier,356,1,126,2018-11-24T17:30:00Z,True,16,5,0,0,27,6,21,28,15,13,-1,-7
Trippier,356,1,130,2018-12-02T14:05:00Z,False,16,0,0,0,30,9,21,27,14,13,3,7
Trippier,356,1,149,2018-12-05T20:00:00Z,True,16,15,86,6,30,9,21,9,5,4,21,5
Trippier,356,1,156,2018-12-08T19:45:00Z,False,16,10,0,0,33,12,21,22,11,11,11,10
Trippier,356,1,167,2018-12-15T15:00:00Z,True,16,3,90,6,36,12,24,12,7,5,24,7
Trippier,356,1,174,2018-12-23T16:00:00Z,False,16,7,90,3,39,15,24,24,18,6,15,6
Trippier,356,1,188,2018-12-26T15:00:00Z,True,16,1,0,0,42,15,27,26,17,9,16,6
Trippier,356,1,198,2018-12-29T15:00:00Z,True,16,19,90,1,45,18,27,26,14,12,19,6
Trippier,356,1,202,2019-01-01T17:30:00Z,False,16,4,90,6,45,18,27,18,13,5,27,14
Trippier,356,1,218,2019-01-13T16:30:00Z,True,16,13,90,2,48,18,30,38,21,17,10,1
Trippier,356,1,222,2019-01-20T16:00:00Z,False,16,8,90,2,48,18,30,14,12,2,34,18
Trippier,356,1,239,2019-01-30T20:00:00Z,True,16,17,21,1,51,18,33,33,17,16,18,2
Trippier,356,1,248,2019-02-02T12:30:00Z,True,16,14,90,8,54,21,33,24,13,11,30,10
Trippier,356,1,257,2019-02-10T13:30:00Z,True,16,10,90,2,57,24,33,32,14,18,25,6
Trippier,356,1,262,2019-02-23T12:30:00Z,False,16,3,0,0,60,27,33,27,14,13,33,19
Trippier,356,1,275,2019-02-27T20:00:00Z,False,16,5,90,-1,60,27,33,50,28,22,10,5
Trippier,356,1,286,2019-03-02T12:30:00Z,True,16,0,90,4,60,27,33,56,38,18,4,9
Trippier,356,1,299,2019-03-09T15:00:00Z,False,16,15,0,0,61,28,33,27,15,12,34,18
Trippier,356,1,317,2019-03-31T15:30:00Z,False,16,11,90,1,61,28,33,76,41,35,-15,-8
Trippier,356,1,306,2019-04-03T18:45:00Z,True,16,6,90,7,61,28,33,36,16,20,25,8
Trippier,356,1,338,2019-04-13T11:30:00Z,True,16,9,0,0,64,31,33,14,8,6,50,25
Trippier,356,1,346,2019-04-20T11:30:00Z,False,16,12,0,0,67,34,33,83,48,35,-16,-15
Trippier,356,1,327,2019-04-23T18:45:00Z,True,16,2,90,9,67,34,33,34,22,12,33,22
Trippier,356,1,358,2019-04-27T11:30:00Z,True,16,18,0,0,70,37,33,43,28,15,27,22
Trippier,356,1,361,2019-05-04T11:30:00Z,False,16,1,90,2,70,37,33,42,26,16,28,7
Trippier,356,1,378,2019-05-12T14:00:00Z,True,16,7,0,0,70,37,33,53,34,19,17,18
Walker-Peters,357,1,6,2018-08-11T11:30:00Z,False,16,14,0,0,0,0,0,0,0,0,0,0
Walker-Peters,357,1,18,2018-08-18T14:00:00Z,True,16,8,0,0,3,0,3,0,0,0,3,0
Walker-Peters,357,1,25,2018-08-27T19:00:00Z,False,16,13,0,0,6,3,3,3,3,0,3,0
Walker-Peters,357,1,38,2018-09-02T15:00:00Z,False,16,17,0,0,9,3,6,9,6,3,0,0
Walker-Peters,357,1,47,2018-09-15T11:30:00Z,True,16,11,0,0,9,3,6,12,6,6,-3,-3
Walker-Peters,357,1,51,2018-09-22T16:30:00Z,False,16,2,0,0,9,3,6,5,4,1,4,2
Walker-Peters,357,1,65,2018-09-29T14:00:00Z,False,16,9,0,0,12,3,9,2,1,1,10,8
Walker-Peters,357,1,78,2018-10-06T14:00:00Z,True,16,4,0,0,15,3,12,2,1,1,13,2
Walker-Peters,357,1,88,2018-10-20T14:00:00Z,False,16,18,0,0,18,6,12,7,4,3,11,8
Walker-Peters,357,1,98,2018-10-29T20:00:00Z,True,16,12,0,0,21,6,15,23,15,8,-2,-2
Walker-Peters,357,1,109,2018-11-03T19:45:00Z,False,16,19,0,0,21,6,15,15,8,7,6,7
Walker-Peters,357,1,113,2018-11-10T17:30:00Z,False,16,6,0,0,24,6,18,8,2,6,16,16
Walker-Peters,357,1,126,2018-11-24T17:30:00Z,True,16,5,0,0,27,6,21,28,15,13,-1,-7
Walker-Peters,357,1,130,2018-12-02T14:05:00Z,False,16,0,0,0,30,9,21,27,14,13,3,7
Walker-Peters,357,1,149,2018-12-05T20:00:00Z,True,16,15,0,0,30,9,21,9,5,4,21,5
Walker-Peters,357,1,156,2018-12-08T19:45:00Z,False,16,10,12,1,33,12,21,22,11,11,11,10
Walker-Peters,357,1,167,2018-12-15T15:00:00Z,True,16,3,0,0,36,12,24,12,7,5,24,7
Walker-Peters,357,1,174,2018-12-23T16:00:00Z,False,16,7,0,0,39,15,24,24,18,6,15,6
Walker-Peters,357,1,188,2018-12-26T15:00:00Z,True,16,1,90,18,42,15,27,26,17,9,16,6
Walker-Peters,357,1,198,2018-12-29T15:00:00Z,True,16,19,0,0,45,18,27,26,14,12,19,6
Walker-Peters,357,1,202,2019-01-01T17:30:00Z,False,16,4,0,0,45,18,27,18,13,5,27,14
Walker-Peters,357,1,218,2019-01-13T16:30:00Z,True,16,13,0,0,48,18,30,38,21,17,10,1
Walker-Peters,357,1,222,2019-01-20T16:00:00Z,False,16,8,0,0,48,18,30,14,12,2,34,18
Walker-Peters,357,1,239,2019-01-30T20:00:00Z,True,16,17,0,0,51,18,33,33,17,16,18,2
Walker-Peters,357,1,248,2019-02-02T12:30:00Z,True,16,14,0,0,54,21,33,24,13,11,30,10
Walker-Peters,357,1,257,2019-02-10T13:30:00Z,True,16,10,2,1,57,24,33,32,14,18,25,6
Walker-Peters,357,1,262,2019-02-23T12:30:00Z,False,16,3,0,0,60,27,33,27,14,13,33,19
Walker-Peters,357,1,275,2019-02-27T20:00:00Z,False,16,5,0,0,60,27,33,50,28,22,10,5
Walker-Peters,357,1,286,2019-03-02T12:30:00Z,True,16,0,0,0,60,27,33,56,38,18,4,9
Walker-Peters,357,1,299,2019-03-09T15:00:00Z,False,16,15,90,0,61,28,33,27,15,12,34,18
Walker-Peters,357,1,317,2019-03-31T15:30:00Z,False,16,11,0,0,61,28,33,76,41,35,-15,-8
Walker-Peters,357,1,306,2019-04-03T18:45:00Z,True,16,6,0,0,61,28,33,36,16,20,25,8
Walker-Peters,357,1,338,2019-04-13T11:30:00Z,True,16,9,90,7,64,31,33,14,8,6,50,25
Walker-Peters,357,1,346,2019-04-20T11:30:00Z,False,16,12,0,0,67,34,33,83,48,35,-16,-15
Walker-Peters,357,1,327,2019-04-23T18:45:00Z,True,16,2,0,0,67,34,33,34,22,12,33,22
Walker-Peters,357,1,358,2019-04-27T11:30:00Z,True,16,18,0,0,70,37,33,43,28,15,27,22
Walker-Peters,357,1,361,2019-05-04T11:30:00Z,False,16,1,0,0,70,37,33,42,26,16,28,7
Walker-Peters,357,1,378,2019-05-12T14:00:00Z,True,16,7,90,1,70,37,33,53,34,19,17,18
Sanchez,358,1,6,2018-08-11T11:30:00Z,False,16,14,90,5,0,0,0,0,0,0,0,0
Sanchez,358,1,18,2018-08-18T14:00:00Z,True,16,8,62,2,3,0,3,0,0,0,3,0
Sanchez,358,1,25,2018-08-27T19:00:00Z,False,16,13,0,0,6,3,3,3,3,0,3,0
Sanchez,358,1,38,2018-09-02T15:00:00Z,False,16,17,90,1,9,3,6,9,6,3,0,0
Sanchez,358,1,47,2018-09-15T11:30:00Z,True,16,11,0,0,9,3,6,12,6,6,-3,-3
Sanchez,358,1,51,2018-09-22T16:30:00Z,False,16,2,0,0,9,3,6,5,4,1,4,2
Sanchez,358,1,65,2018-09-29T14:00:00Z,False,16,9,90,7,12,3,9,2,1,1,10,8
Sanchez,358,1,78,2018-10-06T14:00:00Z,True,16,4,90,11,15,3,12,2,1,1,13,2
Sanchez,358,1,88,2018-10-20T14:00:00Z,False,16,18,90,6,18,6,12,7,4,3,11,8
Sanchez,358,1,98,2018-10-29T20:00:00Z,True,16,12,90,2,21,6,15,23,15,8,-2,-2
Sanchez,358,1,109,2018-11-03T19:45:00Z,False,16,19,11,1,21,6,15,15,8,7,6,7
Sanchez,358,1,113,2018-11-10T17:30:00Z,False,16,6,0,0,24,6,18,8,2,6,16,16
Sanchez,358,1,126,2018-11-24T17:30:00Z,True,16,5,0,0,27,6,21,28,15,13,-1,-7
Sanchez,358,1,130,2018-12-02T14:05:00Z,False,16,0,0,0,30,9,21,27,14,13,3,7
Sanchez,358,1,149,2018-12-05T20:00:00Z,True,16,15,0,0,30,9,21,9,5,4,21,5
Sanchez,358,1,156,2018-12-08T19:45:00Z,False,16,10,0,0,33,12,21,22,11,11,11,10
Sanchez,358,1,167,2018-12-15T15:00:00Z,True,16,3,0,0,36,12,24,12,7,5,24,7
Sanchez,358,1,174,2018-12-23T16:00:00Z,False,16,7,90,1,39,15,24,24,18,6,15,6
Sanchez,358,1,188,2018-12-26T15:00:00Z,True,16,1,0,0,42,15,27,26,17,9,16,6
Sanchez,358,1,198,2018-12-29T15:00:00Z,True,16,19,90,1,45,18,27,26,14,12,19,6
Sanchez,358,1,202,2019-01-01T17:30:00Z,False,16,4,90,6,45,18,27,18,13,5,27,14
Sanchez,358,1,218,2019-01-13T16:30:00Z,True,16,13,0,0,48,18,30,38,21,17,10,1
Sanchez,358,1,222,2019-01-20T16:00:00Z,False,16,8,90,1,48,18,30,14,12,2,34,18
Sanchez,358,1,239,2019-01-30T20:00:00Z,True,16,17,90,2,51,18,33,33,17,16,18,2
Sanchez,358,1,248,2019-02-02T12:30:00Z,True,16,14,90,6,54,21,33,24,13,11,30,10
Sanchez,358,1,257,2019-02-10T13:30:00Z,True,16,10,90,8,57,24,33,32,14,18,25,6
Sanchez,358,1,262,2019-02-23T12:30:00Z,False,16,3,0,0,60,27,33,27,14,13,33,19
Sanchez,358,1,275,2019-02-27T20:00:00Z,False,16,5,90,1,60,27,33,50,28,22,10,5
Sanchez,358,1,286,2019-03-02T12:30:00Z,True,16,0,90,2,60,27,33,56,38,18,4,9
Sanchez,358,1,299,2019-03-09T15:00:00Z,False,16,15,90,1,61,28,33,27,15,12,34,18
Sanchez,358,1,317,2019-03-31T15:30:00Z,False,16,11,68,2,61,28,33,76,41,35,-15,-8
Sanchez,358,1,306,2019-04-03T18:45:00Z,True,16,6,0,0,61,28,33,36,16,20,25,8
Sanchez,358,1,338,2019-04-13T11:30:00Z,True,16,9,90,6,64,31,33,14,8,6,50,25
Sanchez,358,1,346,2019-04-20T11:30:00Z,False,16,12,90,2,67,34,33,83,48,35,-16,-15
Sanchez,358,1,327,2019-04-23T18:45:00Z,True,16,2,0,0,67,34,33,34,22,12,33,22
Sanchez,358,1,358,2019-04-27T11:30:00Z,True,16,18,90,2,70,37,33,43,28,15,27,22
Sanchez,358,1,361,2019-05-04T11:30:00Z,False,16,1,90,2,70,37,33,42,26,16,28,7
Sanchez,358,1,378,2019-05-12T14:00:00Z,True,16,7,0,0,70,37,33,53,34,19,17,18
Aurier,359,1,6,2018-08-11T11:30:00Z,False,16,14,90,5,0,0,0,0,0,0,0,0
Aurier,359,1,18,2018-08-18T14:00:00Z,True,16,8,0,0,3,0,3,0,0,0,3,0
Aurier,359,1,25,2018-08-27T19:00:00Z,False,16,13,14,1,6,3,3,3,3,0,3,0
Aurier,359,1,38,2018-09-02T15:00:00Z,False,16,17,0,0,9,3,6,9,6,3,0,0
Aurier,359,1,47,2018-09-15T11:30:00Z,True,16,11,0,0,9,3,6,12,6,6,-3,-3
Aurier,359,1,51,2018-09-22T16:30:00Z,False,16,2,0,0,9,3,6,5,4,1,4,2
Aurier,359,1,65,2018-09-29T14:00:00Z,False,16,9,0,0,12,3,9,2,1,1,10,8
Aurier,359,1,78,2018-10-06T14:00:00Z,True,16,4,0,0,15,3,12,2,1,1,13,2
Aurier,359,1,88,2018-10-20T14:00:00Z,False,16,18,0,0,18,6,12,7,4,3,11,8
Aurier,359,1,98,2018-10-29T20:00:00Z,True,16,12,0,0,21,6,15,23,15,8,-2,-2
Aurier,359,1,109,2018-11-03T19:45:00Z,False,16,19,0,0,21,6,15,15,8,7,6,7
Aurier,359,1,113,2018-11-10T17:30:00Z,False,16,6,66,6,24,6,18,8,2,6,16,16
Aurier,359,1,126,2018-11-24T17:30:00Z,True,16,5,90,2,27,6,21,28,15,13,-1,-7
Aurier,359,1,130,2018-12-02T14:05:00Z,False,16,0,90,-1,30,9,21,27,14,13,3,7
Aurier,359,1,149,2018-12-05T20:00:00Z,True,16,15,0,0,30,9,21,9,5,4,21,5
Aurier,359,1,156,2018-12-08T19:45:00Z,False,16,10,77,9,33,12,21,22,11,11,11,10
Aurier,359,1,167,2018-12-15T15:00:00Z,True,16,3,0,0,36,12,24,12,7,5,24,7
Aurier,359,1,174,2018-12-23T16:00:00Z,False,16,7,0,0,39,15,24,24,18,6,15,6
Aurier,359,1,188,2018-12-26T15:00:00Z,True,16,1,0,0,42,15,27,26,17,9,16,6
Aurier,359,1,198,2018-12-29T15:00:00Z,True,16,19,0,0,45,18,27,26,14,12,19,6
Aurier,359,1,202,2019-01-01T17:30:00Z,False,16,4,0,0,45,18,27,18,13,5,27,14
Aurier,359,1,218,2019-01-13T16:30:00Z,True,16,13,0,0,48,18,30,38,21,17,10,1
Aurier,359,1,222,2019-01-20T16:00:00Z,False,16,8,0,0,48,18,30,14,12,2,34,18
Aurier,359,1,239,2019-01-30T20:00:00Z,True,16,17,45,1,51,18,33,33,17,16,18,2
Aurier,359,1,248,2019-02-02T12:30:00Z,True,16,14,0,0,54,21,33,24,13,11,30,10
Aurier,359,1,257,2019-02-10T13:30:00Z,True,16,10,0,0,57,24,33,32,14,18,25,6
Aurier,359,1,262,2019-02-23T12:30:00Z,False,16,3,90,1,60,27,33,27,14,13,33,19
Aurier,359,1,275,2019-02-27T20:00:00Z,False,16,5,0,0,60,27,33,50,28,22,10,5
Aurier,359,1,286,2019-03-02T12:30:00Z,True,16,0,0,0,60,27,33,56,38,18,4,9
Aurier,359,1,299,2019-03-09T15:00:00Z,False,16,15,0,0,61,28,33,27,15,12,34,18
Aurier,359,1,317,2019-03-31T15:30:00Z,False,16,11,0,0,61,28,33,76,41,35,-15,-8
Aurier,359,1,306,2019-04-03T18:45:00Z,True,16,6,0,0,61,28,33,36,16,20,25,8
Aurier,359,1,338,2019-04-13T11:30:00Z,True,16,9,0,0,64,31,33,14,8,6,50,25
Aurier,359,1,346,2019-04-20T11:30:00Z,False,16,12,0,0,67,34,33,83,48,35,-16,-15
Aurier,359,1,327,2019-04-23T18:45:00Z,True,16,2,0,0,67,34,33,34,22,12,33,22
Aurier,359,1,358,2019-04-27T11:30:00Z,True,16,18,0,0,70,37,33,43,28,15,27,22
Aurier,359,1,361,2019-05-04T11:30:00Z,False,16,1,0,0,70,37,33,42,26,16,28,7
Aurier,359,1,378,2019-05-12T14:00:00Z,True,16,7,0,0,70,37,33,53,34,19,17,18
Dier,360,2,6,2018-08-11T11:30:00Z,False,16,14,87,1,0,0,0,0,0,0,0,0
Dier,360,2,18,2018-08-18T14:00:00Z,True,16,8,72,2,3,0,3,0,0,0,3,0
Dier,360,2,25,2018-08-27T19:00:00Z,False,16,13,90,3,6,3,3,3,3,0,3,0
Dier,360,2,38,2018-09-02T15:00:00Z,False,16,17,0,0,9,3,6,9,6,3,0,0
Dier,360,2,47,2018-09-15T11:30:00Z,True,16,11,82,2,9,3,6,12,6,6,-3,-3
Dier,360,2,51,2018-09-22T16:30:00Z,False,16,2,90,2,9,3,6,5,4,1,4,2
Dier,360,2,65,2018-09-29T14:00:00Z,False,16,9,90,3,12,3,9,2,1,1,10,8
Dier,360,2,78,2018-10-06T14:00:00Z,True,16,4,90,8,15,3,12,2,1,1,13,2
Dier,360,2,88,2018-10-20T14:00:00Z,False,16,18,90,3,18,6,12,7,4,3,11,8
Dier,360,2,98,2018-10-29T20:00:00Z,True,16,12,66,2,21,6,15,23,15,8,-2,-2
Dier,360,2,109,2018-11-03T19:45:00Z,False,16,19,0,0,21,6,15,15,8,7,6,7
Dier,360,2,113,2018-11-10T17:30:00Z,False,16,6,0,0,24,6,18,8,2,6,16,16
Dier,360,2,126,2018-11-24T17:30:00Z,True,16,5,90,2,27,6,21,28,15,13,-1,-7
Dier,360,2,130,2018-12-02T14:05:00Z,False,16,0,90,7,30,9,21,27,14,13,3,7
Dier,360,2,149,2018-12-05T20:00:00Z,True,16,15,90,2,30,9,21,9,5,4,21,5
Dier,360,2,156,2018-12-08T19:45:00Z,False,16,10,90,2,33,12,21,22,11,11,11,10
Dier,360,2,167,2018-12-15T15:00:00Z,True,16,3,0,0,36,12,24,12,7,5,24,7
Dier,360,2,174,2018-12-23T16:00:00Z,False,16,7,0,0,39,15,24,24,18,6,15,6
Dier,360,2,188,2018-12-26T15:00:00Z,True,16,1,0,0,42,15,27,26,17,9,16,6
Dier,360,2,198,2018-12-29T15:00:00Z,True,16,19,0,0,45,18,27,26,14,12,19,6
Dier,360,2,202,2019-01-01T17:30:00Z,False,16,4,0,0,45,18,27,18,13,5,27,14
Dier,360,2,218,2019-01-13T16:30:00Z,True,16,13,0,0,48,18,30,38,21,17,10,1
Dier,360,2,222,2019-01-20T16:00:00Z,False,16,8,11,1,48,18,30,14,12,2,34,18
Dier,360,2,239,2019-01-30T20:00:00Z,True,16,17,0,0,51,18,33,33,17,16,18,2
Dier,360,2,248,2019-02-02T12:30:00Z,True,16,14,1,1,54,21,33,24,13,11,30,10
Dier,360,2,257,2019-02-10T13:30:00Z,True,16,10,0,0,57,24,33,32,14,18,25,6
Dier,360,2,262,2019-02-23T12:30:00Z,False,16,3,0,0,60,27,33,27,14,13,33,19
Dier,360,2,275,2019-02-27T20:00:00Z,False,16,5,0,0,60,27,33,50,28,22,10,5
Dier,360,2,286,2019-03-02T12:30:00Z,True,16,0,0,0,60,27,33,56,38,18,4,9
Dier,360,2,299,2019-03-09T15:00:00Z,False,16,15,90,2,61,28,33,27,15,12,34,18
Dier,360,2,317,2019-03-31T15:30:00Z,False,16,11,0,0,61,28,33,76,41,35,-15,-8
Dier,360,2,306,2019-04-03T18:45:00Z,True,16,6,0,0,61,28,33,36,16,20,25,8
Dier,360,2,338,2019-04-13T11:30:00Z,True,16,9,0,0,64,31,33,14,8,6,50,25
Dier,360,2,346,2019-04-20T11:30:00Z,False,16,12,60,2,67,34,33,83,48,35,-16,-15
Dier,360,2,327,2019-04-23T18:45:00Z,True,16,2,0,0,67,34,33,34,22,12,33,22
Dier,360,2,358,2019-04-27T11:30:00Z,True,16,18,90,2,70,37,33,43,28,15,27,22
Dier,360,2,361,2019-05-04T11:30:00Z,False,16,1,45,0,70,37,33,42,26,16,28,7
Dier,360,2,378,2019-05-12T14:00:00Z,True,16,7,90,9,70,37,33,53,34,19,17,18
Dembele,361,2,6,2018-08-11T11:30:00Z,False,16,14,22,1,0,0,0,0,0,0,0,0
Dembele,361,2,18,2018-08-18T14:00:00Z,True,16,8,27,1,3,0,3,0,0,0,3,0
Dembele,361,2,25,2018-08-27T19:00:00Z,False,16,13,90,3,6,3,3,3,3,0,3,0
Dembele,361,2,38,2018-09-02T15:00:00Z,False,16,17,85,1,9,3,6,9,6,3,0,0
Dembele,361,2,47,2018-09-15T11:30:00Z,True,16,11,59,1,9,3,6,12,6,6,-3,-3
Dembele,361,2,51,2018-09-22T16:30:00Z,False,16,2,90,2,9,3,6,5,4,1,4,2
Dembele,361,2,65,2018-09-29T14:00:00Z,False,16,9,45,1,12,3,9,2,1,1,10,8
Dembele,361,2,78,2018-10-06T14:00:00Z,True,16,4,0,0,15,3,12,2,1,1,13,2
Dembele,361,2,88,2018-10-20T14:00:00Z,False,16,18,14,1,18,6,12,7,4,3,11,8
Dembele,361,2,98,2018-10-29T20:00:00Z,True,16,12,74,2,21,6,15,23,15,8,-2,-2
Dembele,361,2,109,2018-11-03T19:45:00Z,False,16,19,6,1,21,6,15,15,8,7,6,7
Dembele,361,2,113,2018-11-10T17:30:00Z,False,16,6,0,0,24,6,18,8,2,6,16,16
Dembele,361,2,126,2018-11-24T17:30:00Z,True,16,5,0,0,27,6,21,28,15,13,-1,-7
Dembele,361,2,130,2018-12-02T14:05:00Z,False,16,0,0,0,30,9,21,27,14,13,3,7
Dembele,361,2,149,2018-12-05T20:00:00Z,True,16,15,0,0,30,9,21,9,5,4,21,5
Dembele,361,2,156,2018-12-08T19:45:00Z,False,16,10,0,0,33,12,21,22,11,11,11,10
Dembele,361,2,167,2018-12-15T15:00:00Z,True,16,3,0,0,36,12,24,12,7,5,24,7
Dembele,361,2,174,2018-12-23T16:00:00Z,False,16,7,0,0,39,15,24,24,18,6,15,6
Dembele,361,2,188,2018-12-26T15:00:00Z,True,16,1,0,0,42,15,27,26,17,9,16,6
Dembele,361,2,198,2018-12-29T15:00:00Z,True,16,19,0,0,45,18,27,26,14,12,19,6
Dembele,361,2,202,2019-01-01T17:30:00Z,False,16,4,0,0,45,18,27,18,13,5,27,14
Dembele,361,2,218,2019-01-13T16:30:00Z,True,16,13,0,0,48,18,30,38,21,17,10,1
Dembele,361,2,222,2019-01-20T16:00:00Z,False,16,8,0,0,48,18,30,14,12,2,34,18
Dembele,361,2,239,2019-01-30T20:00:00Z,True,16,17,0,0,51,18,33,33,17,16,18,2
Dembele,361,2,248,2019-02-02T12:30:00Z,True,16,14,0,0,54,21,33,24,13,11,30,10
Dembele,361,2,257,2019-02-10T13:30:00Z,True,16,10,0,0,57,24,33,32,14,18,25,6
Dembele,361,2,262,2019-02-23T12:30:00Z,False,16,3,0,0,60,27,33,27,14,13,33,19
Dembele,361,2,275,2019-02-27T20:00:00Z,False,16,5,0,0,60,27,33,50,28,22,10,5
Dembele,361,2,286,2019-03-02T12:30:00Z,True,16,0,0,0,60,27,33,56,38,18,4,9
Dembele,361,2,299,2019-03-09T15:00:00Z,False,16,15,0,0,61,28,33,27,15,12,34,18
Dembele,361,2,317,2019-03-31T15:30:00Z,False,16,11,0,0,61,28,33,76,41,35,-15,-8
Dembele,361,2,306,2019-04-03T18:45:00Z,True,16,6,0,0,61,28,33,36,16,20,25,8
Dembele,361,2,338,2019-04-13T11:30:00Z,True,16,9,0,0,64,31,33,14,8,6,50,25
Dembele,361,2,346,2019-04-20T11:30:00Z,False,16,12,0,0,67,34,33,83,48,35,-16,-15
Dembele,361,2,327,2019-04-23T18:45:00Z,True,16,2,0,0,67,34,33,34,22,12,33,22
Dembele,361,2,358,2019-04-27T11:30:00Z,True,16,18,0,0,70,37,33,43,28,15,27,22
Dembele,361,2,361,2019-05-04T11:30:00Z,False,16,1,0,0,70,37,33,42,26,16,28,7
Dembele,361,2,378,2019-05-12T14:00:00Z,True,16,7,0,0,70,37,33,53,34,19,17,18
Lamela,362,2,6,2018-08-11T11:30:00Z,False,16,14,0,0,0,0,0,0,0,0,0,0
Lamela,362,2,18,2018-08-18T14:00:00Z,True,16,8,17,4,3,0,3,0,0,0,3,0
Lamela,362,2,25,2018-08-27T19:00:00Z,False,16,13,0,0,6,3,3,3,3,0,3,0
Lamela,362,2,38,2018-09-02T15:00:00Z,False,16,17,0,0,9,3,6,9,6,3,0,0
Lamela,362,2,47,2018-09-15T11:30:00Z,True,16,11,30,6,9,3,6,12,6,6,-3,-3
Lamela,362,2,51,2018-09-22T16:30:00Z,False,16,2,22,7,9,3,6,5,4,1,4,2
Lamela,362,2,65,2018-09-29T14:00:00Z,False,16,9,0,0,12,3,9,2,1,1,10,8
Lamela,362,2,78,2018-10-06T14:00:00Z,True,16,4,18,1,15,3,12,2,1,1,13,2
Lamela,362,2,88,2018-10-20T14:00:00Z,False,16,18,75,11,18,6,12,7,4,3,11,8
Lamela,362,2,98,2018-10-29T20:00:00Z,True,16,12,90,2,21,6,15,23,15,8,-2,-2
Lamela,362,2,109,2018-11-03T19:45:00Z,False,16,19,90,7,21,6,15,15,8,7,6,7
Lamela,362,2,113,2018-11-10T17:30:00Z,False,16,6,82,3,24,6,18,8,2,6,16,16
Lamela,362,2,126,2018-11-24T17:30:00Z,True,16,5,12,1,27,6,21,28,15,13,-1,-7
Lamela,362,2,130,2018-12-02T14:05:00Z,False,16,0,0,0,30,9,21,27,14,13,3,7
Lamela,362,2,149,2018-12-05T20:00:00Z,True,16,15,0,0,30,9,21,9,5,4,21,5
Lamela,362,2,156,2018-12-08T19:45:00Z,False,16,10,0,0,33,12,21,22,11,11,11,10
Lamela,362,2,167,2018-12-15T15:00:00Z,True,16,3,81,3,36,12,24,12,7,5,24,7
Lamela,362,2,174,2018-12-23T16:00:00Z,False,16,7,45,4,39,15,24,24,18,6,15,6
Lamela,362,2,188,2018-12-26T15:00:00Z,True,16,1,0,0,42,15,27,26,17,9,16,6
Lamela,362,2,198,2018-12-29T15:00:00Z,True,16,19,0,0,45,18,27,26,14,12,19,6
Lamela,362,2,202,2019-01-01T17:30:00Z,False,16,4,0,0,45,18,27,18,13,5,27,14
Lamela,362,2,218,2019-01-13T16:30:00Z,True,16,13,47,1,48,18,30,38,21,17,10,1
Lamela,362,2,222,2019-01-20T16:00:00Z,False,16,8,78,2,48,18,30,14,12,2,34,18
Lamela,362,2,239,2019-01-30T20:00:00Z,True,16,17,11,1,51,18,33,33,17,16,18,2
Lamela,362,2,248,2019-02-02T12:30:00Z,True,16,14,77,3,54,21,33,24,13,11,30,10
Lamela,362,2,257,2019-02-10T13:30:00Z,True,16,10,0,0,57,24,33,32,14,18,25,6
Lamela,362,2,262,2019-02-23T12:30:00Z,False,16,3,14,0,60,27,33,27,14,13,33,19
Lamela,362,2,275,2019-02-27T20:00:00Z,False,16,5,69,2,60,27,33,50,28,22,10,5
Lamela,362,2,286,2019-03-02T12:30:00Z,True,16,0,31,0,60,27,33,56,38,18,4,9
Lamela,362,2,299,2019-03-09T15:00:00Z,False,16,15,0,0,61,28,33,27,15,12,34,18
Lamela,362,2,317,2019-03-31T15:30:00Z,False,16,11,0,0,61,28,33,76,41,35,-15,-8
Lamela,362,2,306,2019-04-03T18:45:00Z,True,16,6,0,0,61,28,33,36,16,20,25,8
Lamela,362,2,338,2019-04-13T11:30:00Z,True,16,9,0,0,64,31,33,14,8,6,50,25
Lamela,362,2,346,2019-04-20T11:30:00Z,False,16,12,0,0,67,34,33,83,48,35,-16,-15
Lamela,362,2,327,2019-04-23T18:45:00Z,True,16,2,0,0,67,34,33,34,22,12,33,22
Lamela,362,2,358,2019-04-27T11:30:00Z,True,16,18,0,0,70,37,33,43,28,15,27,22
Lamela,362,2,361,2019-05-04T11:30:00Z,False,16,1,0,0,70,37,33,42,26,16,28,7
Lamela,362,2,378,2019-05-12T14:00:00Z,True,16,7,76,9,70,37,33,53,34,19,17,18
Eriksen,363,2,6,2018-08-11T11:30:00Z,False,16,14,90,2,0,0,0,0,0,0,0,0
Eriksen,363,2,18,2018-08-18T14:00:00Z,True,16,8,90,2,3,0,3,0,0,0,3,0
Eriksen,363,2,25,2018-08-27T19:00:00Z,False,16,13,90,6,6,3,3,3,3,0,3,0
Eriksen,363,2,38,2018-09-02T15:00:00Z,False,16,17,90,2,9,3,6,9,6,3,0,0
Eriksen,363,2,47,2018-09-15T11:30:00Z,True,16,11,90,5,9,3,6,12,6,6,-3,-3
Eriksen,363,2,51,2018-09-22T16:30:00Z,False,16,2,90,2,9,3,6,5,4,1,4,2
Eriksen,363,2,65,2018-09-29T14:00:00Z,False,16,9,0,0,12,3,9,2,1,1,10,8
Eriksen,363,2,78,2018-10-06T14:00:00Z,True,16,4,0,0,15,3,12,2,1,1,13,2
Eriksen,363,2,88,2018-10-20T14:00:00Z,False,16,18,1,1,18,6,12,7,4,3,11,8
Eriksen,363,2,98,2018-10-29T20:00:00Z,True,16,12,9,1,21,6,15,23,15,8,-2,-2
Eriksen,363,2,109,2018-11-03T19:45:00Z,False,16,19,31,1,21,6,15,15,8,7,6,7
Eriksen,363,2,113,2018-11-10T17:30:00Z,False,16,6,0,0,24,6,18,8,2,6,16,16
Eriksen,363,2,126,2018-11-24T17:30:00Z,True,16,5,90,11,27,6,21,28,15,13,-1,-7
Eriksen,363,2,130,2018-12-02T14:05:00Z,False,16,0,90,5,30,9,21,27,14,13,3,7
Eriksen,363,2,149,2018-12-05T20:00:00Z,True,16,15,78,6,30,9,21,9,5,4,21,5
Eriksen,363,2,156,2018-12-08T19:45:00Z,False,16,10,23,1,33,12,21,22,11,11,11,10
Eriksen,363,2,167,2018-12-15T15:00:00Z,True,16,3,25,7,36,12,24,12,7,5,24,7
Eriksen,363,2,174,2018-12-23T16:00:00Z,False,16,7,90,6,39,15,24,24,18,6,15,6
Eriksen,363,2,188,2018-12-26T15:00:00Z,True,16,1,83,13,42,15,27,26,17,9,16,6
Eriksen,363,2,198,2018-12-29T15:00:00Z,True,16,19,90,1,45,18,27,26,14,12,19,6
Eriksen,363,2,202,2019-01-01T17:30:00Z,False,16,4,90,9,45,18,27,18,13,5,27,14
Eriksen,363,2,218,2019-01-13T16:30:00Z,True,16,13,90,2,48,18,30,38,21,17,10,1
Eriksen,363,2,222,2019-01-20T16:00:00Z,False,16,8,90,6,48,18,30,14,12,2,34,18
Eriksen,363,2,239,2019-01-30T20:00:00Z,True,16,17,90,2,51,18,33,33,17,16,18,2
Eriksen,363,2,248,2019-02-02T12:30:00Z,True,16,14,90,3,54,21,33,24,13,11,30,10
Eriksen,363,2,257,2019-02-10T13:30:00Z,True,16,10,90,13,57,24,33,32,14,18,25,6
Eriksen,363,2,262,2019-02-23T12:30:00Z,False,16,3,90,2,60,27,33,27,14,13,33,19
Eriksen,363,2,275,2019-02-27T20:00:00Z,False,16,5,90,2,60,27,33,50,28,22,10,5
Eriksen,363,2,286,2019-03-02T12:30:00Z,True,16,0,90,2,60,27,33,56,38,18,4,9
Eriksen,363,2,299,2019-03-09T15:00:00Z,False,16,15,90,2,61,28,33,27,15,12,34,18
Eriksen,363,2,317,2019-03-31T15:30:00Z,False,16,11,90,6,61,28,33,76,41,35,-15,-8
Eriksen,363,2,306,2019-04-03T18:45:00Z,True,16,6,90,14,61,28,33,36,16,20,25,8
Eriksen,363,2,338,2019-04-13T11:30:00Z,True,16,9,90,6,64,31,33,14,8,6,50,25
Eriksen,363,2,346,2019-04-20T11:30:00Z,False,16,12,90,2,67,34,33,83,48,35,-16,-15
Eriksen,363,2,327,2019-04-23T18:45:00Z,True,16,2,90,7,67,34,33,34,22,12,33,22
Eriksen,363,2,358,2019-04-27T11:30:00Z,True,16,18,90,2,70,37,33,43,28,15,27,22
Eriksen,363,2,361,2019-05-04T11:30:00Z,False,16,1,90,2,70,37,33,42,26,16,28,7
Eriksen,363,2,378,2019-05-12T14:00:00Z,True,16,7,90,7,70,37,33,53,34,19,17,18
Alli,364,2,6,2018-08-11T11:30:00Z,False,16,14,79,9,0,0,0,0,0,0,0,0
Alli,364,2,18,2018-08-18T14:00:00Z,True,16,8,90,5,3,0,3,0,0,0,3,0
Alli,364,2,25,2018-08-27T19:00:00Z,False,16,13,90,3,6,3,3,3,3,0,3,0
Alli,364,2,38,2018-09-02T15:00:00Z,False,16,17,90,2,9,3,6,9,6,3,0,0
Alli,364,2,47,2018-09-15T11:30:00Z,True,16,11,0,0,9,3,6,12,6,6,-3,-3
Alli,364,2,51,2018-09-22T16:30:00Z,False,16,2,12,1,9,3,6,5,4,1,4,2
Alli,364,2,65,2018-09-29T14:00:00Z,False,16,9,0,0,12,3,9,2,1,1,10,8
Alli,364,2,78,2018-10-06T14:00:00Z,True,16,4,0,0,15,3,12,2,1,1,13,2
Alli,364,2,88,2018-10-20T14:00:00Z,False,16,18,0,0,18,6,12,7,4,3,11,8
Alli,364,2,98,2018-10-29T20:00:00Z,True,16,12,15,1,21,6,15,23,15,8,-2,-2
Alli,364,2,109,2018-11-03T19:45:00Z,False,16,19,0,0,21,6,15,15,8,7,6,7
Alli,364,2,113,2018-11-10T17:30:00Z,False,16,6,90,3,24,6,18,8,2,6,16,16
Alli,364,2,126,2018-11-24T17:30:00Z,True,16,5,86,13,27,6,21,28,15,13,-1,-7
Alli,364,2,130,2018-12-02T14:05:00Z,False,16,0,78,1,30,9,21,27,14,13,3,7
Alli,364,2,149,2018-12-05T20:00:00Z,True,16,15,11,1,30,9,21,9,5,4,21,5
Alli,364,2,156,2018-12-08T19:45:00Z,False,16,10,90,9,33,12,21,22,11,11,11,10
Alli,364,2,167,2018-12-15T15:00:00Z,True,16,3,90,3,36,12,24,12,7,5,24,7
Alli,364,2,174,2018-12-23T16:00:00Z,False,16,7,45,6,39,15,24,24,18,6,15,6
Alli,364,2,188,2018-12-26T15:00:00Z,True,16,1,0,0,42,15,27,26,17,9,16,6
Alli,364,2,198,2018-12-29T15:00:00Z,True,16,19,67,3,45,18,27,26,14,12,19,6
Alli,364,2,202,2019-01-01T17:30:00Z,False,16,4,85,3,45,18,27,18,13,5,27,14
Alli,364,2,218,2019-01-13T16:30:00Z,True,16,13,90,1,48,18,30,38,21,17,10,1
Alli,364,2,222,2019-01-20T16:00:00Z,False,16,8,85,9,48,18,30,14,12,2,34,18
Alli,364,2,239,2019-01-30T20:00:00Z,True,16,17,0,0,51,18,33,33,17,16,18,2
Alli,364,2,248,2019-02-02T12:30:00Z,True,16,14,0,0,54,21,33,24,13,11,30,10
Alli,364,2,257,2019-02-10T13:30:00Z,True,16,10,0,0,57,24,33,32,14,18,25,6
Alli,364,2,262,2019-02-23T12:30:00Z,False,16,3,0,0,60,27,33,27,14,13,33,19
Alli,364,2,275,2019-02-27T20:00:00Z,False,16,5,0,0,60,27,33,50,28,22,10,5
Alli,364,2,286,2019-03-02T12:30:00Z,True,16,0,0,0,60,27,33,56,38,18,4,9
Alli,364,2,299,2019-03-09T15:00:00Z,False,16,15,81,5,61,28,33,27,15,12,34,18
Alli,364,2,317,2019-03-31T15:30:00Z,False,16,11,90,2,61,28,33,76,41,35,-15,-8
Alli,364,2,306,2019-04-03T18:45:00Z,True,16,6,81,2,61,28,33,36,16,20,25,8
Alli,364,2,338,2019-04-13T11:30:00Z,True,16,9,0,0,64,31,33,14,8,6,50,25
Alli,364,2,346,2019-04-20T11:30:00Z,False,16,12,68,2,67,34,33,83,48,35,-16,-15
Alli,364,2,327,2019-04-23T18:45:00Z,True,16,2,90,6,67,34,33,34,22,12,33,22
Alli,364,2,358,2019-04-27T11:30:00Z,True,16,18,84,2,70,37,33,43,28,15,27,22
Alli,364,2,361,2019-05-04T11:30:00Z,False,16,1,90,1,70,37,33,42,26,16,28,7
Alli,364,2,378,2019-05-12T14:00:00Z,True,16,7,45,1,70,37,33,53,34,19,17,18
Wanyama,365,2,6,2018-08-11T11:30:00Z,False,16,14,0,0,0,0,0,0,0,0,0,0
Wanyama,365,2,18,2018-08-18T14:00:00Z,True,16,8,0,0,3,0,3,0,0,0,3,0
Wanyama,365,2,25,2018-08-27T19:00:00Z,False,16,13,0,0,6,3,3,3,3,0,3,0
Wanyama,365,2,38,2018-09-02T15:00:00Z,False,16,17,0,0,9,3,6,9,6,3,0,0
Wanyama,365,2,47,2018-09-15T11:30:00Z,True,16,11,7,1,9,3,6,12,6,6,-3,-3
Wanyama,365,2,51,2018-09-22T16:30:00Z,False,16,2,0,0,9,3,6,5,4,1,4,2
Wanyama,365,2,65,2018-09-29T14:00:00Z,False,16,9,45,1,12,3,9,2,1,1,10,8
Wanyama,365,2,78,2018-10-06T14:00:00Z,True,16,4,5,1,15,3,12,2,1,1,13,2
Wanyama,365,2,88,2018-10-20T14:00:00Z,False,16,18,0,0,18,6,12,7,4,3,11,8
Wanyama,365,2,98,2018-10-29T20:00:00Z,True,16,12,0,0,21,6,15,23,15,8,-2,-2
Wanyama,365,2,109,2018-11-03T19:45:00Z,False,16,19,0,0,21,6,15,15,8,7,6,7
Wanyama,365,2,113,2018-11-10T17:30:00Z,False,16,6,90,3,24,6,18,8,2,6,16,16
Wanyama,365,2,126,2018-11-24T17:30:00Z,True,16,5,0,0,27,6,21,28,15,13,-1,-7
Wanyama,365,2,130,2018-12-02T14:05:00Z,False,16,0,0,0,30,9,21,27,14,13,3,7
Wanyama,365,2,149,2018-12-05T20:00:00Z,True,16,15,0,0,30,9,21,9,5,4,21,5
Wanyama,365,2,156,2018-12-08T19:45:00Z,False,16,10,0,0,33,12,21,22,11,11,11,10
Wanyama,365,2,167,2018-12-15T15:00:00Z,True,16,3,0,0,36,12,24,12,7,5,24,7
Wanyama,365,2,174,2018-12-23T16:00:00Z,False,16,7,0,0,39,15,24,24,18,6,15,6
Wanyama,365,2,188,2018-12-26T15:00:00Z,True,16,1,0,0,42,15,27,26,17,9,16,6
Wanyama,365,2,198,2018-12-29T15:00:00Z,True,16,19,0,0,45,18,27,26,14,12,19,6
Wanyama,365,2,202,2019-01-01T17:30:00Z,False,16,4,0,0,45,18,27,18,13,5,27,14
Wanyama,365,2,218,2019-01-13T16:30:00Z,True,16,13,0,0,48,18,30,38,21,17,10,1
Wanyama,365,2,222,2019-01-20T16:00:00Z,False,16,8,0,0,48,18,30,14,12,2,34,18
Wanyama,365,2,239,2019-01-30T20:00:00Z,True,16,17,0,0,51,18,33,33,17,16,18,2
Wanyama,365,2,248,2019-02-02T12:30:00Z,True,16,14,0,0,54,21,33,24,13,11,30,10
Wanyama,365,2,257,2019-02-10T13:30:00Z,True,16,10,10,1,57,24,33,32,14,18,25,6
Wanyama,365,2,262,2019-02-23T12:30:00Z,False,16,3,0,0,60,27,33,27,14,13,33,19
Wanyama,365,2,275,2019-02-27T20:00:00Z,False,16,5,0,0,60,27,33,50,28,22,10,5
Wanyama,365,2,286,2019-03-02T12:30:00Z,True,16,0,58,1,60,27,33,56,38,18,4,9
Wanyama,365,2,299,2019-03-09T15:00:00Z,False,16,15,0,0,61,28,33,27,15,12,34,18
Wanyama,365,2,317,2019-03-31T15:30:00Z,False,16,11,0,0,61,28,33,76,41,35,-15,-8
Wanyama,365,2,306,2019-04-03T18:45:00Z,True,16,6,1,1,61,28,33,36,16,20,25,8
Wanyama,365,2,338,2019-04-13T11:30:00Z,True,16,9,90,10,64,31,33,14,8,6,50,25
Wanyama,365,2,346,2019-04-20T11:30:00Z,False,16,12,29,0,67,34,33,83,48,35,-16,-15
Wanyama,365,2,327,2019-04-23T18:45:00Z,True,16,2,81,3,67,34,33,34,22,12,33,22
Wanyama,365,2,358,2019-04-27T11:30:00Z,True,16,18,5,1,70,37,33,43,28,15,27,22
Wanyama,365,2,361,2019-05-04T11:30:00Z,False,16,1,45,0,70,37,33,42,26,16,28,7
Wanyama,365,2,378,2019-05-12T14:00:00Z,True,16,7,45,1,70,37,33,53,34,19,17,18
Son,366,2,6,2018-08-11T11:30:00Z,False,16,14,10,1,0,0,0,0,0,0,0,0
Son,366,2,18,2018-08-18T14:00:00Z,True,16,8,0,0,3,0,3,0,0,0,3,0
Son,366,2,25,2018-08-27T19:00:00Z,False,16,13,0,0,6,3,3,3,3,0,3,0
Son,366,2,38,2018-09-02T15:00:00Z,False,16,17,0,0,9,3,6,9,6,3,0,0
Son,366,2,47,2018-09-15T11:30:00Z,True,16,11,17,1,9,3,6,12,6,6,-3,-3
Son,366,2,51,2018-09-22T16:30:00Z,False,16,2,67,3,9,3,6,5,4,1,4,2
Son,366,2,65,2018-09-29T14:00:00Z,False,16,9,89,3,12,3,9,2,1,1,10,8
Son,366,2,78,2018-10-06T14:00:00Z,True,16,4,71,3,15,3,12,2,1,1,13,2
Son,366,2,88,2018-10-20T14:00:00Z,False,16,18,0,0,18,6,12,7,4,3,11,8
Son,366,2,98,2018-10-29T20:00:00Z,True,16,12,0,0,21,6,15,23,15,8,-2,-2
Son,366,2,109,2018-11-03T19:45:00Z,False,16,19,51,4,21,6,15,15,8,7,6,7
Son,366,2,113,2018-11-10T17:30:00Z,False,16,6,19,1,24,6,18,8,2,6,16,16
Son,366,2,126,2018-11-24T17:30:00Z,True,16,5,77,8,27,6,21,28,15,13,-1,-7
Son,366,2,130,2018-12-02T14:05:00Z,False,16,0,78,5,30,9,21,27,14,13,3,7
Son,366,2,149,2018-12-05T20:00:00Z,True,16,15,90,8,30,9,21,9,5,4,21,5
Son,366,2,156,2018-12-08T19:45:00Z,False,16,10,73,14,33,12,21,22,11,11,11,10
Son,366,2,167,2018-12-15T15:00:00Z,True,16,3,15,1,36,12,24,12,7,5,24,7
Son,366,2,174,2018-12-23T16:00:00Z,False,16,7,78,21,39,15,24,24,18,6,15,6
Son,366,2,188,2018-12-26T15:00:00Z,True,16,1,87,13,42,15,27,26,17,9,16,6
Son,366,2,198,2018-12-29T15:00:00Z,True,16,19,90,5,45,18,27,26,14,12,19,6
Son,366,2,202,2019-01-01T17:30:00Z,False,16,4,75,13,45,18,27,18,13,5,27,14
Son,366,2,218,2019-01-13T16:30:00Z,True,16,13,90,2,48,18,30,38,21,17,10,1
Son,366,2,222,2019-01-20T16:00:00Z,False,16,8,0,0,48,18,30,14,12,2,34,18
Son,366,2,239,2019-01-30T20:00:00Z,True,16,17,90,9,51,18,33,33,17,16,18,2
Son,366,2,248,2019-02-02T12:30:00Z,True,16,14,88,11,54,21,33,24,13,11,30,10
Son,366,2,257,2019-02-10T13:30:00Z,True,16,10,90,6,57,24,33,32,14,18,25,6
Son,366,2,262,2019-02-23T12:30:00Z,False,16,3,87,2,60,27,33,27,14,13,33,19
Son,366,2,275,2019-02-27T20:00:00Z,False,16,5,79,2,60,27,33,50,28,22,10,5
Son,366,2,286,2019-03-02T12:30:00Z,True,16,0,78,2,60,27,33,56,38,18,4,9
Son,366,2,299,2019-03-09T15:00:00Z,False,16,15,18,1,61,28,33,27,15,12,34,18
Son,366,2,317,2019-03-31T15:30:00Z,False,16,11,21,1,61,28,33,76,41,35,-15,-8
Son,366,2,306,2019-04-03T18:45:00Z,True,16,6,90,10,61,28,33,36,16,20,25,8
Son,366,2,338,2019-04-13T11:30:00Z,True,16,9,3,4,64,31,33,14,8,6,50,25
Son,366,2,346,2019-04-20T11:30:00Z,False,16,12,90,2,67,34,33,83,48,35,-16,-15
Son,366,2,327,2019-04-23T18:45:00Z,True,16,2,89,3,67,34,33,34,22,12,33,22
Son,366,2,358,2019-04-27T11:30:00Z,True,16,18,90,2,70,37,33,43,28,15,27,22
Son,366,2,361,2019-05-04T11:30:00Z,False,16,1,43,-2,70,37,33,42,26,16,28,7
Son,366,2,378,2019-05-12T14:00:00Z,True,16,7,0,0,70,37,33,53,34,19,17,18
Winks,367,2,6,2018-08-11T11:30:00Z,False,16,14,0,0,0,0,0,0,0,0,0,0
Winks,367,2,18,2018-08-18T14:00:00Z,True,16,8,1,1,3,0,3,0,0,0,3,0
Winks,367,2,25,2018-08-27T19:00:00Z,False,16,13,1,1,6,3,3,3,3,0,3,0
Winks,367,2,38,2018-09-02T15:00:00Z,False,16,17,4,1,9,3,6,9,6,3,0,0
Winks,367,2,47,2018-09-15T11:30:00Z,True,16,11,72,2,9,3,6,12,6,6,-3,-3
Winks,367,2,51,2018-09-22T16:30:00Z,False,16,2,0,0,9,3,6,5,4,1,4,2
Winks,367,2,65,2018-09-29T14:00:00Z,False,16,9,45,0,12,3,9,2,1,1,10,8
Winks,367,2,78,2018-10-06T14:00:00Z,True,16,4,90,3,15,3,12,2,1,1,13,2
Winks,367,2,88,2018-10-20T14:00:00Z,False,16,18,90,3,18,6,12,7,4,3,11,8
Winks,367,2,98,2018-10-29T20:00:00Z,True,16,12,23,1,21,6,15,23,15,8,-2,-2
Winks,367,2,109,2018-11-03T19:45:00Z,False,16,19,90,1,21,6,15,15,8,7,6,7
Winks,367,2,113,2018-11-10T17:30:00Z,False,16,6,7,0,24,6,18,8,2,6,16,16
Winks,367,2,126,2018-11-24T17:30:00Z,True,16,5,3,1,27,6,21,28,15,13,-1,-7
Winks,367,2,130,2018-12-02T14:05:00Z,False,16,0,11,1,30,9,21,27,14,13,3,7
Winks,367,2,149,2018-12-05T20:00:00Z,True,16,15,90,2,30,9,21,9,5,4,21,5
Winks,367,2,156,2018-12-08T19:45:00Z,False,16,10,90,3,33,12,21,22,11,11,11,10
Winks,367,2,167,2018-12-15T15:00:00Z,True,16,3,0,0,36,12,24,12,7,5,24,7
Winks,367,2,174,2018-12-23T16:00:00Z,False,16,7,90,2,39,15,24,24,18,6,15,6
Winks,367,2,188,2018-12-26T15:00:00Z,True,16,1,90,2,42,15,27,26,17,9,16,6
Winks,367,2,198,2018-12-29T15:00:00Z,True,16,19,90,2,45,18,27,26,14,12,19,6
Winks,367,2,202,2019-01-01T17:30:00Z,False,16,4,90,3,45,18,27,18,13,5,27,14
Winks,367,2,218,2019-01-13T16:30:00Z,True,16,13,80,2,48,18,30,38,21,17,10,1
Winks,367,2,222,2019-01-20T16:00:00Z,False,16,8,90,10,48,18,30,14,12,2,34,18
Winks,367,2,239,2019-01-30T20:00:00Z,True,16,17,90,2,51,18,33,33,17,16,18,2
Winks,367,2,248,2019-02-02T12:30:00Z,True,16,14,90,3,54,21,33,24,13,11,30,10
Winks,367,2,257,2019-02-10T13:30:00Z,True,16,10,90,2,57,24,33,32,14,18,25,6
Winks,367,2,262,2019-02-23T12:30:00Z,False,16,3,61,2,60,27,33,27,14,13,33,19
Winks,367,2,275,2019-02-27T20:00:00Z,False,16,5,90,2,60,27,33,50,28,22,10,5
Winks,367,2,286,2019-03-02T12:30:00Z,True,16,0,0,0,60,27,33,56,38,18,4,9
Winks,367,2,299,2019-03-09T15:00:00Z,False,16,15,0,0,61,28,33,27,15,12,34,18
Winks,367,2,317,2019-03-31T15:30:00Z,False,16,11,0,0,61,28,33,76,41,35,-15,-8
Winks,367,2,306,2019-04-03T18:45:00Z,True,16,6,21,1,61,28,33,36,16,20,25,8
Winks,367,2,338,2019-04-13T11:30:00Z,True,16,9,0,0,64,31,33,14,8,6,50,25
Winks,367,2,346,2019-04-20T11:30:00Z,False,16,12,0,0,67,34,33,83,48,35,-16,-15
Winks,367,2,327,2019-04-23T18:45:00Z,True,16,2,0,0,67,34,33,34,22,12,33,22
Winks,367,2,358,2019-04-27T11:30:00Z,True,16,18,0,0,70,37,33,43,28,15,27,22
Winks,367,2,361,2019-05-04T11:30:00Z,False,16,1,0,0,70,37,33,42,26,16,28,7
Winks,367,2,378,2019-05-12T14:00:00Z,True,16,7,0,0,70,37,33,53,34,19,17,18
Sissoko,368,2,6,2018-08-11T11:30:00Z,False,16,14,90,2,0,0,0,0,0,0,0,0
Sissoko,368,2,18,2018-08-18T14:00:00Z,True,16,8,0,0,3,0,3,0,0,0,3,0
Sissoko,368,2,25,2018-08-27T19:00:00Z,False,16,13,0,0,6,3,3,3,3,0,3,0
Sissoko,368,2,38,2018-09-02T15:00:00Z,False,16,17,0,0,9,3,6,9,6,3,0,0
Sissoko,368,2,47,2018-09-15T11:30:00Z,True,16,11,0,0,9,3,6,12,6,6,-3,-3
Sissoko,368,2,51,2018-09-22T16:30:00Z,False,16,2,0,0,9,3,6,5,4,1,4,2
Sissoko,368,2,65,2018-09-29T14:00:00Z,False,16,9,1,1,12,3,9,2,1,1,10,8
Sissoko,368,2,78,2018-10-06T14:00:00Z,True,16,4,84,3,15,3,12,2,1,1,13,2
Sissoko,368,2,88,2018-10-20T14:00:00Z,False,16,18,88,8,18,6,12,7,4,3,11,8
Sissoko,368,2,98,2018-10-29T20:00:00Z,True,16,12,90,2,21,6,15,23,15,8,-2,-2
Sissoko,368,2,109,2018-11-03T19:45:00Z,False,16,19,90,2,21,6,15,15,8,7,6,7
Sissoko,368,2,113,2018-11-10T17:30:00Z,False,16,6,90,3,24,6,18,8,2,6,16,16
Sissoko,368,2,126,2018-11-24T17:30:00Z,True,16,5,90,2,27,6,21,28,15,13,-1,-7
Sissoko,368,2,130,2018-12-02T14:05:00Z,False,16,0,90,2,30,9,21,27,14,13,3,7
Sissoko,368,2,149,2018-12-05T20:00:00Z,True,16,15,16,1,30,9,21,9,5,4,21,5
Sissoko,368,2,156,2018-12-08T19:45:00Z,False,16,10,90,3,33,12,21,22,11,11,11,10
Sissoko,368,2,167,2018-12-15T15:00:00Z,True,16,3,90,3,36,12,24,12,7,5,24,7
Sissoko,368,2,174,2018-12-23T16:00:00Z,False,16,7,82,2,39,15,24,24,18,6,15,6
Sissoko,368,2,188,2018-12-26T15:00:00Z,True,16,1,90,3,42,15,27,26,17,9,16,6
Sissoko,368,2,198,2018-12-29T15:00:00Z,True,16,19,90,2,45,18,27,26,14,12,19,6
Sissoko,368,2,202,2019-01-01T17:30:00Z,False,16,4,90,3,45,18,27,18,13,5,27,14
Sissoko,368,2,218,2019-01-13T16:30:00Z,True,16,13,42,1,48,18,30,38,21,17,10,1
Sissoko,368,2,222,2019-01-20T16:00:00Z,False,16,8,0,0,48,18,30,14,12,2,34,18
Sissoko,368,2,239,2019-01-30T20:00:00Z,True,16,17,68,2,51,18,33,33,17,16,18,2
Sissoko,368,2,248,2019-02-02T12:30:00Z,True,16,14,90,3,54,21,33,24,13,11,30,10
Sissoko,368,2,257,2019-02-10T13:30:00Z,True,16,10,90,6,57,24,33,32,14,18,25,6
Sissoko,368,2,262,2019-02-23T12:30:00Z,False,16,3,90,2,60,27,33,27,14,13,33,19
Sissoko,368,2,275,2019-02-27T20:00:00Z,False,16,5,84,2,60,27,33,50,28,22,10,5
Sissoko,368,2,286,2019-03-02T12:30:00Z,True,16,0,90,2,60,27,33,56,38,18,4,9
Sissoko,368,2,299,2019-03-09T15:00:00Z,False,16,15,90,1,61,28,33,27,15,12,34,18
Sissoko,368,2,317,2019-03-31T15:30:00Z,False,16,11,90,2,61,28,33,76,41,35,-15,-8
Sissoko,368,2,306,2019-04-03T18:45:00Z,True,16,6,90,3,61,28,33,36,16,20,25,8
Sissoko,368,2,338,2019-04-13T11:30:00Z,True,16,9,73,6,64,31,33,14,8,6,50,25
Sissoko,368,2,346,2019-04-20T11:30:00Z,False,16,12,0,0,67,34,33,83,48,35,-16,-15
Sissoko,368,2,327,2019-04-23T18:45:00Z,True,16,2,0,0,67,34,33,34,22,12,33,22
Sissoko,368,2,358,2019-04-27T11:30:00Z,True,16,18,0,0,70,37,33,43,28,15,27,22
Sissoko,368,2,361,2019-05-04T11:30:00Z,False,16,1,81,2,70,37,33,42,26,16,28,7
Sissoko,368,2,378,2019-05-12T14:00:00Z,True,16,7,90,2,70,37,33,53,34,19,17,18
Lucas Moura,369,2,6,2018-08-11T11:30:00Z,False,16,14,67,2,0,0,0,0,0,0,0,0
Lucas Moura,369,2,18,2018-08-18T14:00:00Z,True,16,8,90,7,3,0,3,0,0,0,3,0
Lucas Moura,369,2,25,2018-08-27T19:00:00Z,False,16,13,90,15,6,3,3,3,3,0,3,0
Lucas Moura,369,2,38,2018-09-02T15:00:00Z,False,16,17,90,5,9,3,6,9,6,3,0,0
Lucas Moura,369,2,47,2018-09-15T11:30:00Z,True,16,11,90,2,9,3,6,12,6,6,-3,-3
Lucas Moura,369,2,51,2018-09-22T16:30:00Z,False,16,2,77,3,9,3,6,5,4,1,4,2
Lucas Moura,369,2,65,2018-09-29T14:00:00Z,False,16,9,90,3,12,3,9,2,1,1,10,8
Lucas Moura,369,2,78,2018-10-06T14:00:00Z,True,16,4,90,3,15,3,12,2,1,1,13,2
Lucas Moura,369,2,88,2018-10-20T14:00:00Z,False,16,18,90,3,18,6,12,7,4,3,11,8
Lucas Moura,369,2,98,2018-10-29T20:00:00Z,True,16,12,80,1,21,6,15,23,15,8,-2,-2
Lucas Moura,369,2,109,2018-11-03T19:45:00Z,False,16,19,78,9,21,6,15,15,8,7,6,7
Lucas Moura,369,2,113,2018-11-10T17:30:00Z,False,16,6,70,3,24,6,18,8,2,6,16,16
Lucas Moura,369,2,126,2018-11-24T17:30:00Z,True,16,5,0,0,27,6,21,28,15,13,-1,-7
Lucas Moura,369,2,130,2018-12-02T14:05:00Z,False,16,0,11,1,30,9,21,27,14,13,3,7
Lucas Moura,369,2,149,2018-12-05T20:00:00Z,True,16,15,73,8,30,9,21,9,5,4,21,5
Lucas Moura,369,2,156,2018-12-08T19:45:00Z,False,16,10,66,3,33,12,21,22,11,11,11,10
Lucas Moura,369,2,167,2018-12-15T15:00:00Z,True,16,3,64,3,36,12,24,12,7,5,24,7
Lucas Moura,369,2,174,2018-12-23T16:00:00Z,False,16,7,7,1,39,15,24,24,18,6,15,6
Lucas Moura,369,2,188,2018-12-26T15:00:00Z,True,16,1,90,11,42,15,27,26,17,9,16,6
Lucas Moura,369,2,198,2018-12-29T15:00:00Z,True,16,19,22,1,45,18,27,26,14,12,19,6
Lucas Moura,369,2,202,2019-01-01T17:30:00Z,False,16,4,0,0,45,18,27,18,13,5,27,14
Lucas Moura,369,2,218,2019-01-13T16:30:00Z,True,16,13,0,0,48,18,30,38,21,17,10,1
Lucas Moura,369,2,222,2019-01-20T16:00:00Z,False,16,8,0,0,48,18,30,14,12,2,34,18
Lucas Moura,369,2,239,2019-01-30T20:00:00Z,True,16,17,45,1,51,18,33,33,17,16,18,2
Lucas Moura,369,2,248,2019-02-02T12:30:00Z,True,16,14,59,1,54,21,33,24,13,11,30,10
Lucas Moura,369,2,257,2019-02-10T13:30:00Z,True,16,10,0,0,57,24,33,32,14,18,25,6
Lucas Moura,369,2,262,2019-02-23T12:30:00Z,False,16,3,2,1,60,27,33,27,14,13,33,19
Lucas Moura,369,2,275,2019-02-27T20:00:00Z,False,16,5,10,1,60,27,33,50,28,22,10,5
Lucas Moura,369,2,286,2019-03-02T12:30:00Z,True,16,0,0,0,60,27,33,56,38,18,4,9
Lucas Moura,369,2,299,2019-03-09T15:00:00Z,False,16,15,71,3,61,28,33,27,15,12,34,18
Lucas Moura,369,2,317,2019-03-31T15:30:00Z,False,16,11,81,6,61,28,33,76,41,35,-15,-8
Lucas Moura,369,2,306,2019-04-03T18:45:00Z,True,16,6,8,1,61,28,33,36,16,20,25,8
Lucas Moura,369,2,338,2019-04-13T11:30:00Z,True,16,9,90,21,64,31,33,14,8,6,50,25
Lucas Moura,369,2,346,2019-04-20T11:30:00Z,False,16,12,90,2,67,34,33,83,48,35,-16,-15
Lucas Moura,369,2,327,2019-04-23T18:45:00Z,True,16,2,79,3,67,34,33,34,22,12,33,22
Lucas Moura,369,2,358,2019-04-27T11:30:00Z,True,16,18,65,3,70,37,33,43,28,15,27,22
Lucas Moura,369,2,361,2019-05-04T11:30:00Z,False,16,1,90,2,70,37,33,42,26,16,28,7
Lucas Moura,369,2,378,2019-05-12T14:00:00Z,True,16,7,90,2,70,37,33,53,34,19,17,18
Llorente,370,3,6,2018-08-11T11:30:00Z,False,16,14,0,0,0,0,0,0,0,0,0,0
Llorente,370,3,18,2018-08-18T14:00:00Z,True,16,8,0,0,3,0,3,0,0,0,3,0
Llorente,370,3,25,2018-08-27T19:00:00Z,False,16,13,0,0,6,3,3,3,3,0,3,0
Llorente,370,3,38,2018-09-02T15:00:00Z,False,16,17,9,1,9,3,6,9,6,3,0,0
Llorente,370,3,47,2018-09-15T11:30:00Z,True,16,11,0,0,9,3,6,12,6,6,-3,-3
Llorente,370,3,51,2018-09-22T16:30:00Z,False,16,2,0,0,9,3,6,5,4,1,4,2
Llorente,370,3,65,2018-09-29T14:00:00Z,False,16,9,0,0,12,3,9,2,1,1,10,8
Llorente,370,3,78,2018-10-06T14:00:00Z,True,16,4,0,0,15,3,12,2,1,1,13,2
Llorente,370,3,88,2018-10-20T14:00:00Z,False,16,18,4,1,18,6,12,7,4,3,11,8
Llorente,370,3,98,2018-10-29T20:00:00Z,True,16,12,0,0,21,6,15,23,15,8,-2,-2
Llorente,370,3,109,2018-11-03T19:45:00Z,False,16,19,0,0,21,6,15,15,8,7,6,7
Llorente,370,3,113,2018-11-10T17:30:00Z,False,16,6,0,0,24,6,18,8,2,6,16,16
Llorente,370,3,126,2018-11-24T17:30:00Z,True,16,5,0,0,27,6,21,28,15,13,-1,-7
Llorente,370,3,130,2018-12-02T14:05:00Z,False,16,0,0,0,30,9,21,27,14,13,3,7
Llorente,370,3,149,2018-12-05T20:00:00Z,True,16,15,0,0,30,9,21,9,5,4,21,5
Llorente,370,3,156,2018-12-08T19:45:00Z,False,16,10,0,0,33,12,21,22,11,11,11,10
Llorente,370,3,167,2018-12-15T15:00:00Z,True,16,3,8,1,36,12,24,12,7,5,24,7
Llorente,370,3,174,2018-12-23T16:00:00Z,False,16,7,0,0,39,15,24,24,18,6,15,6
Llorente,370,3,188,2018-12-26T15:00:00Z,True,16,1,2,1,42,15,27,26,17,9,16,6
Llorente,370,3,198,2018-12-29T15:00:00Z,True,16,19,0,0,45,18,27,26,14,12,19,6
Llorente,370,3,202,2019-01-01T17:30:00Z,False,16,4,4,1,45,18,27,18,13,5,27,14
Llorente,370,3,218,2019-01-13T16:30:00Z,True,16,13,9,1,48,18,30,38,21,17,10,1
Llorente,370,3,222,2019-01-20T16:00:00Z,False,16,8,90,0,48,18,30,14,12,2,34,18
Llorente,370,3,239,2019-01-30T20:00:00Z,True,16,17,90,12,51,18,33,33,17,16,18,2
Llorente,370,3,248,2019-02-02T12:30:00Z,True,16,14,30,4,54,21,33,24,13,11,30,10
Llorente,370,3,257,2019-02-10T13:30:00Z,True,16,10,79,5,57,24,33,32,14,18,25,6
Llorente,370,3,262,2019-02-23T12:30:00Z,False,16,3,28,0,60,27,33,27,14,13,33,19
Llorente,370,3,275,2019-02-27T20:00:00Z,False,16,5,20,1,60,27,33,50,28,22,10,5
Llorente,370,3,286,2019-03-02T12:30:00Z,True,16,0,11,0,60,27,33,56,38,18,4,9
Llorente,370,3,299,2019-03-09T15:00:00Z,False,16,15,8,1,61,28,33,27,15,12,34,18
Llorente,370,3,317,2019-03-31T15:30:00Z,False,16,11,1,1,61,28,33,76,41,35,-15,-8
Llorente,370,3,306,2019-04-03T18:45:00Z,True,16,6,0,0,61,28,33,36,16,20,25,8
Llorente,370,3,338,2019-04-13T11:30:00Z,True,16,9,86,5,64,31,33,14,8,6,50,25
Llorente,370,3,346,2019-04-20T11:30:00Z,False,16,12,12,1,67,34,33,83,48,35,-16,-15
Llorente,370,3,327,2019-04-23T18:45:00Z,True,16,2,90,2,67,34,33,34,22,12,33,22
Llorente,370,3,358,2019-04-27T11:30:00Z,True,16,18,24,1,70,37,33,43,28,15,27,22
Llorente,370,3,361,2019-05-04T11:30:00Z,False,16,1,0,0,70,37,33,42,26,16,28,7
Llorente,370,3,378,2019-05-12T14:00:00Z,True,16,7,76,2,70,37,33,53,34,19,17,18
Kane,371,3,6,2018-08-11T11:30:00Z,False,16,14,90,1,0,0,0,0,0,0,0,0
Kane,371,3,18,2018-08-18T14:00:00Z,True,16,8,88,7,3,0,3,0,0,0,3,0
Kane,371,3,25,2018-08-27T19:00:00Z,False,16,13,88,10,6,3,3,3,3,0,3,0
Kane,371,3,38,2018-09-02T15:00:00Z,False,16,17,90,2,9,3,6,9,6,3,0,0
Kane,371,3,47,2018-09-15T11:30:00Z,True,16,11,90,2,9,3,6,12,6,6,-3,-3
Kane,371,3,51,2018-09-22T16:30:00Z,False,16,2,90,9,9,3,6,5,4,1,4,2
Kane,371,3,65,2018-09-29T14:00:00Z,False,16,9,90,13,12,3,9,2,1,1,10,8
Kane,371,3,78,2018-10-06T14:00:00Z,True,16,4,90,1,15,3,12,2,1,1,13,2
Kane,371,3,88,2018-10-20T14:00:00Z,False,16,18,85,2,18,6,12,7,4,3,11,8
Kane,371,3,98,2018-10-29T20:00:00Z,True,16,12,90,2,21,6,15,23,15,8,-2,-2
Kane,371,3,109,2018-11-03T19:45:00Z,False,16,19,90,7,21,6,15,15,8,7,6,7
Kane,371,3,113,2018-11-10T17:30:00Z,False,16,6,90,5,24,6,18,8,2,6,16,16
Kane,371,3,126,2018-11-24T17:30:00Z,True,16,5,90,6,27,6,21,28,15,13,-1,-7
Kane,371,3,130,2018-12-02T14:05:00Z,False,16,0,90,6,30,9,21,27,14,13,3,7
Kane,371,3,149,2018-12-05T20:00:00Z,True,16,15,90,12,30,9,21,9,5,4,21,5
Kane,371,3,156,2018-12-08T19:45:00Z,False,16,10,16,1,33,12,21,22,11,11,11,10
Kane,371,3,167,2018-12-15T15:00:00Z,True,16,3,90,5,36,12,24,12,7,5,24,7
Kane,371,3,174,2018-12-23T16:00:00Z,False,16,7,90,15,39,15,24,24,18,6,15,6
Kane,371,3,188,2018-12-26T15:00:00Z,True,16,1,76,6,42,15,27,26,17,9,16,6
Kane,371,3,198,2018-12-29T15:00:00Z,True,16,19,90,6,45,18,27,26,14,12,19,6
Kane,371,3,202,2019-01-01T17:30:00Z,False,16,4,90,12,45,18,27,18,13,5,27,14
Kane,371,3,218,2019-01-13T16:30:00Z,True,16,13,90,2,48,18,30,38,21,17,10,1
Kane,371,3,222,2019-01-20T16:00:00Z,False,16,8,0,0,48,18,30,14,12,2,34,18
Kane,371,3,239,2019-01-30T20:00:00Z,True,16,17,0,0,51,18,33,33,17,16,18,2
Kane,371,3,248,2019-02-02T12:30:00Z,True,16,14,0,0,54,21,33,24,13,11,30,10
Kane,371,3,257,2019-02-10T13:30:00Z,True,16,10,0,0,57,24,33,32,14,18,25,6
Kane,371,3,262,2019-02-23T12:30:00Z,False,16,3,90,8,60,27,33,27,14,13,33,19
Kane,371,3,275,2019-02-27T20:00:00Z,False,16,5,90,1,60,27,33,50,28,22,10,5
Kane,371,3,286,2019-03-02T12:30:00Z,True,16,0,90,7,60,27,33,56,38,18,4,9
Kane,371,3,299,2019-03-09T15:00:00Z,False,16,15,90,8,61,28,33,27,15,12,34,18
Kane,371,3,317,2019-03-31T15:30:00Z,False,16,11,90,2,61,28,33,76,41,35,-15,-8
Kane,371,3,306,2019-04-03T18:45:00Z,True,16,6,90,2,61,28,33,36,16,20,25,8
Kane,371,3,338,2019-04-13T11:30:00Z,True,16,9,0,0,64,31,33,14,8,6,50,25
Kane,371,3,346,2019-04-20T11:30:00Z,False,16,12,0,0,67,34,33,83,48,35,-16,-15
Kane,371,3,327,2019-04-23T18:45:00Z,True,16,2,0,0,67,34,33,34,22,12,33,22
Kane,371,3,358,2019-04-27T11:30:00Z,True,16,18,0,0,70,37,33,43,28,15,27,22
Kane,371,3,361,2019-05-04T11:30:00Z,False,16,1,0,0,70,37,33,42,26,16,28,7
Kane,371,3,378,2019-05-12T14:00:00Z,True,16,7,0,0,70,37,33,53,34,19,17,18
Gomes,372,0,8,2018-08-11T14:00:00Z,True,17,2,0,0,0,0,0,0,0,0,0,0
Gomes,372,0,11,2018-08-19T12:30:00Z,False,17,3,0,0,3,3,0,1,0,1,2,0
Gomes,372,0,28,2018-08-26T12:30:00Z,True,17,6,0,0,6,3,3,3,0,3,3,0
Gomes,372,0,38,2018-09-02T15:00:00Z,True,17,16,0,0,9,6,3,9,3,6,0,0
Gomes,372,0,48,2018-09-15T16:30:00Z,True,17,13,0,0,12,9,3,6,3,3,6,6
Gomes,372,0,55,2018-09-22T11:30:00Z,False,17,8,0,0,12,9,3,4,3,1,8,0
Gomes,372,0,60,2018-09-29T14:00:00Z,False,17,0,0,0,13,9,4,12,6,6,1,-2
Gomes,372,0,79,2018-10-06T14:00:00Z,True,17,1,0,0,13,9,4,13,10,3,0,6
Gomes,372,0,89,2018-10-20T14:00:00Z,False,17,19,0,0,13,9,4,15,8,7,-2,-4
Gomes,372,0,99,2018-10-27T14:00:00Z,True,17,9,0,0,16,9,7,3,1,2,13,7
Gomes,372,0,107,2018-11-03T15:00:00Z,False,17,14,0,0,19,12,7,3,0,3,16,7
Gomes,372,0,119,2018-11-10T15:00:00Z,False,17,15,0,0,19,12,7,7,3,4,12,4
Gomes,372,0,127,2018-11-24T15:00:00Z,True,17,11,0,0,20,12,8,30,16,14,-10,-2
Gomes,372,0,135,2018-12-01T15:00:00Z,False,17,10,0,0,20,12,8,18,8,10,2,0
Gomes,372,0,145,2018-12-04T20:00:00Z,True,17,12,0,0,20,12,8,38,24,14,-18,-2
Gomes,372,0,155,2018-12-10T20:00:00Z,False,17,7,0,0,20,12,8,23,17,6,-3,-9
Gomes,372,0,168,2018-12-15T15:00:00Z,True,17,4,0,0,21,12,9,14,13,1,7,11
Gomes,372,0,178,2018-12-22T15:00:00Z,False,17,18,0,0,24,15,9,24,13,11,0,-4
Gomes,372,0,189,2018-12-26T19:30:00Z,True,17,5,0,0,27,15,12,37,21,16,-10,-1
Gomes,372,0,199,2018-12-29T15:00:00Z,True,17,14,0,0,27,15,12,17,7,10,10,5
Gomes,372,0,201,2019-01-02T19:45:00Z,False,17,1,0,0,28,16,12,26,17,9,2,-5
Gomes,372,0,214,2019-01-12T15:00:00Z,False,17,6,0,0,29,16,13,22,9,13,7,4
Gomes,372,0,228,2019-01-19T15:00:00Z,True,17,3,0,0,32,16,16,21,13,8,11,8
Gomes,372,0,239,2019-01-30T20:00:00Z,False,17,16,0,0,33,17,16,51,18,33,-18,-2
Gomes,372,0,240,2019-02-02T15:00:00Z,False,17,2,0,0,33,17,16,26,18,8,7,-2
Gomes,372,0,258,2019-02-09T15:00:00Z,True,17,7,0,0,34,17,17,33,21,12,1,5
Gomes,372,0,263,2019-02-22T19:45:00Z,False,17,4,0,0,37,20,17,25,17,8,12,0
Gomes,372,0,276,2019-02-27T20:00:00Z,False,17,11,0,0,40,20,20,66,35,31,-26,-15
Gomes,372,0,287,2019-03-03T12:00:00Z,True,17,10,0,0,40,20,20,35,17,18,5,2
Gomes,372,0,297,2019-03-09T17:30:00Z,False,17,12,0,0,43,23,20,71,42,29,-28,-22
Gomes,372,0,318,2019-03-30T15:00:00Z,False,17,13,0,0,43,23,20,58,29,29,-15,-9
Gomes,372,0,328,2019-04-02T18:45:00Z,True,17,8,0,0,43,23,20,17,15,2,26,21
Gomes,372,0,339,2019-04-15T19:00:00Z,True,17,0,0,0,46,26,20,63,44,19,-17,7
Gomes,372,0,345,2019-04-20T14:00:00Z,False,17,9,0,0,46,26,20,14,8,6,32,12
Gomes,372,0,307,2019-04-23T18:45:00Z,True,17,15,0,0,49,26,23,36,21,15,13,11
Gomes,372,0,359,2019-04-27T14:00:00Z,True,17,19,0,0,50,27,23,51,31,20,-1,7
Gomes,372,0,363,2019-05-05T13:00:00Z,False,17,5,0,0,50,27,23,68,39,29,-18,-16
Gomes,372,0,379,2019-05-12T14:00:00Z,True,17,18,0,0,50,27,23,49,31,18,1,9
Dahlberg,373,0,8,2018-08-11T14:00:00Z,True,17,2,0,0,0,0,0,0,0,0,0,0
Dahlberg,373,0,11,2018-08-19T12:30:00Z,False,17,3,0,0,3,3,0,1,0,1,2,0
Dahlberg,373,0,28,2018-08-26T12:30:00Z,True,17,6,0,0,6,3,3,3,0,3,3,0
Dahlberg,373,0,38,2018-09-02T15:00:00Z,True,17,16,0,0,9,6,3,9,3,6,0,0
Dahlberg,373,0,48,2018-09-15T16:30:00Z,True,17,13,0,0,12,9,3,6,3,3,6,6
Dahlberg,373,0,55,2018-09-22T11:30:00Z,False,17,8,0,0,12,9,3,4,3,1,8,0
Dahlberg,373,0,60,2018-09-29T14:00:00Z,False,17,0,0,0,13,9,4,12,6,6,1,-2
Dahlberg,373,0,79,2018-10-06T14:00:00Z,True,17,1,0,0,13,9,4,13,10,3,0,6
Dahlberg,373,0,89,2018-10-20T14:00:00Z,False,17,19,0,0,13,9,4,15,8,7,-2,-4
Dahlberg,373,0,99,2018-10-27T14:00:00Z,True,17,9,0,0,16,9,7,3,1,2,13,7
Dahlberg,373,0,107,2018-11-03T15:00:00Z,False,17,14,0,0,19,12,7,3,0,3,16,7
Dahlberg,373,0,119,2018-11-10T15:00:00Z,False,17,15,0,0,19,12,7,7,3,4,12,4
Dahlberg,373,0,127,2018-11-24T15:00:00Z,True,17,11,0,0,20,12,8,30,16,14,-10,-2
Dahlberg,373,0,135,2018-12-01T15:00:00Z,False,17,10,0,0,20,12,8,18,8,10,2,0
Dahlberg,373,0,145,2018-12-04T20:00:00Z,True,17,12,0,0,20,12,8,38,24,14,-18,-2
Dahlberg,373,0,155,2018-12-10T20:00:00Z,False,17,7,0,0,20,12,8,23,17,6,-3,-9
Dahlberg,373,0,168,2018-12-15T15:00:00Z,True,17,4,0,0,21,12,9,14,13,1,7,11
Dahlberg,373,0,178,2018-12-22T15:00:00Z,False,17,18,0,0,24,15,9,24,13,11,0,-4
Dahlberg,373,0,189,2018-12-26T19:30:00Z,True,17,5,0,0,27,15,12,37,21,16,-10,-1
Dahlberg,373,0,199,2018-12-29T15:00:00Z,True,17,14,0,0,27,15,12,17,7,10,10,5
Dahlberg,373,0,201,2019-01-02T19:45:00Z,False,17,1,0,0,28,16,12,26,17,9,2,-5
Dahlberg,373,0,214,2019-01-12T15:00:00Z,False,17,6,0,0,29,16,13,22,9,13,7,4
Dahlberg,373,0,228,2019-01-19T15:00:00Z,True,17,3,0,0,32,16,16,21,13,8,11,8
Dahlberg,373,0,239,2019-01-30T20:00:00Z,False,17,16,0,0,33,17,16,51,18,33,-18,-2
Dahlberg,373,0,240,2019-02-02T15:00:00Z,False,17,2,0,0,33,17,16,26,18,8,7,-2
Dahlberg,373,0,258,2019-02-09T15:00:00Z,True,17,7,0,0,34,17,17,33,21,12,1,5
Dahlberg,373,0,263,2019-02-22T19:45:00Z,False,17,4,0,0,37,20,17,25,17,8,12,0
Dahlberg,373,0,276,2019-02-27T20:00:00Z,False,17,11,0,0,40,20,20,66,35,31,-26,-15
Dahlberg,373,0,287,2019-03-03T12:00:00Z,True,17,10,0,0,40,20,20,35,17,18,5,2
Dahlberg,373,0,297,2019-03-09T17:30:00Z,False,17,12,0,0,43,23,20,71,42,29,-28,-22
Dahlberg,373,0,318,2019-03-30T15:00:00Z,False,17,13,0,0,43,23,20,58,29,29,-15,-9
Dahlberg,373,0,328,2019-04-02T18:45:00Z,True,17,8,0,0,43,23,20,17,15,2,26,21
Dahlberg,373,0,339,2019-04-15T19:00:00Z,True,17,0,0,0,46,26,20,63,44,19,-17,7
Dahlberg,373,0,345,2019-04-20T14:00:00Z,False,17,9,0,0,46,26,20,14,8,6,32,12
Dahlberg,373,0,307,2019-04-23T18:45:00Z,True,17,15,0,0,49,26,23,36,21,15,13,11
Dahlberg,373,0,359,2019-04-27T14:00:00Z,True,17,19,0,0,50,27,23,51,31,20,-1,7
Dahlberg,373,0,363,2019-05-05T13:00:00Z,False,17,5,0,0,50,27,23,68,39,29,-18,-16
Dahlberg,373,0,379,2019-05-12T14:00:00Z,True,17,18,0,0,50,27,23,49,31,18,1,9
Kaboul,374,1,8,2018-08-11T14:00:00Z,True,17,2,0,0,0,0,0,0,0,0,0,0
Kaboul,374,1,11,2018-08-19T12:30:00Z,False,17,3,0,0,3,3,0,1,0,1,2,0
Kaboul,374,1,28,2018-08-26T12:30:00Z,True,17,6,0,0,6,3,3,3,0,3,3,0
Kaboul,374,1,38,2018-09-02T15:00:00Z,True,17,16,0,0,9,6,3,9,3,6,0,0
Kaboul,374,1,48,2018-09-15T16:30:00Z,True,17,13,0,0,12,9,3,6,3,3,6,6
Kaboul,374,1,55,2018-09-22T11:30:00Z,False,17,8,0,0,12,9,3,4,3,1,8,0
Kaboul,374,1,60,2018-09-29T14:00:00Z,False,17,0,0,0,13,9,4,12,6,6,1,-2
Kaboul,374,1,79,2018-10-06T14:00:00Z,True,17,1,0,0,13,9,4,13,10,3,0,6
Kaboul,374,1,89,2018-10-20T14:00:00Z,False,17,19,0,0,13,9,4,15,8,7,-2,-4
Kaboul,374,1,99,2018-10-27T14:00:00Z,True,17,9,0,0,16,9,7,3,1,2,13,7
Kaboul,374,1,107,2018-11-03T15:00:00Z,False,17,14,0,0,19,12,7,3,0,3,16,7
Kaboul,374,1,119,2018-11-10T15:00:00Z,False,17,15,0,0,19,12,7,7,3,4,12,4
Kaboul,374,1,127,2018-11-24T15:00:00Z,True,17,11,0,0,20,12,8,30,16,14,-10,-2
Kaboul,374,1,135,2018-12-01T15:00:00Z,False,17,10,0,0,20,12,8,18,8,10,2,0
Kaboul,374,1,145,2018-12-04T20:00:00Z,True,17,12,0,0,20,12,8,38,24,14,-18,-2
Kaboul,374,1,155,2018-12-10T20:00:00Z,False,17,7,0,0,20,12,8,23,17,6,-3,-9
Kaboul,374,1,168,2018-12-15T15:00:00Z,True,17,4,0,0,21,12,9,14,13,1,7,11
Kaboul,374,1,178,2018-12-22T15:00:00Z,False,17,18,0,0,24,15,9,24,13,11,0,-4
Kaboul,374,1,189,2018-12-26T19:30:00Z,True,17,5,0,0,27,15,12,37,21,16,-10,-1
Kaboul,374,1,199,2018-12-29T15:00:00Z,True,17,14,0,0,27,15,12,17,7,10,10,5
Kaboul,374,1,201,2019-01-02T19:45:00Z,False,17,1,0,0,28,16,12,26,17,9,2,-5
Kaboul,374,1,214,2019-01-12T15:00:00Z,False,17,6,0,0,29,16,13,22,9,13,7,4
Kaboul,374,1,228,2019-01-19T15:00:00Z,True,17,3,0,0,32,16,16,21,13,8,11,8
Kaboul,374,1,239,2019-01-30T20:00:00Z,False,17,16,0,0,33,17,16,51,18,33,-18,-2
Kaboul,374,1,240,2019-02-02T15:00:00Z,False,17,2,0,0,33,17,16,26,18,8,7,-2
Kaboul,374,1,258,2019-02-09T15:00:00Z,True,17,7,0,0,34,17,17,33,21,12,1,5
Kaboul,374,1,263,2019-02-22T19:45:00Z,False,17,4,0,0,37,20,17,25,17,8,12,0
Kaboul,374,1,276,2019-02-27T20:00:00Z,False,17,11,0,0,40,20,20,66,35,31,-26,-15
Kaboul,374,1,287,2019-03-03T12:00:00Z,True,17,10,0,0,40,20,20,35,17,18,5,2
Kaboul,374,1,297,2019-03-09T17:30:00Z,False,17,12,0,0,43,23,20,71,42,29,-28,-22
Kaboul,374,1,318,2019-03-30T15:00:00Z,False,17,13,0,0,43,23,20,58,29,29,-15,-9
Kaboul,374,1,328,2019-04-02T18:45:00Z,True,17,8,0,0,43,23,20,17,15,2,26,21
Kaboul,374,1,339,2019-04-15T19:00:00Z,True,17,0,0,0,46,26,20,63,44,19,-17,7
Kaboul,374,1,345,2019-04-20T14:00:00Z,False,17,9,0,0,46,26,20,14,8,6,32,12
Kaboul,374,1,307,2019-04-23T18:45:00Z,True,17,15,0,0,49,26,23,36,21,15,13,11
Kaboul,374,1,359,2019-04-27T14:00:00Z,True,17,19,0,0,50,27,23,51,31,20,-1,7
Kaboul,374,1,363,2019-05-05T13:00:00Z,False,17,5,0,0,50,27,23,68,39,29,-18,-16
Kaboul,374,1,379,2019-05-12T14:00:00Z,True,17,18,0,0,50,27,23,49,31,18,1,9
Cathcart,375,1,8,2018-08-11T14:00:00Z,True,17,2,90,6,0,0,0,0,0,0,0,0
Cathcart,375,1,11,2018-08-19T12:30:00Z,False,17,3,90,2,3,3,0,1,0,1,2,0
Cathcart,375,1,28,2018-08-26T12:30:00Z,True,17,6,90,2,6,3,3,3,0,3,3,0
Cathcart,375,1,38,2018-09-02T15:00:00Z,True,17,16,90,11,9,6,3,9,3,6,0,0
Cathcart,375,1,48,2018-09-15T16:30:00Z,True,17,13,87,1,12,9,3,6,3,3,6,6
Cathcart,375,1,55,2018-09-22T11:30:00Z,False,17,8,90,2,12,9,3,4,3,1,8,0
Cathcart,375,1,60,2018-09-29T14:00:00Z,False,17,0,90,-1,13,9,4,12,6,6,1,-2
Cathcart,375,1,79,2018-10-06T14:00:00Z,True,17,1,90,-1,13,9,4,13,10,3,0,6
Cathcart,375,1,89,2018-10-20T14:00:00Z,False,17,19,90,6,13,9,4,15,8,7,-2,-4
Cathcart,375,1,99,2018-10-27T14:00:00Z,True,17,9,84,6,16,9,7,3,1,2,13,7
Cathcart,375,1,107,2018-11-03T15:00:00Z,False,17,14,90,2,19,12,7,3,0,3,16,7
Cathcart,375,1,119,2018-11-10T15:00:00Z,False,17,15,90,2,19,12,7,7,3,4,12,4
Cathcart,375,1,127,2018-11-24T15:00:00Z,True,17,11,90,1,20,12,8,30,16,14,-10,-2
Cathcart,375,1,135,2018-12-01T15:00:00Z,False,17,10,90,1,20,12,8,18,8,10,2,0
Cathcart,375,1,145,2018-12-04T20:00:00Z,True,17,12,90,1,20,12,8,38,24,14,-18,-2
Cathcart,375,1,155,2018-12-10T20:00:00Z,False,17,7,90,1,20,12,8,23,17,6,-3,-9
Cathcart,375,1,168,2018-12-15T15:00:00Z,True,17,4,90,1,21,12,9,14,13,1,7,11
Cathcart,375,1,178,2018-12-22T15:00:00Z,False,17,18,90,6,24,15,9,24,13,11,0,-4
Cathcart,375,1,189,2018-12-26T19:30:00Z,True,17,5,90,1,27,15,12,37,21,16,-10,-1
Cathcart,375,1,199,2018-12-29T15:00:00Z,True,17,14,90,2,27,15,12,17,7,10,10,5
Cathcart,375,1,201,2019-01-02T19:45:00Z,False,17,1,90,1,28,16,12,26,17,9,2,-5
Cathcart,375,1,214,2019-01-12T15:00:00Z,False,17,6,90,6,29,16,13,22,9,13,7,4
Cathcart,375,1,228,2019-01-19T15:00:00Z,True,17,3,0,0,32,16,16,21,13,8,11,8
Cathcart,375,1,239,2019-01-30T20:00:00Z,False,17,16,90,7,33,17,16,51,18,33,-18,-2
Cathcart,375,1,240,2019-02-02T15:00:00Z,False,17,2,90,8,33,17,16,26,18,8,7,-2
Cathcart,375,1,258,2019-02-09T15:00:00Z,True,17,7,90,6,34,17,17,33,21,12,1,5
Cathcart,375,1,263,2019-02-22T19:45:00Z,False,17,4,90,2,37,20,17,25,17,8,12,0
Cathcart,375,1,276,2019-02-27T20:00:00Z,False,17,11,90,-1,40,20,20,66,35,31,-26,-15
Cathcart,375,1,287,2019-03-03T12:00:00Z,True,17,10,90,2,40,20,20,35,17,18,5,2
Cathcart,375,1,297,2019-03-09T17:30:00Z,False,17,12,8,1,43,23,20,71,42,29,-28,-22
Cathcart,375,1,318,2019-03-30T15:00:00Z,False,17,13,0,0,43,23,20,58,29,29,-15,-9
Cathcart,375,1,328,2019-04-02T18:45:00Z,True,17,8,90,2,43,23,20,17,15,2,26,21
Cathcart,375,1,339,2019-04-15T19:00:00Z,True,17,0,90,2,46,26,20,63,44,19,-17,7
Cathcart,375,1,345,2019-04-20T14:00:00Z,False,17,9,90,2,46,26,20,14,8,6,32,12
Cathcart,375,1,307,2019-04-23T18:45:00Z,True,17,15,45,1,49,26,23,36,21,15,13,11
Cathcart,375,1,359,2019-04-27T14:00:00Z,True,17,19,81,1,50,27,23,51,31,20,-1,7
Cathcart,375,1,363,2019-05-05T13:00:00Z,False,17,5,90,1,50,27,23,68,39,29,-18,-16
Cathcart,375,1,379,2019-05-12T14:00:00Z,True,17,18,90,0,50,27,23,49,31,18,1,9
Prodl,376,1,8,2018-08-11T14:00:00Z,True,17,2,0,0,0,0,0,0,0,0,0,0
Prodl,376,1,11,2018-08-19T12:30:00Z,False,17,3,0,0,3,3,0,1,0,1,2,0
Prodl,376,1,28,2018-08-26T12:30:00Z,True,17,6,0,0,6,3,3,3,0,3,3,0
Prodl,376,1,38,2018-09-02T15:00:00Z,True,17,16,0,0,9,6,3,9,3,6,0,0
Prodl,376,1,48,2018-09-15T16:30:00Z,True,17,13,0,0,12,9,3,6,3,3,6,6
Prodl,376,1,55,2018-09-22T11:30:00Z,False,17,8,0,0,12,9,3,4,3,1,8,0
Prodl,376,1,60,2018-09-29T14:00:00Z,False,17,0,0,0,13,9,4,12,6,6,1,-2
Prodl,376,1,79,2018-10-06T14:00:00Z,True,17,1,0,0,13,9,4,13,10,3,0,6
Prodl,376,1,89,2018-10-20T14:00:00Z,False,17,19,13,1,13,9,4,15,8,7,-2,-4
Prodl,376,1,99,2018-10-27T14:00:00Z,True,17,9,0,0,16,9,7,3,1,2,13,7
Prodl,376,1,107,2018-11-03T15:00:00Z,False,17,14,0,0,19,12,7,3,0,3,16,7
Prodl,376,1,119,2018-11-10T15:00:00Z,False,17,15,0,0,19,12,7,7,3,4,12,4
Prodl,376,1,127,2018-11-24T15:00:00Z,True,17,11,0,0,20,12,8,30,16,14,-10,-2
Prodl,376,1,135,2018-12-01T15:00:00Z,False,17,10,0,0,20,12,8,18,8,10,2,0
Prodl,376,1,145,2018-12-04T20:00:00Z,True,17,12,0,0,20,12,8,38,24,14,-18,-2
Prodl,376,1,155,2018-12-10T20:00:00Z,False,17,7,0,0,20,12,8,23,17,6,-3,-9
Prodl,376,1,168,2018-12-15T15:00:00Z,True,17,4,0,0,21,12,9,14,13,1,7,11
Prodl,376,1,178,2018-12-22T15:00:00Z,False,17,18,0,0,24,15,9,24,13,11,0,-4
Prodl,376,1,189,2018-12-26T19:30:00Z,True,17,5,0,0,27,15,12,37,21,16,-10,-1
Prodl,376,1,199,2018-12-29T15:00:00Z,True,17,14,0,0,27,15,12,17,7,10,10,5
Prodl,376,1,201,2019-01-02T19:45:00Z,False,17,1,0,0,28,16,12,26,17,9,2,-5
Prodl,376,1,214,2019-01-12T15:00:00Z,False,17,6,0,0,29,16,13,22,9,13,7,4
Prodl,376,1,228,2019-01-19T15:00:00Z,True,17,3,0,0,32,16,16,21,13,8,11,8
Prodl,376,1,239,2019-01-30T20:00:00Z,False,17,16,0,0,33,17,16,51,18,33,-18,-2
Prodl,376,1,240,2019-02-02T15:00:00Z,False,17,2,0,0,33,17,16,26,18,8,7,-2
Prodl,376,1,258,2019-02-09T15:00:00Z,True,17,7,0,0,34,17,17,33,21,12,1,5
Prodl,376,1,263,2019-02-22T19:45:00Z,False,17,4,0,0,37,20,17,25,17,8,12,0
Prodl,376,1,276,2019-02-27T20:00:00Z,False,17,11,0,0,40,20,20,66,35,31,-26,-15
Prodl,376,1,287,2019-03-03T12:00:00Z,True,17,10,0,0,40,20,20,35,17,18,5,2
Prodl,376,1,297,2019-03-09T17:30:00Z,False,17,12,0,0,43,23,20,71,42,29,-28,-22
Prodl,376,1,318,2019-03-30T15:00:00Z,False,17,13,0,0,43,23,20,58,29,29,-15,-9
Prodl,376,1,328,2019-04-02T18:45:00Z,True,17,8,0,0,43,23,20,17,15,2,26,21
Prodl,376,1,339,2019-04-15T19:00:00Z,True,17,0,0,0,46,26,20,63,44,19,-17,7
Prodl,376,1,345,2019-04-20T14:00:00Z,False,17,9,0,0,46,26,20,14,8,6,32,12
Prodl,376,1,307,2019-04-23T18:45:00Z,True,17,15,0,0,49,26,23,36,21,15,13,11
Prodl,376,1,359,2019-04-27T14:00:00Z,True,17,19,0,0,50,27,23,51,31,20,-1,7
Prodl,376,1,363,2019-05-05T13:00:00Z,False,17,5,0,0,50,27,23,68,39,29,-18,-16
Prodl,376,1,379,2019-05-12T14:00:00Z,True,17,18,0,0,50,27,23,49,31,18,1,9
Holebas,377,1,8,2018-08-11T14:00:00Z,True,17,2,90,13,0,0,0,0,0,0,0,0
Holebas,377,1,11,2018-08-19T12:30:00Z,False,17,3,90,2,3,3,0,1,0,1,2,0
Holebas,377,1,28,2018-08-26T12:30:00Z,True,17,6,90,9,6,3,3,3,0,3,3,0
Holebas,377,1,38,2018-09-02T15:00:00Z,True,17,16,90,10,9,6,3,9,3,6,0,0
Holebas,377,1,48,2018-09-15T16:30:00Z,True,17,13,83,0,12,9,3,6,3,3,6,6
Holebas,377,1,55,2018-09-22T11:30:00Z,False,17,8,90,1,12,9,3,4,3,1,8,0
Holebas,377,1,60,2018-09-29T14:00:00Z,False,17,0,90,1,13,9,4,12,6,6,1,-2
Holebas,377,1,79,2018-10-06T14:00:00Z,True,17,1,90,-1,13,9,4,13,10,3,0,6
Holebas,377,1,89,2018-10-20T14:00:00Z,False,17,19,0,0,13,9,4,15,8,7,-2,-4
Holebas,377,1,99,2018-10-27T14:00:00Z,True,17,9,0,0,16,9,7,3,1,2,13,7
Holebas,377,1,107,2018-11-03T15:00:00Z,False,17,14,90,1,19,12,7,3,0,3,16,7
Holebas,377,1,119,2018-11-10T15:00:00Z,False,17,15,90,8,19,12,7,7,3,4,12,4
Holebas,377,1,127,2018-11-24T15:00:00Z,True,17,11,0,0,20,12,8,30,16,14,-10,-2
Holebas,377,1,135,2018-12-01T15:00:00Z,False,17,10,90,1,20,12,8,18,8,10,2,0
Holebas,377,1,145,2018-12-04T20:00:00Z,True,17,12,90,1,20,12,8,38,24,14,-18,-2
Holebas,377,1,155,2018-12-10T20:00:00Z,False,17,7,90,1,20,12,8,23,17,6,-3,-9
Holebas,377,1,168,2018-12-15T15:00:00Z,True,17,4,90,7,21,12,9,14,13,1,7,11
Holebas,377,1,178,2018-12-22T15:00:00Z,False,17,18,90,5,24,15,9,24,13,11,0,-4
Holebas,377,1,189,2018-12-26T19:30:00Z,True,17,5,90,4,27,15,12,37,21,16,-10,-1
Holebas,377,1,199,2018-12-29T15:00:00Z,True,17,14,12,1,27,15,12,17,7,10,10,5
Holebas,377,1,201,2019-01-02T19:45:00Z,False,17,1,90,0,28,16,12,26,17,9,2,-5
Holebas,377,1,214,2019-01-12T15:00:00Z,False,17,6,90,7,29,16,13,22,9,13,7,4
Holebas,377,1,228,2019-01-19T15:00:00Z,True,17,3,90,6,32,16,16,21,13,8,11,8
Holebas,377,1,239,2019-01-30T20:00:00Z,False,17,16,90,3,33,17,16,51,18,33,-18,-2
Holebas,377,1,240,2019-02-02T15:00:00Z,False,17,2,90,6,33,17,16,26,18,8,7,-2
Holebas,377,1,258,2019-02-09T15:00:00Z,True,17,7,90,7,34,17,17,33,21,12,1,5
Holebas,377,1,263,2019-02-22T19:45:00Z,False,17,4,0,0,37,20,17,25,17,8,12,0
Holebas,377,1,276,2019-02-27T20:00:00Z,False,17,11,0,0,40,20,20,66,35,31,-26,-15
Holebas,377,1,287,2019-03-03T12:00:00Z,True,17,10,90,2,40,20,20,35,17,18,5,2
Holebas,377,1,297,2019-03-09T17:30:00Z,False,17,12,0,0,43,23,20,71,42,29,-28,-22
Holebas,377,1,318,2019-03-30T15:00:00Z,False,17,13,0,0,43,23,20,58,29,29,-15,-9
Holebas,377,1,328,2019-04-02T18:45:00Z,True,17,8,90,1,43,23,20,17,15,2,26,21
Holebas,377,1,339,2019-04-15T19:00:00Z,True,17,0,0,0,46,26,20,63,44,19,-17,7
Holebas,377,1,345,2019-04-20T14:00:00Z,False,17,9,0,0,46,26,20,14,8,6,32,12
Holebas,377,1,307,2019-04-23T18:45:00Z,True,17,15,0,0,49,26,23,36,21,15,13,11
Holebas,377,1,359,2019-04-27T14:00:00Z,True,17,19,90,0,50,27,23,51,31,20,-1,7
Holebas,377,1,363,2019-05-05T13:00:00Z,False,17,5,90,1,50,27,23,68,39,29,-18,-16
Holebas,377,1,379,2019-05-12T14:00:00Z,True,17,18,47,-4,50,27,23,49,31,18,1,9
Britos,378,1,8,2018-08-11T14:00:00Z,True,17,2,0,0,0,0,0,0,0,0,0,0
Britos,378,1,11,2018-08-19T12:30:00Z,False,17,3,0,0,3,3,0,1,0,1,2,0
Britos,378,1,28,2018-08-26T12:30:00Z,True,17,6,0,0,6,3,3,3,0,3,3,0
Britos,378,1,38,2018-09-02T15:00:00Z,True,17,16,0,0,9,6,3,9,3,6,0,0
Britos,378,1,48,2018-09-15T16:30:00Z,True,17,13,0,0,12,9,3,6,3,3,6,6
Britos,378,1,55,2018-09-22T11:30:00Z,False,17,8,0,0,12,9,3,4,3,1,8,0
Britos,378,1,60,2018-09-29T14:00:00Z,False,17,0,0,0,13,9,4,12,6,6,1,-2
Britos,378,1,79,2018-10-06T14:00:00Z,True,17,1,0,0,13,9,4,13,10,3,0,6
Britos,378,1,89,2018-10-20T14:00:00Z,False,17,19,0,0,13,9,4,15,8,7,-2,-4
Britos,378,1,99,2018-10-27T14:00:00Z,True,17,9,0,0,16,9,7,3,1,2,13,7
Britos,378,1,107,2018-11-03T15:00:00Z,False,17,14,0,0,19,12,7,3,0,3,16,7
Britos,378,1,119,2018-11-10T15:00:00Z,False,17,15,0,0,19,12,7,7,3,4,12,4
Britos,378,1,127,2018-11-24T15:00:00Z,True,17,11,0,0,20,12,8,30,16,14,-10,-2
Britos,378,1,135,2018-12-01T15:00:00Z,False,17,10,0,0,20,12,8,18,8,10,2,0
Britos,378,1,145,2018-12-04T20:00:00Z,True,17,12,0,0,20,12,8,38,24,14,-18,-2
Britos,378,1,155,2018-12-10T20:00:00Z,False,17,7,0,0,20,12,8,23,17,6,-3,-9
Britos,378,1,168,2018-12-15T15:00:00Z,True,17,4,0,0,21,12,9,14,13,1,7,11
Britos,378,1,178,2018-12-22T15:00:00Z,False,17,18,0,0,24,15,9,24,13,11,0,-4
Britos,378,1,189,2018-12-26T19:30:00Z,True,17,5,0,0,27,15,12,37,21,16,-10,-1
Britos,378,1,199,2018-12-29T15:00:00Z,True,17,14,0,0,27,15,12,17,7,10,10,5
Britos,378,1,201,2019-01-02T19:45:00Z,False,17,1,0,0,28,16,12,26,17,9,2,-5
Britos,378,1,214,2019-01-12T15:00:00Z,False,17,6,0,0,29,16,13,22,9,13,7,4
Britos,378,1,228,2019-01-19T15:00:00Z,True,17,3,13,1,32,16,16,21,13,8,11,8
Britos,378,1,239,2019-01-30T20:00:00Z,False,17,16,0,0,33,17,16,51,18,33,-18,-2
Britos,378,1,240,2019-02-02T15:00:00Z,False,17,2,0,0,33,17,16,26,18,8,7,-2
Britos,378,1,258,2019-02-09T15:00:00Z,True,17,7,0,0,34,17,17,33,21,12,1,5
Britos,378,1,263,2019-02-22T19:45:00Z,False,17,4,0,0,37,20,17,25,17,8,12,0
Britos,378,1,276,2019-02-27T20:00:00Z,False,17,11,0,0,40,20,20,66,35,31,-26,-15
Britos,378,1,287,2019-03-03T12:00:00Z,True,17,10,0,0,40,20,20,35,17,18,5,2
Britos,378,1,297,2019-03-09T17:30:00Z,False,17,12,81,1,43,23,20,71,42,29,-28,-22
Britos,378,1,318,2019-03-30T15:00:00Z,False,17,13,90,1,43,23,20,58,29,29,-15,-9
Britos,378,1,328,2019-04-02T18:45:00Z,True,17,8,0,0,43,23,20,17,15,2,26,21
Britos,378,1,339,2019-04-15T19:00:00Z,True,17,0,0,0,46,26,20,63,44,19,-17,7
Britos,378,1,345,2019-04-20T14:00:00Z,False,17,9,0,0,46,26,20,14,8,6,32,12
Britos,378,1,307,2019-04-23T18:45:00Z,True,17,15,0,0,49,26,23,36,21,15,13,11
Britos,378,1,359,2019-04-27T14:00:00Z,True,17,19,0,0,50,27,23,51,31,20,-1,7
Britos,378,1,363,2019-05-05T13:00:00Z,False,17,5,0,0,50,27,23,68,39,29,-18,-16
Britos,378,1,379,2019-05-12T14:00:00Z,True,17,18,0,0,50,27,23,49,31,18,1,9
Kabasele,379,1,8,2018-08-11T14:00:00Z,True,17,2,90,6,0,0,0,0,0,0,0,0
Kabasele,379,1,11,2018-08-19T12:30:00Z,False,17,3,90,2,3,3,0,1,0,1,2,0
Kabasele,379,1,28,2018-08-26T12:30:00Z,True,17,6,90,2,6,3,3,3,0,3,3,0
Kabasele,379,1,38,2018-09-02T15:00:00Z,True,17,16,90,2,9,6,3,9,3,6,0,0
Kabasele,379,1,48,2018-09-15T16:30:00Z,True,17,13,90,1,12,9,3,6,3,3,6,6
Kabasele,379,1,55,2018-09-22T11:30:00Z,False,17,8,90,2,12,9,3,4,3,1,8,0
Kabasele,379,1,60,2018-09-29T14:00:00Z,False,17,0,90,1,13,9,4,12,6,6,1,-2
Kabasele,379,1,79,2018-10-06T14:00:00Z,True,17,1,31,-4,13,9,4,13,10,3,0,6
Kabasele,379,1,89,2018-10-20T14:00:00Z,False,17,19,0,0,13,9,4,15,8,7,-2,-4
Kabasele,379,1,99,2018-10-27T14:00:00Z,True,17,9,5,1,16,9,7,3,1,2,13,7
Kabasele,379,1,107,2018-11-03T15:00:00Z,False,17,14,0,0,19,12,7,3,0,3,16,7
Kabasele,379,1,119,2018-11-10T15:00:00Z,False,17,15,0,0,19,12,7,7,3,4,12,4
Kabasele,379,1,127,2018-11-24T15:00:00Z,True,17,11,0,0,20,12,8,30,16,14,-10,-2
Kabasele,379,1,135,2018-12-01T15:00:00Z,False,17,10,0,0,20,12,8,18,8,10,2,0
Kabasele,379,1,145,2018-12-04T20:00:00Z,True,17,12,90,1,20,12,8,38,24,14,-18,-2
Kabasele,379,1,155,2018-12-10T20:00:00Z,False,17,7,90,1,20,12,8,23,17,6,-3,-9
Kabasele,379,1,168,2018-12-15T15:00:00Z,True,17,4,90,1,21,12,9,14,13,1,7,11
Kabasele,379,1,178,2018-12-22T15:00:00Z,False,17,18,90,5,24,15,9,24,13,11,0,-4
Kabasele,379,1,189,2018-12-26T19:30:00Z,True,17,5,15,1,27,15,12,37,21,16,-10,-1
Kabasele,379,1,199,2018-12-29T15:00:00Z,True,17,14,0,0,27,15,12,17,7,10,10,5
Kabasele,379,1,201,2019-01-02T19:45:00Z,False,17,1,0,0,28,16,12,26,17,9,2,-5
Kabasele,379,1,214,2019-01-12T15:00:00Z,False,17,6,0,0,29,16,13,22,9,13,7,4
Kabasele,379,1,228,2019-01-19T15:00:00Z,True,17,3,90,7,32,16,16,21,13,8,11,8
Kabasele,379,1,239,2019-01-30T20:00:00Z,False,17,16,0,0,33,17,16,51,18,33,-18,-2
Kabasele,379,1,240,2019-02-02T15:00:00Z,False,17,2,0,0,33,17,16,26,18,8,7,-2
Kabasele,379,1,258,2019-02-09T15:00:00Z,True,17,7,0,0,34,17,17,33,21,12,1,5
Kabasele,379,1,263,2019-02-22T19:45:00Z,False,17,4,0,0,37,20,17,25,17,8,12,0
Kabasele,379,1,276,2019-02-27T20:00:00Z,False,17,11,0,0,40,20,20,66,35,31,-26,-15
Kabasele,379,1,287,2019-03-03T12:00:00Z,True,17,10,0,0,40,20,20,35,17,18,5,2
Kabasele,379,1,297,2019-03-09T17:30:00Z,False,17,12,90,1,43,23,20,71,42,29,-28,-22
Kabasele,379,1,318,2019-03-30T15:00:00Z,False,17,13,90,1,43,23,20,58,29,29,-15,-9
Kabasele,379,1,328,2019-04-02T18:45:00Z,True,17,8,0,0,43,23,20,17,15,2,26,21
Kabasele,379,1,339,2019-04-15T19:00:00Z,True,17,0,90,2,46,26,20,63,44,19,-17,7
Kabasele,379,1,345,2019-04-20T14:00:00Z,False,17,9,0,0,46,26,20,14,8,6,32,12
Kabasele,379,1,307,2019-04-23T18:45:00Z,True,17,15,90,1,49,26,23,36,21,15,13,11
Kabasele,379,1,359,2019-04-27T14:00:00Z,True,17,19,16,1,50,27,23,51,31,20,-1,7
Kabasele,379,1,363,2019-05-05T13:00:00Z,False,17,5,0,0,50,27,23,68,39,29,-18,-16
Kabasele,379,1,379,2019-05-12T14:00:00Z,True,17,18,77,1,50,27,23,49,31,18,1,9
Janmaat,380,1,8,2018-08-11T14:00:00Z,True,17,2,90,7,0,0,0,0,0,0,0,0
Janmaat,380,1,11,2018-08-19T12:30:00Z,False,17,3,90,1,3,3,0,1,0,1,2,0
Janmaat,380,1,28,2018-08-26T12:30:00Z,True,17,6,90,7,6,3,3,3,0,3,3,0
Janmaat,380,1,38,2018-09-02T15:00:00Z,True,17,16,90,2,9,6,3,9,3,6,0,0
Janmaat,380,1,48,2018-09-15T16:30:00Z,True,17,13,71,1,12,9,3,6,3,3,6,6
Janmaat,380,1,55,2018-09-22T11:30:00Z,False,17,8,90,2,12,9,3,4,3,1,8,0
Janmaat,380,1,60,2018-09-29T14:00:00Z,False,17,0,0,0,13,9,4,12,6,6,1,-2
Janmaat,380,1,79,2018-10-06T14:00:00Z,True,17,1,0,0,13,9,4,13,10,3,0,6
Janmaat,380,1,89,2018-10-20T14:00:00Z,False,17,19,0,0,13,9,4,15,8,7,-2,-4
Janmaat,380,1,99,2018-10-27T14:00:00Z,True,17,9,0,0,16,9,7,3,1,2,13,7
Janmaat,380,1,107,2018-11-03T15:00:00Z,False,17,14,0,0,19,12,7,3,0,3,16,7
Janmaat,380,1,119,2018-11-10T15:00:00Z,False,17,15,0,0,19,12,7,7,3,4,12,4
Janmaat,380,1,127,2018-11-24T15:00:00Z,True,17,11,0,0,20,12,8,30,16,14,-10,-2
Janmaat,380,1,135,2018-12-01T15:00:00Z,False,17,10,0,0,20,12,8,18,8,10,2,0
Janmaat,380,1,145,2018-12-04T20:00:00Z,True,17,12,0,0,20,12,8,38,24,14,-18,-2
Janmaat,380,1,155,2018-12-10T20:00:00Z,False,17,7,0,0,20,12,8,23,17,6,-3,-9
Janmaat,380,1,168,2018-12-15T15:00:00Z,True,17,4,0,0,21,12,9,14,13,1,7,11
Janmaat,380,1,178,2018-12-22T15:00:00Z,False,17,18,0,0,24,15,9,24,13,11,0,-4
Janmaat,380,1,189,2018-12-26T19:30:00Z,True,17,5,0,0,27,15,12,37,21,16,-10,-1
Janmaat,380,1,199,2018-12-29T15:00:00Z,True,17,14,90,2,27,15,12,17,7,10,10,5
Janmaat,380,1,201,2019-01-02T19:45:00Z,False,17,1,0,0,28,16,12,26,17,9,2,-5
Janmaat,380,1,214,2019-01-12T15:00:00Z,False,17,6,0,0,29,16,13,22,9,13,7,4
Janmaat,380,1,228,2019-01-19T15:00:00Z,True,17,3,0,0,32,16,16,21,13,8,11,8
Janmaat,380,1,239,2019-01-30T20:00:00Z,False,17,16,90,1,33,17,16,51,18,33,-18,-2
Janmaat,380,1,240,2019-02-02T15:00:00Z,False,17,2,90,6,33,17,16,26,18,8,7,-2
Janmaat,380,1,258,2019-02-09T15:00:00Z,True,17,7,90,6,34,17,17,33,21,12,1,5
Janmaat,380,1,263,2019-02-22T19:45:00Z,False,17,4,90,2,37,20,17,25,17,8,12,0
Janmaat,380,1,276,2019-02-27T20:00:00Z,False,17,11,90,0,40,20,20,66,35,31,-26,-15
Janmaat,380,1,287,2019-03-03T12:00:00Z,True,17,10,90,2,40,20,20,35,17,18,5,2
Janmaat,380,1,297,2019-03-09T17:30:00Z,False,17,12,90,1,43,23,20,71,42,29,-28,-22
Janmaat,380,1,318,2019-03-30T15:00:00Z,False,17,13,54,1,43,23,20,58,29,29,-15,-9
Janmaat,380,1,328,2019-04-02T18:45:00Z,True,17,8,45,0,43,23,20,17,15,2,26,21
Janmaat,380,1,339,2019-04-15T19:00:00Z,True,17,0,90,2,46,26,20,63,44,19,-17,7
Janmaat,380,1,345,2019-04-20T14:00:00Z,False,17,9,0,0,46,26,20,14,8,6,32,12
Janmaat,380,1,307,2019-04-23T18:45:00Z,True,17,15,90,7,49,26,23,36,21,15,13,11
Janmaat,380,1,359,2019-04-27T14:00:00Z,True,17,19,0,0,50,27,23,51,31,20,-1,7
Janmaat,380,1,363,2019-05-05T13:00:00Z,False,17,5,0,0,50,27,23,68,39,29,-18,-16
Janmaat,380,1,379,2019-05-12T14:00:00Z,True,17,18,0,0,50,27,23,49,31,18,1,9
Mariappa,381,1,8,2018-08-11T14:00:00Z,True,17,2,0,0,0,0,0,0,0,0,0,0
Mariappa,381,1,11,2018-08-19T12:30:00Z,False,17,3,0,0,3,3,0,1,0,1,2,0
Mariappa,381,1,28,2018-08-26T12:30:00Z,True,17,6,0,0,6,3,3,3,0,3,3,0
Mariappa,381,1,38,2018-09-02T15:00:00Z,True,17,16,1,1,9,6,3,9,3,6,0,0
Mariappa,381,1,48,2018-09-15T16:30:00Z,True,17,13,0,0,12,9,3,6,3,3,6,6
Mariappa,381,1,55,2018-09-22T11:30:00Z,False,17,8,0,0,12,9,3,4,3,1,8,0
Mariappa,381,1,60,2018-09-29T14:00:00Z,False,17,0,0,0,13,9,4,12,6,6,1,-2
Mariappa,381,1,79,2018-10-06T14:00:00Z,True,17,1,35,1,13,9,4,13,10,3,0,6
Mariappa,381,1,89,2018-10-20T14:00:00Z,False,17,19,90,6,13,9,4,15,8,7,-2,-4
Mariappa,381,1,99,2018-10-27T14:00:00Z,True,17,9,90,6,16,9,7,3,1,2,13,7
Mariappa,381,1,107,2018-11-03T15:00:00Z,False,17,14,90,2,19,12,7,3,0,3,16,7
Mariappa,381,1,119,2018-11-10T15:00:00Z,False,17,15,90,2,19,12,7,7,3,4,12,4
Mariappa,381,1,127,2018-11-24T15:00:00Z,True,17,11,90,1,20,12,8,30,16,14,-10,-2
Mariappa,381,1,135,2018-12-01T15:00:00Z,False,17,10,90,1,20,12,8,18,8,10,2,0
Mariappa,381,1,145,2018-12-04T20:00:00Z,True,17,12,0,0,20,12,8,38,24,14,-18,-2
Mariappa,381,1,155,2018-12-10T20:00:00Z,False,17,7,1,1,20,12,8,23,17,6,-3,-9
Mariappa,381,1,168,2018-12-15T15:00:00Z,True,17,4,0,0,21,12,9,14,13,1,7,11
Mariappa,381,1,178,2018-12-22T15:00:00Z,False,17,18,1,1,24,15,9,24,13,11,0,-4
Mariappa,381,1,189,2018-12-26T19:30:00Z,True,17,5,74,1,27,15,12,37,21,16,-10,-1
Mariappa,381,1,199,2018-12-29T15:00:00Z,True,17,14,90,2,27,15,12,17,7,10,10,5
Mariappa,381,1,201,2019-01-02T19:45:00Z,False,17,1,90,1,28,16,12,26,17,9,2,-5
Mariappa,381,1,214,2019-01-12T15:00:00Z,False,17,6,90,2,29,16,13,22,9,13,7,4
Mariappa,381,1,228,2019-01-19T15:00:00Z,True,17,3,90,8,32,16,16,21,13,8,11,8
Mariappa,381,1,239,2019-01-30T20:00:00Z,False,17,16,90,0,33,17,16,51,18,33,-18,-2
Mariappa,381,1,240,2019-02-02T15:00:00Z,False,17,2,90,6,33,17,16,26,18,8,7,-2
Mariappa,381,1,258,2019-02-09T15:00:00Z,True,17,7,90,6,34,17,17,33,21,12,1,5
Mariappa,381,1,263,2019-02-22T19:45:00Z,False,17,4,90,2,37,20,17,25,17,8,12,0
Mariappa,381,1,276,2019-02-27T20:00:00Z,False,17,11,90,0,40,20,20,66,35,31,-26,-15
Mariappa,381,1,287,2019-03-03T12:00:00Z,True,17,10,90,1,40,20,20,35,17,18,5,2
Mariappa,381,1,297,2019-03-09T17:30:00Z,False,17,12,0,0,43,23,20,71,42,29,-28,-22
Mariappa,381,1,318,2019-03-30T15:00:00Z,False,17,13,0,0,43,23,20,58,29,29,-15,-9
Mariappa,381,1,328,2019-04-02T18:45:00Z,True,17,8,90,1,43,23,20,17,15,2,26,21
Mariappa,381,1,339,2019-04-15T19:00:00Z,True,17,0,0,0,46,26,20,63,44,19,-17,7
Mariappa,381,1,345,2019-04-20T14:00:00Z,False,17,9,90,2,46,26,20,14,8,6,32,12
Mariappa,381,1,307,2019-04-23T18:45:00Z,True,17,15,0,0,49,26,23,36,21,15,13,11
Mariappa,381,1,359,2019-04-27T14:00:00Z,True,17,19,90,1,50,27,23,51,31,20,-1,7
Mariappa,381,1,363,2019-05-05T13:00:00Z,False,17,5,90,1,50,27,23,68,39,29,-18,-16
Mariappa,381,1,379,2019-05-12T14:00:00Z,True,17,18,12,1,50,27,23,49,31,18,1,9
Kiko Femenia,382,1,8,2018-08-11T14:00:00Z,True,17,2,3,1,0,0,0,0,0,0,0,0
Kiko Femenia,382,1,11,2018-08-19T12:30:00Z,False,17,3,7,1,3,3,0,1,0,1,2,0
Kiko Femenia,382,1,28,2018-08-26T12:30:00Z,True,17,6,0,0,6,3,3,3,0,3,3,0
Kiko Femenia,382,1,38,2018-09-02T15:00:00Z,True,17,16,0,0,9,6,3,9,3,6,0,0
Kiko Femenia,382,1,48,2018-09-15T16:30:00Z,True,17,13,18,1,12,9,3,6,3,3,6,6
Kiko Femenia,382,1,55,2018-09-22T11:30:00Z,False,17,8,20,1,12,9,3,4,3,1,8,0
Kiko Femenia,382,1,60,2018-09-29T14:00:00Z,False,17,0,6,1,13,9,4,12,6,6,1,-2
Kiko Femenia,382,1,79,2018-10-06T14:00:00Z,True,17,1,90,0,13,9,4,13,10,3,0,6
Kiko Femenia,382,1,89,2018-10-20T14:00:00Z,False,17,19,90,6,13,9,4,15,8,7,-2,-4
Kiko Femenia,382,1,99,2018-10-27T14:00:00Z,True,17,9,90,12,16,9,7,3,1,2,13,7
Kiko Femenia,382,1,107,2018-11-03T15:00:00Z,False,17,14,90,2,19,12,7,3,0,3,16,7
Kiko Femenia,382,1,119,2018-11-10T15:00:00Z,False,17,15,90,2,19,12,7,7,3,4,12,4
Kiko Femenia,382,1,127,2018-11-24T15:00:00Z,True,17,11,90,1,20,12,8,30,16,14,-10,-2
Kiko Femenia,382,1,135,2018-12-01T15:00:00Z,False,17,10,90,1,20,12,8,18,8,10,2,0
Kiko Femenia,382,1,145,2018-12-04T20:00:00Z,True,17,12,90,1,20,12,8,38,24,14,-18,-2
Kiko Femenia,382,1,155,2018-12-10T20:00:00Z,False,17,7,90,1,20,12,8,23,17,6,-3,-9
Kiko Femenia,382,1,168,2018-12-15T15:00:00Z,True,17,4,90,1,21,12,9,14,13,1,7,11
Kiko Femenia,382,1,178,2018-12-22T15:00:00Z,False,17,18,90,6,24,15,9,24,13,11,0,-4
Kiko Femenia,382,1,189,2018-12-26T19:30:00Z,True,17,5,90,1,27,15,12,37,21,16,-10,-1
Kiko Femenia,382,1,199,2018-12-29T15:00:00Z,True,17,14,0,0,27,15,12,17,7,10,10,5
Kiko Femenia,382,1,201,2019-01-02T19:45:00Z,False,17,1,90,1,28,16,12,26,17,9,2,-5
Kiko Femenia,382,1,214,2019-01-12T15:00:00Z,False,17,6,90,1,29,16,13,22,9,13,7,4
Kiko Femenia,382,1,228,2019-01-19T15:00:00Z,True,17,3,76,9,32,16,16,21,13,8,11,8
Kiko Femenia,382,1,239,2019-01-30T20:00:00Z,False,17,16,0,0,33,17,16,51,18,33,-18,-2
Kiko Femenia,382,1,240,2019-02-02T15:00:00Z,False,17,2,0,0,33,17,16,26,18,8,7,-2
Kiko Femenia,382,1,258,2019-02-09T15:00:00Z,True,17,7,0,0,34,17,17,33,21,12,1,5
Kiko Femenia,382,1,263,2019-02-22T19:45:00Z,False,17,4,0,0,37,20,17,25,17,8,12,0
Kiko Femenia,382,1,276,2019-02-27T20:00:00Z,False,17,11,0,0,40,20,20,66,35,31,-26,-15
Kiko Femenia,382,1,287,2019-03-03T12:00:00Z,True,17,10,0,0,40,20,20,35,17,18,5,2
Kiko Femenia,382,1,297,2019-03-09T17:30:00Z,False,17,12,65,1,43,23,20,71,42,29,-28,-22
Kiko Femenia,382,1,318,2019-03-30T15:00:00Z,False,17,13,35,1,43,23,20,58,29,29,-15,-9
Kiko Femenia,382,1,328,2019-04-02T18:45:00Z,True,17,8,90,8,43,23,20,17,15,2,26,21
Kiko Femenia,382,1,339,2019-04-15T19:00:00Z,True,17,0,58,1,46,26,20,63,44,19,-17,7
Kiko Femenia,382,1,345,2019-04-20T14:00:00Z,False,17,9,90,2,46,26,20,14,8,6,32,12
Kiko Femenia,382,1,307,2019-04-23T18:45:00Z,True,17,15,45,1,49,26,23,36,21,15,13,11
Kiko Femenia,382,1,359,2019-04-27T14:00:00Z,True,17,19,90,1,50,27,23,51,31,20,-1,7
Kiko Femenia,382,1,363,2019-05-05T13:00:00Z,False,17,5,90,1,50,27,23,68,39,29,-18,-16
Kiko Femenia,382,1,379,2019-05-12T14:00:00Z,True,17,18,90,0,50,27,23,49,31,18,1,9
Zeegelaar,383,1,8,2018-08-11T14:00:00Z,True,17,2,0,0,0,0,0,0,0,0,0,0
Zeegelaar,383,1,11,2018-08-19T12:30:00Z,False,17,3,0,0,3,3,0,1,0,1,2,0
Zeegelaar,383,1,28,2018-08-26T12:30:00Z,True,17,6,0,0,6,3,3,3,0,3,3,0
Zeegelaar,383,1,38,2018-09-02T15:00:00Z,True,17,16,0,0,9,6,3,9,3,6,0,0
Zeegelaar,383,1,48,2018-09-15T16:30:00Z,True,17,13,0,0,12,9,3,6,3,3,6,6
Zeegelaar,383,1,55,2018-09-22T11:30:00Z,False,17,8,0,0,12,9,3,4,3,1,8,0
Zeegelaar,383,1,60,2018-09-29T14:00:00Z,False,17,0,0,0,13,9,4,12,6,6,1,-2
Zeegelaar,383,1,79,2018-10-06T14:00:00Z,True,17,1,0,0,13,9,4,13,10,3,0,6
Zeegelaar,383,1,89,2018-10-20T14:00:00Z,False,17,19,0,0,13,9,4,15,8,7,-2,-4
Zeegelaar,383,1,99,2018-10-27T14:00:00Z,True,17,9,0,0,16,9,7,3,1,2,13,7
Zeegelaar,383,1,107,2018-11-03T15:00:00Z,False,17,14,0,0,19,12,7,3,0,3,16,7
Zeegelaar,383,1,119,2018-11-10T15:00:00Z,False,17,15,0,0,19,12,7,7,3,4,12,4
Zeegelaar,383,1,127,2018-11-24T15:00:00Z,True,17,11,0,0,20,12,8,30,16,14,-10,-2
Zeegelaar,383,1,135,2018-12-01T15:00:00Z,False,17,10,0,0,20,12,8,18,8,10,2,0
Zeegelaar,383,1,145,2018-12-04T20:00:00Z,True,17,12,0,0,20,12,8,38,24,14,-18,-2
Zeegelaar,383,1,155,2018-12-10T20:00:00Z,False,17,7,0,0,20,12,8,23,17,6,-3,-9
Zeegelaar,383,1,168,2018-12-15T15:00:00Z,True,17,4,0,0,21,12,9,14,13,1,7,11
Zeegelaar,383,1,178,2018-12-22T15:00:00Z,False,17,18,0,0,24,15,9,24,13,11,0,-4
Zeegelaar,383,1,189,2018-12-26T19:30:00Z,True,17,5,0,0,27,15,12,37,21,16,-10,-1
Zeegelaar,383,1,199,2018-12-29T15:00:00Z,True,17,14,0,0,27,15,12,17,7,10,10,5
Zeegelaar,383,1,201,2019-01-02T19:45:00Z,False,17,1,0,0,28,16,12,26,17,9,2,-5
Zeegelaar,383,1,214,2019-01-12T15:00:00Z,False,17,6,0,0,29,16,13,22,9,13,7,4
Zeegelaar,383,1,228,2019-01-19T15:00:00Z,True,17,3,0,0,32,16,16,21,13,8,11,8
Zeegelaar,383,1,239,2019-01-30T20:00:00Z,False,17,16,0,0,33,17,16,51,18,33,-18,-2
Zeegelaar,383,1,240,2019-02-02T15:00:00Z,False,17,2,0,0,33,17,16,26,18,8,7,-2
Zeegelaar,383,1,258,2019-02-09T15:00:00Z,True,17,7,0,0,34,17,17,33,21,12,1,5
Zeegelaar,383,1,263,2019-02-22T19:45:00Z,False,17,4,0,0,37,20,17,25,17,8,12,0
Zeegelaar,383,1,276,2019-02-27T20:00:00Z,False,17,11,0,0,40,20,20,66,35,31,-26,-15
Zeegelaar,383,1,287,2019-03-03T12:00:00Z,True,17,10,0,0,40,20,20,35,17,18,5,2
Zeegelaar,383,1,297,2019-03-09T17:30:00Z,False,17,12,0,0,43,23,20,71,42,29,-28,-22
Zeegelaar,383,1,318,2019-03-30T15:00:00Z,False,17,13,0,0,43,23,20,58,29,29,-15,-9
Zeegelaar,383,1,328,2019-04-02T18:45:00Z,True,17,8,0,0,43,23,20,17,15,2,26,21
Zeegelaar,383,1,339,2019-04-15T19:00:00Z,True,17,0,0,0,46,26,20,63,44,19,-17,7
Zeegelaar,383,1,345,2019-04-20T14:00:00Z,False,17,9,0,0,46,26,20,14,8,6,32,12
Zeegelaar,383,1,307,2019-04-23T18:45:00Z,True,17,15,0,0,49,26,23,36,21,15,13,11
Zeegelaar,383,1,359,2019-04-27T14:00:00Z,True,17,19,0,0,50,27,23,51,31,20,-1,7
Zeegelaar,383,1,363,2019-05-05T13:00:00Z,False,17,5,0,0,50,27,23,68,39,29,-18,-16
Zeegelaar,383,1,379,2019-05-12T14:00:00Z,True,17,18,0,0,50,27,23,49,31,18,1,9
Navarro,384,1,8,2018-08-11T14:00:00Z,True,17,2,0,0,0,0,0,0,0,0,0,0
Navarro,384,1,11,2018-08-19T12:30:00Z,False,17,3,0,0,3,3,0,1,0,1,2,0
Navarro,384,1,28,2018-08-26T12:30:00Z,True,17,6,0,0,6,3,3,3,0,3,3,0
Navarro,384,1,38,2018-09-02T15:00:00Z,True,17,16,0,0,9,6,3,9,3,6,0,0
Navarro,384,1,48,2018-09-15T16:30:00Z,True,17,13,0,0,12,9,3,6,3,3,6,6
Navarro,384,1,55,2018-09-22T11:30:00Z,False,17,8,0,0,12,9,3,4,3,1,8,0
Navarro,384,1,60,2018-09-29T14:00:00Z,False,17,0,83,1,13,9,4,12,6,6,1,-2
Navarro,384,1,79,2018-10-06T14:00:00Z,True,17,1,0,0,13,9,4,13,10,3,0,6
Navarro,384,1,89,2018-10-20T14:00:00Z,False,17,19,0,0,13,9,4,15,8,7,-2,-4
Navarro,384,1,99,2018-10-27T14:00:00Z,True,17,9,0,0,16,9,7,3,1,2,13,7
Navarro,384,1,107,2018-11-03T15:00:00Z,False,17,14,0,0,19,12,7,3,0,3,16,7
Navarro,384,1,119,2018-11-10T15:00:00Z,False,17,15,0,0,19,12,7,7,3,4,12,4
Navarro,384,1,127,2018-11-24T15:00:00Z,True,17,11,0,0,20,12,8,30,16,14,-10,-2
Navarro,384,1,135,2018-12-01T15:00:00Z,False,17,10,0,0,20,12,8,18,8,10,2,0
Navarro,384,1,145,2018-12-04T20:00:00Z,True,17,12,0,0,20,12,8,38,24,14,-18,-2
Navarro,384,1,155,2018-12-10T20:00:00Z,False,17,7,0,0,20,12,8,23,17,6,-3,-9
Navarro,384,1,168,2018-12-15T15:00:00Z,True,17,4,0,0,21,12,9,14,13,1,7,11
Navarro,384,1,178,2018-12-22T15:00:00Z,False,17,18,0,0,24,15,9,24,13,11,0,-4
Navarro,384,1,189,2018-12-26T19:30:00Z,True,17,5,0,0,27,15,12,37,21,16,-10,-1
Navarro,384,1,199,2018-12-29T15:00:00Z,True,17,14,0,0,27,15,12,17,7,10,10,5
Navarro,384,1,201,2019-01-02T19:45:00Z,False,17,1,0,0,28,16,12,26,17,9,2,-5
Navarro,384,1,214,2019-01-12T15:00:00Z,False,17,6,0,0,29,16,13,22,9,13,7,4
Navarro,384,1,228,2019-01-19T15:00:00Z,True,17,3,0,0,32,16,16,21,13,8,11,8
Navarro,384,1,239,2019-01-30T20:00:00Z,False,17,16,0,0,33,17,16,51,18,33,-18,-2
Navarro,384,1,240,2019-02-02T15:00:00Z,False,17,2,0,0,33,17,16,26,18,8,7,-2
Navarro,384,1,258,2019-02-09T15:00:00Z,True,17,7,0,0,34,17,17,33,21,12,1,5
Navarro,384,1,263,2019-02-22T19:45:00Z,False,17,4,0,0,37,20,17,25,17,8,12,0
Navarro,384,1,276,2019-02-27T20:00:00Z,False,17,11,0,0,40,20,20,66,35,31,-26,-15
Navarro,384,1,287,2019-03-03T12:00:00Z,True,17,10,0,0,40,20,20,35,17,18,5,2
Navarro,384,1,297,2019-03-09T17:30:00Z,False,17,12,0,0,43,23,20,71,42,29,-28,-22
Navarro,384,1,318,2019-03-30T15:00:00Z,False,17,13,0,0,43,23,20,58,29,29,-15,-9
Navarro,384,1,328,2019-04-02T18:45:00Z,True,17,8,0,0,43,23,20,17,15,2,26,21
Navarro,384,1,339,2019-04-15T19:00:00Z,True,17,0,0,0,46,26,20,63,44,19,-17,7
Navarro,384,1,345,2019-04-20T14:00:00Z,False,17,9,1,1,46,26,20,14,8,6,32,12
Navarro,384,1,307,2019-04-23T18:45:00Z,True,17,15,0,0,49,26,23,36,21,15,13,11
Navarro,384,1,359,2019-04-27T14:00:00Z,True,17,19,0,0,50,27,23,51,31,20,-1,7
Navarro,384,1,363,2019-05-05T13:00:00Z,False,17,5,0,0,50,27,23,68,39,29,-18,-16
Navarro,384,1,379,2019-05-12T14:00:00Z,True,17,18,0,0,50,27,23,49,31,18,1,9
Masina,385,1,8,2018-08-11T14:00:00Z,True,17,2,0,0,0,0,0,0,0,0,0,0
Masina,385,1,11,2018-08-19T12:30:00Z,False,17,3,0,0,3,3,0,1,0,1,2,0
Masina,385,1,28,2018-08-26T12:30:00Z,True,17,6,0,0,6,3,3,3,0,3,3,0
Masina,385,1,38,2018-09-02T15:00:00Z,True,17,16,0,0,9,6,3,9,3,6,0,0
Masina,385,1,48,2018-09-15T16:30:00Z,True,17,13,6,1,12,9,3,6,3,3,6,6
Masina,385,1,55,2018-09-22T11:30:00Z,False,17,8,0,0,12,9,3,4,3,1,8,0
Masina,385,1,60,2018-09-29T14:00:00Z,False,17,0,0,0,13,9,4,12,6,6,1,-2
Masina,385,1,79,2018-10-06T14:00:00Z,True,17,1,0,0,13,9,4,13,10,3,0,6
Masina,385,1,89,2018-10-20T14:00:00Z,False,17,19,90,7,13,9,4,15,8,7,-2,-4
Masina,385,1,99,2018-10-27T14:00:00Z,True,17,9,90,8,16,9,7,3,1,2,13,7
Masina,385,1,107,2018-11-03T15:00:00Z,False,17,14,0,0,19,12,7,3,0,3,16,7
Masina,385,1,119,2018-11-10T15:00:00Z,False,17,15,0,0,19,12,7,7,3,4,12,4
Masina,385,1,127,2018-11-24T15:00:00Z,True,17,11,90,1,20,12,8,30,16,14,-10,-2
Masina,385,1,135,2018-12-01T15:00:00Z,False,17,10,0,0,20,12,8,18,8,10,2,0
Masina,385,1,145,2018-12-04T20:00:00Z,True,17,12,0,0,20,12,8,38,24,14,-18,-2
Masina,385,1,155,2018-12-10T20:00:00Z,False,17,7,0,0,20,12,8,23,17,6,-3,-9
Masina,385,1,168,2018-12-15T15:00:00Z,True,17,4,0,0,21,12,9,14,13,1,7,11
Masina,385,1,178,2018-12-22T15:00:00Z,False,17,18,0,0,24,15,9,24,13,11,0,-4
Masina,385,1,189,2018-12-26T19:30:00Z,True,17,5,0,0,27,15,12,37,21,16,-10,-1
Masina,385,1,199,2018-12-29T15:00:00Z,True,17,14,77,1,27,15,12,17,7,10,10,5
Masina,385,1,201,2019-01-02T19:45:00Z,False,17,1,0,0,28,16,12,26,17,9,2,-5
Masina,385,1,214,2019-01-12T15:00:00Z,False,17,6,1,1,29,16,13,22,9,13,7,4
Masina,385,1,228,2019-01-19T15:00:00Z,True,17,3,0,0,32,16,16,21,13,8,11,8
Masina,385,1,239,2019-01-30T20:00:00Z,False,17,16,0,0,33,17,16,51,18,33,-18,-2
Masina,385,1,240,2019-02-02T15:00:00Z,False,17,2,0,0,33,17,16,26,18,8,7,-2
Masina,385,1,258,2019-02-09T15:00:00Z,True,17,7,0,0,34,17,17,33,21,12,1,5
Masina,385,1,263,2019-02-22T19:45:00Z,False,17,4,90,2,37,20,17,25,17,8,12,0
Masina,385,1,276,2019-02-27T20:00:00Z,False,17,11,90,-1,40,20,20,66,35,31,-26,-15
Masina,385,1,287,2019-03-03T12:00:00Z,True,17,10,0,0,40,20,20,35,17,18,5,2
Masina,385,1,297,2019-03-09T17:30:00Z,False,17,12,90,1,43,23,20,71,42,29,-28,-22
Masina,385,1,318,2019-03-30T15:00:00Z,False,17,13,90,0,43,23,20,58,29,29,-15,-9
Masina,385,1,328,2019-04-02T18:45:00Z,True,17,8,0,0,43,23,20,17,15,2,26,21
Masina,385,1,339,2019-04-15T19:00:00Z,True,17,0,85,2,46,26,20,63,44,19,-17,7
Masina,385,1,345,2019-04-20T14:00:00Z,False,17,9,90,2,46,26,20,14,8,6,32,12
Masina,385,1,307,2019-04-23T18:45:00Z,True,17,15,90,1,49,26,23,36,21,15,13,11
Masina,385,1,359,2019-04-27T14:00:00Z,True,17,19,0,0,50,27,23,51,31,20,-1,7
Masina,385,1,363,2019-05-05T13:00:00Z,False,17,5,0,0,50,27,23,68,39,29,-18,-16
Masina,385,1,379,2019-05-12T14:00:00Z,True,17,18,23,0,50,27,23,49,31,18,1,9
Chalobah,386,2,8,2018-08-11T14:00:00Z,True,17,2,0,0,0,0,0,0,0,0,0,0
Chalobah,386,2,11,2018-08-19T12:30:00Z,False,17,3,0,0,3,3,0,1,0,1,2,0
Chalobah,386,2,28,2018-08-26T12:30:00Z,True,17,6,0,0,6,3,3,3,0,3,3,0
Chalobah,386,2,38,2018-09-02T15:00:00Z,True,17,16,4,1,9,6,3,9,3,6,0,0
Chalobah,386,2,48,2018-09-15T16:30:00Z,True,17,13,0,0,12,9,3,6,3,3,6,6
Chalobah,386,2,55,2018-09-22T11:30:00Z,False,17,8,0,0,12,9,3,4,3,1,8,0
Chalobah,386,2,60,2018-09-29T14:00:00Z,False,17,0,0,0,13,9,4,12,6,6,1,-2
Chalobah,386,2,79,2018-10-06T14:00:00Z,True,17,1,0,0,13,9,4,13,10,3,0,6
Chalobah,386,2,89,2018-10-20T14:00:00Z,False,17,19,0,0,13,9,4,15,8,7,-2,-4
Chalobah,386,2,99,2018-10-27T14:00:00Z,True,17,9,0,0,16,9,7,3,1,2,13,7
Chalobah,386,2,107,2018-11-03T15:00:00Z,False,17,14,5,1,19,12,7,3,0,3,16,7
Chalobah,386,2,119,2018-11-10T15:00:00Z,False,17,15,90,1,19,12,7,7,3,4,12,4
Chalobah,386,2,127,2018-11-24T15:00:00Z,True,17,11,0,0,20,12,8,30,16,14,-10,-2
Chalobah,386,2,135,2018-12-01T15:00:00Z,False,17,10,14,1,20,12,8,18,8,10,2,0
Chalobah,386,2,145,2018-12-04T20:00:00Z,True,17,12,62,2,20,12,8,38,24,14,-18,-2
Chalobah,386,2,155,2018-12-10T20:00:00Z,False,17,7,16,0,20,12,8,23,17,6,-3,-9
Chalobah,386,2,168,2018-12-15T15:00:00Z,True,17,4,0,0,21,12,9,14,13,1,7,11
Chalobah,386,2,178,2018-12-22T15:00:00Z,False,17,18,0,0,24,15,9,24,13,11,0,-4
Chalobah,386,2,189,2018-12-26T19:30:00Z,True,17,5,0,0,27,15,12,37,21,16,-10,-1
Chalobah,386,2,199,2018-12-29T15:00:00Z,True,17,14,0,0,27,15,12,17,7,10,10,5
Chalobah,386,2,201,2019-01-02T19:45:00Z,False,17,1,0,0,28,16,12,26,17,9,2,-5
Chalobah,386,2,214,2019-01-12T15:00:00Z,False,17,6,0,0,29,16,13,22,9,13,7,4
Chalobah,386,2,228,2019-01-19T15:00:00Z,True,17,3,0,0,32,16,16,21,13,8,11,8
Chalobah,386,2,239,2019-01-30T20:00:00Z,False,17,16,0,0,33,17,16,51,18,33,-18,-2
Chalobah,386,2,240,2019-02-02T15:00:00Z,False,17,2,0,0,33,17,16,26,18,8,7,-2
Chalobah,386,2,258,2019-02-09T15:00:00Z,True,17,7,1,1,34,17,17,33,21,12,1,5
Chalobah,386,2,263,2019-02-22T19:45:00Z,False,17,4,0,0,37,20,17,25,17,8,12,0
Chalobah,386,2,276,2019-02-27T20:00:00Z,False,17,11,0,0,40,20,20,66,35,31,-26,-15
Chalobah,386,2,287,2019-03-03T12:00:00Z,True,17,10,0,0,40,20,20,35,17,18,5,2
Chalobah,386,2,297,2019-03-09T17:30:00Z,False,17,12,0,0,43,23,20,71,42,29,-28,-22
Chalobah,386,2,318,2019-03-30T15:00:00Z,False,17,13,0,0,43,23,20,58,29,29,-15,-9
Chalobah,386,2,328,2019-04-02T18:45:00Z,True,17,8,0,0,43,23,20,17,15,2,26,21
Chalobah,386,2,339,2019-04-15T19:00:00Z,True,17,0,0,0,46,26,20,63,44,19,-17,7
Chalobah,386,2,345,2019-04-20T14:00:00Z,False,17,9,7,1,46,26,20,14,8,6,32,12
Chalobah,386,2,307,2019-04-23T18:45:00Z,True,17,15,0,0,49,26,23,36,21,15,13,11
Chalobah,386,2,359,2019-04-27T14:00:00Z,True,17,19,0,0,50,27,23,51,31,20,-1,7
Chalobah,386,2,363,2019-05-05T13:00:00Z,False,17,5,66,2,50,27,23,68,39,29,-18,-16
Chalobah,386,2,379,2019-05-12T14:00:00Z,True,17,18,0,0,50,27,23,49,31,18,1,9
Cleverley,387,2,8,2018-08-11T14:00:00Z,True,17,2,0,0,0,0,0,0,0,0,0,0
Cleverley,387,2,11,2018-08-19T12:30:00Z,False,17,3,0,0,3,3,0,1,0,1,2,0
Cleverley,387,2,28,2018-08-26T12:30:00Z,True,17,6,0,0,6,3,3,3,0,3,3,0
Cleverley,387,2,38,2018-09-02T15:00:00Z,True,17,16,0,0,9,6,3,9,3,6,0,0
Cleverley,387,2,48,2018-09-15T16:30:00Z,True,17,13,0,0,12,9,3,6,3,3,6,6
Cleverley,387,2,55,2018-09-22T11:30:00Z,False,17,8,0,0,12,9,3,4,3,1,8,0
Cleverley,387,2,60,2018-09-29T14:00:00Z,False,17,0,0,0,13,9,4,12,6,6,1,-2
Cleverley,387,2,79,2018-10-06T14:00:00Z,True,17,1,0,0,13,9,4,13,10,3,0,6
Cleverley,387,2,89,2018-10-20T14:00:00Z,False,17,19,0,0,13,9,4,15,8,7,-2,-4
Cleverley,387,2,99,2018-10-27T14:00:00Z,True,17,9,0,0,16,9,7,3,1,2,13,7
Cleverley,387,2,107,2018-11-03T15:00:00Z,False,17,14,0,0,19,12,7,3,0,3,16,7
Cleverley,387,2,119,2018-11-10T15:00:00Z,False,17,15,0,0,19,12,7,7,3,4,12,4
Cleverley,387,2,127,2018-11-24T15:00:00Z,True,17,11,0,0,20,12,8,30,16,14,-10,-2
Cleverley,387,2,135,2018-12-01T15:00:00Z,False,17,10,0,0,20,12,8,18,8,10,2,0
Cleverley,387,2,145,2018-12-04T20:00:00Z,True,17,12,0,0,20,12,8,38,24,14,-18,-2
Cleverley,387,2,155,2018-12-10T20:00:00Z,False,17,7,0,0,20,12,8,23,17,6,-3,-9
Cleverley,387,2,168,2018-12-15T15:00:00Z,True,17,4,3,1,21,12,9,14,13,1,7,11
Cleverley,387,2,178,2018-12-22T15:00:00Z,False,17,18,15,1,24,15,9,24,13,11,0,-4
Cleverley,387,2,189,2018-12-26T19:30:00Z,True,17,5,0,0,27,15,12,37,21,16,-10,-1
Cleverley,387,2,199,2018-12-29T15:00:00Z,True,17,14,0,0,27,15,12,17,7,10,10,5
Cleverley,387,2,201,2019-01-02T19:45:00Z,False,17,1,34,1,28,16,12,26,17,9,2,-5
Cleverley,387,2,214,2019-01-12T15:00:00Z,False,17,6,22,7,29,16,13,22,9,13,7,4
Cleverley,387,2,228,2019-01-19T15:00:00Z,True,17,3,90,3,32,16,16,21,13,8,11,8
Cleverley,387,2,239,2019-01-30T20:00:00Z,False,17,16,65,3,33,17,16,51,18,33,-18,-2
Cleverley,387,2,240,2019-02-02T15:00:00Z,False,17,2,90,3,33,17,16,26,18,8,7,-2
Cleverley,387,2,258,2019-02-09T15:00:00Z,True,17,7,9,1,34,17,17,33,21,12,1,5
Cleverley,387,2,263,2019-02-22T19:45:00Z,False,17,4,11,1,37,20,17,25,17,8,12,0
Cleverley,387,2,276,2019-02-27T20:00:00Z,False,17,11,17,1,40,20,20,66,35,31,-26,-15
Cleverley,387,2,287,2019-03-03T12:00:00Z,True,17,10,1,1,40,20,20,35,17,18,5,2
Cleverley,387,2,297,2019-03-09T17:30:00Z,False,17,12,90,1,43,23,20,71,42,29,-28,-22
Cleverley,387,2,318,2019-03-30T15:00:00Z,False,17,13,0,0,43,23,20,58,29,29,-15,-9
Cleverley,387,2,328,2019-04-02T18:45:00Z,True,17,8,0,0,43,23,20,17,15,2,26,21
Cleverley,387,2,339,2019-04-15T19:00:00Z,True,17,0,0,0,46,26,20,63,44,19,-17,7
Cleverley,387,2,345,2019-04-20T14:00:00Z,False,17,9,0,0,46,26,20,14,8,6,32,12
Cleverley,387,2,307,2019-04-23T18:45:00Z,True,17,15,0,0,49,26,23,36,21,15,13,11
Cleverley,387,2,359,2019-04-27T14:00:00Z,True,17,19,0,0,50,27,23,51,31,20,-1,7
Cleverley,387,2,363,2019-05-05T13:00:00Z,False,17,5,23,1,50,27,23,68,39,29,-18,-16
Cleverley,387,2,379,2019-05-12T14:00:00Z,True,17,18,0,0,50,27,23,49,31,18,1,9
Capoue,388,2,8,2018-08-11T14:00:00Z,True,17,2,90,2,0,0,0,0,0,0,0,0
Capoue,388,2,11,2018-08-19T12:30:00Z,False,17,3,90,2,3,3,0,1,0,1,2,0
Capoue,388,2,28,2018-08-26T12:30:00Z,True,17,6,90,6,6,3,3,3,0,3,3,0
Capoue,388,2,38,2018-09-02T15:00:00Z,True,17,16,90,1,9,6,3,9,3,6,0,0
Capoue,388,2,48,2018-09-15T16:30:00Z,True,17,13,90,1,12,9,3,6,3,3,6,6
Capoue,388,2,55,2018-09-22T11:30:00Z,False,17,8,90,5,12,9,3,4,3,1,8,0
Capoue,388,2,60,2018-09-29T14:00:00Z,False,17,0,90,2,13,9,4,12,6,6,1,-2
Capoue,388,2,79,2018-10-06T14:00:00Z,True,17,1,90,2,13,9,4,13,10,3,0,6
Capoue,388,2,89,2018-10-20T14:00:00Z,False,17,19,90,11,13,9,4,15,8,7,-2,-4
Capoue,388,2,99,2018-10-27T14:00:00Z,True,17,9,90,6,16,9,7,3,1,2,13,7
Capoue,388,2,107,2018-11-03T15:00:00Z,False,17,14,90,1,19,12,7,3,0,3,16,7
Capoue,388,2,119,2018-11-10T15:00:00Z,False,17,15,0,0,19,12,7,7,3,4,12,4
Capoue,388,2,127,2018-11-24T15:00:00Z,True,17,11,90,2,20,12,8,30,16,14,-10,-2
Capoue,388,2,135,2018-12-01T15:00:00Z,False,17,10,89,-1,20,12,8,18,8,10,2,0
Capoue,388,2,145,2018-12-04T20:00:00Z,True,17,12,0,0,20,12,8,38,24,14,-18,-2
Capoue,388,2,155,2018-12-10T20:00:00Z,False,17,7,0,0,20,12,8,23,17,6,-3,-9
Capoue,388,2,168,2018-12-15T15:00:00Z,True,17,4,0,0,21,12,9,14,13,1,7,11
Capoue,388,2,178,2018-12-22T15:00:00Z,False,17,18,90,3,24,15,9,24,13,11,0,-4
Capoue,388,2,189,2018-12-26T19:30:00Z,True,17,5,90,2,27,15,12,37,21,16,-10,-1
Capoue,388,2,199,2018-12-29T15:00:00Z,True,17,14,90,2,27,15,12,17,7,10,10,5
Capoue,388,2,201,2019-01-02T19:45:00Z,False,17,1,90,1,28,16,12,26,17,9,2,-5
Capoue,388,2,214,2019-01-12T15:00:00Z,False,17,6,90,2,29,16,13,22,9,13,7,4
Capoue,388,2,228,2019-01-19T15:00:00Z,True,17,3,90,3,32,16,16,21,13,8,11,8
Capoue,388,2,239,2019-01-30T20:00:00Z,False,17,16,90,1,33,17,16,51,18,33,-18,-2
Capoue,388,2,240,2019-02-02T15:00:00Z,False,17,2,90,3,33,17,16,26,18,8,7,-2
Capoue,388,2,258,2019-02-09T15:00:00Z,True,17,7,90,3,34,17,17,33,21,12,1,5
Capoue,388,2,263,2019-02-22T19:45:00Z,False,17,4,78,5,37,20,17,25,17,8,12,0
Capoue,388,2,276,2019-02-27T20:00:00Z,False,17,11,90,2,40,20,20,66,35,31,-26,-15
Capoue,388,2,287,2019-03-03T12:00:00Z,True,17,10,90,1,40,20,20,35,17,18,5,2
Capoue,388,2,297,2019-03-09T17:30:00Z,False,17,12,90,2,43,23,20,71,42,29,-28,-22
Capoue,388,2,318,2019-03-30T15:00:00Z,False,17,13,90,2,43,23,20,58,29,29,-15,-9
Capoue,388,2,328,2019-04-02T18:45:00Z,True,17,8,77,2,43,23,20,17,15,2,26,21
Capoue,388,2,339,2019-04-15T19:00:00Z,True,17,0,90,1,46,26,20,63,44,19,-17,7
Capoue,388,2,345,2019-04-20T14:00:00Z,False,17,9,90,1,46,26,20,14,8,6,32,12
Capoue,388,2,307,2019-04-23T18:45:00Z,True,17,15,90,1,49,26,23,36,21,15,13,11
Capoue,388,2,359,2019-04-27T14:00:00Z,True,17,19,90,1,50,27,23,51,31,20,-1,7
Capoue,388,2,363,2019-05-05T13:00:00Z,False,17,5,0,0,50,27,23,68,39,29,-18,-16
Capoue,388,2,379,2019-05-12T14:00:00Z,True,17,18,90,1,50,27,23,49,31,18,1,9
Doucoure,389,2,8,2018-08-11T14:00:00Z,True,17,2,90,3,0,0,0,0,0,0,0,0
Doucoure,389,2,11,2018-08-19T12:30:00Z,False,17,3,90,6,3,3,0,1,0,1,2,0
Doucoure,389,2,28,2018-08-26T12:30:00Z,True,17,6,90,2,6,3,3,3,0,3,3,0
Doucoure,389,2,38,2018-09-02T15:00:00Z,True,17,16,90,0,9,6,3,9,3,6,0,0
Doucoure,389,2,48,2018-09-15T16:30:00Z,True,17,13,90,8,12,9,3,6,3,3,6,6
Doucoure,389,2,55,2018-09-22T11:30:00Z,False,17,8,90,2,12,9,3,4,3,1,8,0
Doucoure,389,2,60,2018-09-29T14:00:00Z,False,17,0,90,1,13,9,4,12,6,6,1,-2
Doucoure,389,2,79,2018-10-06T14:00:00Z,True,17,1,90,1,13,9,4,13,10,3,0,6
Doucoure,389,2,89,2018-10-20T14:00:00Z,False,17,19,90,11,13,9,4,15,8,7,-2,-4
Doucoure,389,2,99,2018-10-27T14:00:00Z,True,17,9,90,3,16,9,7,3,1,2,13,7
Doucoure,389,2,107,2018-11-03T15:00:00Z,False,17,14,90,2,19,12,7,3,0,3,16,7
Doucoure,389,2,119,2018-11-10T15:00:00Z,False,17,15,90,2,19,12,7,7,3,4,12,4
Doucoure,389,2,127,2018-11-24T15:00:00Z,True,17,11,90,2,20,12,8,30,16,14,-10,-2
Doucoure,389,2,135,2018-12-01T15:00:00Z,False,17,10,90,2,20,12,8,18,8,10,2,0
Doucoure,389,2,145,2018-12-04T20:00:00Z,True,17,12,90,8,20,12,8,38,24,14,-18,-2
Doucoure,389,2,155,2018-12-10T20:00:00Z,False,17,7,90,8,20,12,8,23,17,6,-3,-9
Doucoure,389,2,168,2018-12-15T15:00:00Z,True,17,4,90,5,21,12,9,14,13,1,7,11
Doucoure,389,2,178,2018-12-22T15:00:00Z,False,17,18,90,3,24,15,9,24,13,11,0,-4
Doucoure,389,2,189,2018-12-26T19:30:00Z,True,17,5,90,2,27,15,12,37,21,16,-10,-1
Doucoure,389,2,199,2018-12-29T15:00:00Z,True,17,14,36,7,27,15,12,17,7,10,10,5
Doucoure,389,2,201,2019-01-02T19:45:00Z,False,17,1,55,0,28,16,12,26,17,9,2,-5
Doucoure,389,2,214,2019-01-12T15:00:00Z,False,17,6,90,2,29,16,13,22,9,13,7,4
Doucoure,389,2,228,2019-01-19T15:00:00Z,True,17,3,0,0,32,16,16,21,13,8,11,8
Doucoure,389,2,239,2019-01-30T20:00:00Z,False,17,16,0,0,33,17,16,51,18,33,-18,-2
Doucoure,389,2,240,2019-02-02T15:00:00Z,False,17,2,0,0,33,17,16,26,18,8,7,-2
Doucoure,389,2,258,2019-02-09T15:00:00Z,True,17,7,90,3,34,17,17,33,21,12,1,5
Doucoure,389,2,263,2019-02-22T19:45:00Z,False,17,4,90,6,37,20,17,25,17,8,12,0
Doucoure,389,2,276,2019-02-27T20:00:00Z,False,17,11,90,2,40,20,20,66,35,31,-26,-15
Doucoure,389,2,287,2019-03-03T12:00:00Z,True,17,10,90,1,40,20,20,35,17,18,5,2
Doucoure,389,2,297,2019-03-09T17:30:00Z,False,17,12,90,2,43,23,20,71,42,29,-28,-22
Doucoure,389,2,318,2019-03-30T15:00:00Z,False,17,13,90,10,43,23,20,58,29,29,-15,-9
Doucoure,389,2,328,2019-04-02T18:45:00Z,True,17,8,90,7,43,23,20,17,15,2,26,21
Doucoure,389,2,339,2019-04-15T19:00:00Z,True,17,0,90,2,46,26,20,63,44,19,-17,7
Doucoure,389,2,345,2019-04-20T14:00:00Z,False,17,9,90,5,46,26,20,14,8,6,32,12
Doucoure,389,2,307,2019-04-23T18:45:00Z,True,17,15,90,1,49,26,23,36,21,15,13,11
Doucoure,389,2,359,2019-04-27T14:00:00Z,True,17,19,90,2,50,27,23,51,31,20,-1,7
Doucoure,389,2,363,2019-05-05T13:00:00Z,False,17,5,90,1,50,27,23,68,39,29,-18,-16
Doucoure,389,2,379,2019-05-12T14:00:00Z,True,17,18,90,2,50,27,23,49,31,18,1,9
Pereyra,390,2,8,2018-08-11T14:00:00Z,True,17,2,86,16,0,0,0,0,0,0,0,0
Pereyra,390,2,11,2018-08-19T12:30:00Z,False,17,3,90,2,3,3,0,1,0,1,2,0
Pereyra,390,2,28,2018-08-26T12:30:00Z,True,17,6,90,8,6,3,3,3,0,3,3,0
Pereyra,390,2,38,2018-09-02T15:00:00Z,True,17,16,90,2,9,6,3,9,3,6,0,0
Pereyra,390,2,48,2018-09-15T16:30:00Z,True,17,13,90,2,12,9,3,6,3,3,6,6
Pereyra,390,2,55,2018-09-22T11:30:00Z,False,17,8,89,2,12,9,3,4,3,1,8,0
Pereyra,390,2,60,2018-09-29T14:00:00Z,False,17,0,90,2,13,9,4,12,6,6,1,-2
Pereyra,390,2,79,2018-10-06T14:00:00Z,True,17,1,73,2,13,9,4,13,10,3,0,6
Pereyra,390,2,89,2018-10-20T14:00:00Z,False,17,19,90,8,13,9,4,15,8,7,-2,-4
Pereyra,390,2,99,2018-10-27T14:00:00Z,True,17,9,90,11,16,9,7,3,1,2,13,7
Pereyra,390,2,107,2018-11-03T15:00:00Z,False,17,14,90,2,19,12,7,3,0,3,16,7
Pereyra,390,2,119,2018-11-10T15:00:00Z,False,17,15,67,2,19,12,7,7,3,4,12,4
Pereyra,390,2,127,2018-11-24T15:00:00Z,True,17,11,90,2,20,12,8,30,16,14,-10,-2
Pereyra,390,2,135,2018-12-01T15:00:00Z,False,17,10,54,1,20,12,8,18,8,10,2,0
Pereyra,390,2,145,2018-12-04T20:00:00Z,True,17,12,90,2,20,12,8,38,24,14,-18,-2
Pereyra,390,2,155,2018-12-10T20:00:00Z,False,17,7,90,8,20,12,8,23,17,6,-3,-9
Pereyra,390,2,168,2018-12-15T15:00:00Z,True,17,4,90,2,21,12,9,14,13,1,7,11
Pereyra,390,2,178,2018-12-22T15:00:00Z,False,17,18,90,12,24,15,9,24,13,11,0,-4
Pereyra,390,2,189,2018-12-26T19:30:00Z,True,17,5,90,9,27,15,12,37,21,16,-10,-1
Pereyra,390,2,199,2018-12-29T15:00:00Z,True,17,14,90,2,27,15,12,17,7,10,10,5
Pereyra,390,2,201,2019-01-02T19:45:00Z,False,17,1,90,2,28,16,12,26,17,9,2,-5
Pereyra,390,2,214,2019-01-12T15:00:00Z,False,17,6,90,1,29,16,13,22,9,13,7,4
Pereyra,390,2,228,2019-01-19T15:00:00Z,True,17,3,90,3,32,16,16,21,13,8,11,8
Pereyra,390,2,239,2019-01-30T20:00:00Z,False,17,16,90,2,33,17,16,51,18,33,-18,-2
Pereyra,390,2,240,2019-02-02T15:00:00Z,False,17,2,0,0,33,17,16,26,18,8,7,-2
Pereyra,390,2,258,2019-02-09T15:00:00Z,True,17,7,0,0,34,17,17,33,21,12,1,5
Pereyra,390,2,263,2019-02-22T19:45:00Z,False,17,4,70,2,37,20,17,25,17,8,12,0
Pereyra,390,2,276,2019-02-27T20:00:00Z,False,17,11,83,2,40,20,20,66,35,31,-26,-15
Pereyra,390,2,287,2019-03-03T12:00:00Z,True,17,10,90,2,40,20,20,35,17,18,5,2
Pereyra,390,2,297,2019-03-09T17:30:00Z,False,17,12,0,0,43,23,20,71,42,29,-28,-22
Pereyra,390,2,318,2019-03-30T15:00:00Z,False,17,13,90,2,43,23,20,58,29,29,-15,-9
Pereyra,390,2,328,2019-04-02T18:45:00Z,True,17,8,45,1,43,23,20,17,15,2,26,21
Pereyra,390,2,339,2019-04-15T19:00:00Z,True,17,0,0,0,46,26,20,63,44,19,-17,7
Pereyra,390,2,345,2019-04-20T14:00:00Z,False,17,9,0,0,46,26,20,14,8,6,32,12
Pereyra,390,2,307,2019-04-23T18:45:00Z,True,17,15,90,2,49,26,23,36,21,15,13,11
Pereyra,390,2,359,2019-04-27T14:00:00Z,True,17,19,90,2,50,27,23,51,31,20,-1,7
Pereyra,390,2,363,2019-05-05T13:00:00Z,False,17,5,90,2,50,27,23,68,39,29,-18,-16
Pereyra,390,2,379,2019-05-12T14:00:00Z,True,17,18,90,2,50,27,23,49,31,18,1,9
Hughes,391,2,8,2018-08-11T14:00:00Z,True,17,2,80,3,0,0,0,0,0,0,0,0
Hughes,391,2,11,2018-08-19T12:30:00Z,False,17,3,82,8,3,3,0,1,0,1,2,0
Hughes,391,2,28,2018-08-26T12:30:00Z,True,17,6,90,2,6,3,3,3,0,3,3,0
Hughes,391,2,38,2018-09-02T15:00:00Z,True,17,16,85,2,9,6,3,9,3,6,0,0
Hughes,391,2,48,2018-09-15T16:30:00Z,True,17,13,90,2,12,9,3,6,3,3,6,6
Hughes,391,2,55,2018-09-22T11:30:00Z,False,17,8,69,6,12,9,3,4,3,1,8,0
Hughes,391,2,60,2018-09-29T14:00:00Z,False,17,0,90,2,13,9,4,12,6,6,1,-2
Hughes,391,2,79,2018-10-06T14:00:00Z,True,17,1,54,1,13,9,4,13,10,3,0,6
Hughes,391,2,89,2018-10-20T14:00:00Z,False,17,19,90,2,13,9,4,15,8,7,-2,-4
Hughes,391,2,99,2018-10-27T14:00:00Z,True,17,9,90,3,16,9,7,3,1,2,13,7
Hughes,391,2,107,2018-11-03T15:00:00Z,False,17,14,76,1,19,12,7,3,0,3,16,7
Hughes,391,2,119,2018-11-10T15:00:00Z,False,17,15,39,1,19,12,7,7,3,4,12,4
Hughes,391,2,127,2018-11-24T15:00:00Z,True,17,11,74,2,20,12,8,30,16,14,-10,-2
Hughes,391,2,135,2018-12-01T15:00:00Z,False,17,10,75,2,20,12,8,18,8,10,2,0
Hughes,391,2,145,2018-12-04T20:00:00Z,True,17,12,51,1,20,12,8,38,24,14,-18,-2
Hughes,391,2,155,2018-12-10T20:00:00Z,False,17,7,0,0,20,12,8,23,17,6,-3,-9
Hughes,391,2,168,2018-12-15T15:00:00Z,True,17,4,0,0,21,12,9,14,13,1,7,11
Hughes,391,2,178,2018-12-22T15:00:00Z,False,17,18,0,0,24,15,9,24,13,11,0,-4
Hughes,391,2,189,2018-12-26T19:30:00Z,True,17,5,0,0,27,15,12,37,21,16,-10,-1
Hughes,391,2,199,2018-12-29T15:00:00Z,True,17,14,53,1,27,15,12,17,7,10,10,5
Hughes,391,2,201,2019-01-02T19:45:00Z,False,17,1,19,1,28,16,12,26,17,9,2,-5
Hughes,391,2,214,2019-01-12T15:00:00Z,False,17,6,18,1,29,16,13,22,9,13,7,4
Hughes,391,2,228,2019-01-19T15:00:00Z,True,17,3,0,0,32,16,16,21,13,8,11,8
Hughes,391,2,239,2019-01-30T20:00:00Z,False,17,16,90,2,33,17,16,51,18,33,-18,-2
Hughes,391,2,240,2019-02-02T15:00:00Z,False,17,2,90,3,33,17,16,26,18,8,7,-2
Hughes,391,2,258,2019-02-09T15:00:00Z,True,17,7,89,6,34,17,17,33,21,12,1,5
Hughes,391,2,263,2019-02-22T19:45:00Z,False,17,4,90,5,37,20,17,25,17,8,12,0
Hughes,391,2,276,2019-02-27T20:00:00Z,False,17,11,90,2,40,20,20,66,35,31,-26,-15
Hughes,391,2,287,2019-03-03T12:00:00Z,True,17,10,90,2,40,20,20,35,17,18,5,2
Hughes,391,2,297,2019-03-09T17:30:00Z,False,17,12,0,0,43,23,20,71,42,29,-28,-22
Hughes,391,2,318,2019-03-30T15:00:00Z,False,17,13,80,1,43,23,20,58,29,29,-15,-9
Hughes,391,2,328,2019-04-02T18:45:00Z,True,17,8,90,13,43,23,20,17,15,2,26,21
Hughes,391,2,339,2019-04-15T19:00:00Z,True,17,0,90,1,46,26,20,63,44,19,-17,7
Hughes,391,2,345,2019-04-20T14:00:00Z,False,17,9,90,3,46,26,20,14,8,6,32,12
Hughes,391,2,307,2019-04-23T18:45:00Z,True,17,15,76,2,49,26,23,36,21,15,13,11
Hughes,391,2,359,2019-04-27T14:00:00Z,True,17,19,73,2,50,27,23,51,31,20,-1,7
Hughes,391,2,363,2019-05-05T13:00:00Z,False,17,5,90,2,50,27,23,68,39,29,-18,-16
Hughes,391,2,379,2019-05-12T14:00:00Z,True,17,18,66,2,50,27,23,49,31,18,1,9
Richarlison,392,2,9,2018-08-11T16:30:00Z,False,7,19,85,14,0,0,0,0,0,0,0,0
Richarlison,392,2,15,2018-08-18T14:00:00Z,True,7,15,85,9,1,0,1,1,1,0,0,0
Richarlison,392,2,21,2018-08-25T14:00:00Z,False,7,1,40,-2,4,3,1,6,3,3,-2,-2
Richarlison,392,2,35,2018-09-01T14:00:00Z,True,7,9,0,0,5,3,2,1,1,0,4,3
Richarlison,392,2,42,2018-09-16T15:00:00Z,True,7,18,0,0,6,4,2,0,0,0,6,4
Richarlison,392,2,50,2018-09-23T15:00:00Z,False,7,0,90,2,6,4,2,9,3,6,-3,-1
Richarlison,392,2,64,2018-09-29T14:00:00Z,True,7,8,87,3,6,4,2,5,4,1,1,3
Richarlison,392,2,74,2018-10-06T14:00:00Z,False,7,10,90,7,9,7,2,12,6,6,-3,-4
Richarlison,392,2,84,2018-10-21T15:00:00Z,True,7,6,90,3,12,7,5,7,1,6,5,1
Richarlison,392,2,96,2018-10-28T16:00:00Z,False,7,13,90,5,15,10,5,14,7,7,1,-2
Richarlison,392,2,104,2018-11-03T15:00:00Z,True,7,2,90,15,15,10,5,14,10,4,1,6
Richarlison,392,2,112,2018-11-11T14:15:00Z,False,7,5,88,3,18,13,5,27,14,13,-9,-9
Richarlison,392,2,123,2018-11-24T15:00:00Z,True,7,4,90,3,19,13,6,8,7,1,11,12
Richarlison,392,2,136,2018-12-02T16:15:00Z,False,7,11,90,2,22,16,6,33,16,17,-11,-10
Richarlison,392,2,148,2018-12-05T19:45:00Z,True,7,14,90,10,22,16,6,12,6,6,10,10
Richarlison,392,2,155,2018-12-10T20:00:00Z,True,7,17,90,7,23,17,6,20,12,8,3,9
Richarlison,392,2,165,2018-12-15T12:30:00Z,False,7,12,90,2,24,18,6,41,24,17,-17,-18
Richarlison,392,2,174,2018-12-23T16:00:00Z,True,7,16,74,5,24,18,6,39,15,24,-15,-6
Richarlison,392,2,181,2018-12-26T15:00:00Z,False,7,3,23,5,24,18,6,12,7,5,12,-1
Richarlison,392,2,190,2018-12-29T15:00:00Z,False,7,2,90,2,27,18,9,22,15,7,5,-6
Richarlison,392,2,204,2019-01-01T12:30:00Z,True,7,10,90,2,27,18,9,28,14,14,-1,4
Richarlison,392,2,215,2019-01-13T14:15:00Z,True,7,1,86,2,27,18,9,27,18,9,0,9
Richarlison,392,2,227,2019-01-19T15:00:00Z,False,7,15,64,2,30,21,9,19,8,11,11,1
Richarlison,392,2,233,2019-01-29T19:45:00Z,False,7,9,85,8,30,21,9,11,5,6,19,4
Richarlison,392,2,245,2019-02-02T15:00:00Z,True,7,19,90,2,33,21,12,35,20,15,-2,6
Richarlison,392,2,265,2019-02-06T19:45:00Z,True,7,12,17,1,33,21,12,59,36,23,-26,-2
Richarlison,392,2,258,2019-02-09T15:00:00Z,False,7,17,65,2,33,21,12,34,17,17,-1,-5
Richarlison,392,2,271,2019-02-26T19:45:00Z,False,7,4,60,3,33,21,12,25,17,8,8,-5
Richarlison,392,2,283,2019-03-03T16:15:00Z,True,7,11,31,1,36,21,15,69,38,31,-33,-10
Richarlison,392,2,298,2019-03-09T15:00:00Z,False,7,14,74,8,37,22,15,31,19,12,6,-4
Richarlison,392,2,303,2019-03-17T16:30:00Z,True,7,5,90,8,37,22,15,57,32,25,-20,-3
Richarlison,392,2,319,2019-03-30T17:30:00Z,False,7,18,89,2,40,25,15,42,27,15,-2,-12
Richarlison,392,2,322,2019-04-07T13:05:00Z,True,7,0,78,3,43,25,18,63,44,19,-20,6
Richarlison,392,2,333,2019-04-13T14:00:00Z,False,7,8,83,1,46,28,18,17,15,2,29,3
Richarlison,392,2,344,2019-04-21T12:30:00Z,True,7,13,50,6,46,28,18,64,35,29,-18,-1
Richarlison,392,2,352,2019-04-27T14:00:00Z,False,7,6,90,3,49,31,18,42,16,26,7,2
Richarlison,392,2,364,2019-05-03T19:00:00Z,True,7,3,48,4,50,31,19,40,23,17,10,14
Richarlison,392,2,378,2019-05-12T14:00:00Z,False,7,16,0,0,53,34,19,70,37,33,-17,-18
Deulofeu,393,2,8,2018-08-11T14:00:00Z,True,17,2,0,0,0,0,0,0,0,0,0,0
Deulofeu,393,2,11,2018-08-19T12:30:00Z,False,17,3,0,0,3,3,0,1,0,1,2,0
Deulofeu,393,2,28,2018-08-26T12:30:00Z,True,17,6,0,0,6,3,3,3,0,3,3,0
Deulofeu,393,2,38,2018-09-02T15:00:00Z,True,17,16,0,0,9,6,3,9,3,6,0,0
Deulofeu,393,2,48,2018-09-15T16:30:00Z,True,17,13,0,0,12,9,3,6,3,3,6,6
Deulofeu,393,2,55,2018-09-22T11:30:00Z,False,17,8,0,0,12,9,3,4,3,1,8,0
Deulofeu,393,2,60,2018-09-29T14:00:00Z,False,17,0,0,0,13,9,4,12,6,6,1,-2
Deulofeu,393,2,79,2018-10-06T14:00:00Z,True,17,1,16,1,13,9,4,13,10,3,0,6
Deulofeu,393,2,89,2018-10-20T14:00:00Z,False,17,19,68,3,13,9,4,15,8,7,-2,-4
Deulofeu,393,2,99,2018-10-27T14:00:00Z,True,17,9,64,8,16,9,7,3,1,2,13,7
Deulofeu,393,2,107,2018-11-03T15:00:00Z,False,17,14,65,2,19,12,7,3,0,3,16,7
Deulofeu,393,2,119,2018-11-10T15:00:00Z,False,17,15,90,4,19,12,7,7,3,4,12,4
Deulofeu,393,2,127,2018-11-24T15:00:00Z,True,17,11,56,1,20,12,8,30,16,14,-10,-2
Deulofeu,393,2,135,2018-12-01T15:00:00Z,False,17,10,54,1,20,12,8,18,8,10,2,0
Deulofeu,393,2,145,2018-12-04T20:00:00Z,True,17,12,27,1,20,12,8,38,24,14,-18,-2
Deulofeu,393,2,155,2018-12-10T20:00:00Z,False,17,7,30,1,20,12,8,23,17,6,-3,-9
Deulofeu,393,2,168,2018-12-15T15:00:00Z,True,17,4,86,13,21,12,9,14,13,1,7,11
Deulofeu,393,2,178,2018-12-22T15:00:00Z,False,17,18,90,9,24,15,9,24,13,11,0,-4
Deulofeu,393,2,189,2018-12-26T19:30:00Z,True,17,5,81,2,27,15,12,37,21,16,-10,-1
Deulofeu,393,2,199,2018-12-29T15:00:00Z,True,17,14,90,5,27,15,12,17,7,10,10,5
Deulofeu,393,2,201,2019-01-02T19:45:00Z,False,17,1,89,2,28,16,12,26,17,9,2,-5
Deulofeu,393,2,214,2019-01-12T15:00:00Z,False,17,6,90,2,29,16,13,22,9,13,7,4
Deulofeu,393,2,228,2019-01-19T15:00:00Z,True,17,3,90,2,32,16,16,21,13,8,11,8
Deulofeu,393,2,239,2019-01-30T20:00:00Z,False,17,16,60,3,33,17,16,51,18,33,-18,-2
Deulofeu,393,2,240,2019-02-02T15:00:00Z,False,17,2,69,3,33,17,16,26,18,8,7,-2
Deulofeu,393,2,258,2019-02-09T15:00:00Z,True,17,7,80,3,34,17,17,33,21,12,1,5
Deulofeu,393,2,263,2019-02-22T19:45:00Z,False,17,4,85,23,37,20,17,25,17,8,12,0
Deulofeu,393,2,276,2019-02-27T20:00:00Z,False,17,11,72,2,40,20,20,66,35,31,-26,-15
Deulofeu,393,2,287,2019-03-03T12:00:00Z,True,17,10,68,6,40,20,20,35,17,18,5,2
Deulofeu,393,2,297,2019-03-09T17:30:00Z,False,17,12,24,6,43,23,20,71,42,29,-28,-22
Deulofeu,393,2,318,2019-03-30T15:00:00Z,False,17,13,73,2,43,23,20,58,29,29,-15,-9
Deulofeu,393,2,328,2019-04-02T18:45:00Z,True,17,8,45,1,43,23,20,17,15,2,26,21
Deulofeu,393,2,339,2019-04-15T19:00:00Z,True,17,0,0,0,46,26,20,63,44,19,-17,7
Deulofeu,393,2,345,2019-04-20T14:00:00Z,False,17,9,82,16,46,26,20,14,8,6,32,12
Deulofeu,393,2,307,2019-04-23T18:45:00Z,True,17,15,90,1,49,26,23,36,21,15,13,11
Deulofeu,393,2,359,2019-04-27T14:00:00Z,True,17,19,90,2,50,27,23,51,31,20,-1,7
Deulofeu,393,2,363,2019-05-05T13:00:00Z,False,17,5,82,2,50,27,23,68,39,29,-18,-16
Deulofeu,393,2,379,2019-05-12T14:00:00Z,True,17,18,58,6,50,27,23,49,31,18,1,9
Gray,394,3,8,2018-08-11T14:00:00Z,True,17,2,73,2,0,0,0,0,0,0,0,0
Gray,394,3,11,2018-08-19T12:30:00Z,False,17,3,67,6,3,3,0,1,0,1,2,0
Gray,394,3,28,2018-08-26T12:30:00Z,True,17,6,72,2,6,3,3,3,0,3,3,0
Gray,394,3,38,2018-09-02T15:00:00Z,True,17,16,69,2,9,6,3,9,3,6,0,0
Gray,394,3,48,2018-09-15T16:30:00Z,True,17,13,90,8,12,9,3,6,3,3,6,6
Gray,394,3,55,2018-09-22T11:30:00Z,False,17,8,79,6,12,9,3,4,3,1,8,0
Gray,394,3,60,2018-09-29T14:00:00Z,False,17,0,71,2,13,9,4,12,6,6,1,-2
Gray,394,3,79,2018-10-06T14:00:00Z,True,17,1,54,1,13,9,4,13,10,3,0,6
Gray,394,3,89,2018-10-20T14:00:00Z,False,17,19,21,1,13,9,4,15,8,7,-2,-4
Gray,394,3,99,2018-10-27T14:00:00Z,True,17,9,7,1,16,9,7,3,1,2,13,7
Gray,394,3,107,2018-11-03T15:00:00Z,False,17,14,24,0,19,12,7,3,0,3,16,7
Gray,394,3,119,2018-11-10T15:00:00Z,False,17,15,22,1,19,12,7,7,3,4,12,4
Gray,394,3,127,2018-11-24T15:00:00Z,True,17,11,15,1,20,12,8,30,16,14,-10,-2
Gray,394,3,135,2018-12-01T15:00:00Z,False,17,10,35,1,20,12,8,18,8,10,2,0
Gray,394,3,145,2018-12-04T20:00:00Z,True,17,12,15,1,20,12,8,38,24,14,-18,-2
Gray,394,3,155,2018-12-10T20:00:00Z,False,17,7,0,0,20,12,8,23,17,6,-3,-9
Gray,394,3,168,2018-12-15T15:00:00Z,True,17,4,0,0,21,12,9,14,13,1,7,11
Gray,394,3,178,2018-12-22T15:00:00Z,False,17,18,0,0,24,15,9,24,13,11,0,-4
Gray,394,3,189,2018-12-26T19:30:00Z,True,17,5,0,0,27,15,12,37,21,16,-10,-1
Gray,394,3,199,2018-12-29T15:00:00Z,True,17,14,0,0,27,15,12,17,7,10,10,5
Gray,394,3,201,2019-01-02T19:45:00Z,False,17,1,0,0,28,16,12,26,17,9,2,-5
Gray,394,3,214,2019-01-12T15:00:00Z,False,17,6,0,0,29,16,13,22,9,13,7,4
Gray,394,3,228,2019-01-19T15:00:00Z,True,17,3,0,0,32,16,16,21,13,8,11,8
Gray,394,3,239,2019-01-30T20:00:00Z,False,17,16,0,0,33,17,16,51,18,33,-18,-2
Gray,394,3,240,2019-02-02T15:00:00Z,False,17,2,20,1,33,17,16,26,18,8,7,-2
Gray,394,3,258,2019-02-09T15:00:00Z,True,17,7,45,7,34,17,17,33,21,12,1,5
Gray,394,3,263,2019-02-22T19:45:00Z,False,17,4,4,1,37,20,17,25,17,8,12,0
Gray,394,3,276,2019-02-27T20:00:00Z,False,17,11,17,1,40,20,20,66,35,31,-26,-15
Gray,394,3,287,2019-03-03T12:00:00Z,True,17,10,21,5,40,20,20,35,17,18,5,2
Gray,394,3,297,2019-03-09T17:30:00Z,False,17,12,90,2,43,23,20,71,42,29,-28,-22
Gray,394,3,318,2019-03-30T15:00:00Z,False,17,13,17,1,43,23,20,58,29,29,-15,-9
Gray,394,3,328,2019-04-02T18:45:00Z,True,17,8,45,7,43,23,20,17,15,2,26,21
Gray,394,3,339,2019-04-15T19:00:00Z,True,17,0,90,2,46,26,20,63,44,19,-17,7
Gray,394,3,345,2019-04-20T14:00:00Z,False,17,9,71,2,46,26,20,14,8,6,32,12
Gray,394,3,307,2019-04-23T18:45:00Z,True,17,15,90,9,49,26,23,36,21,15,13,11
Gray,394,3,359,2019-04-27T14:00:00Z,True,17,19,90,8,50,27,23,51,31,20,-1,7
Gray,394,3,363,2019-05-05T13:00:00Z,False,17,5,7,1,50,27,23,68,39,29,-18,-16
Gray,394,3,379,2019-05-12T14:00:00Z,True,17,18,31,1,50,27,23,49,31,18,1,9
Deeney,395,3,8,2018-08-11T14:00:00Z,True,17,2,90,2,0,0,0,0,0,0,0,0
Deeney,395,3,11,2018-08-19T12:30:00Z,False,17,3,88,12,3,3,0,1,0,1,2,0
Deeney,395,3,28,2018-08-26T12:30:00Z,True,17,6,90,2,6,3,3,3,0,3,3,0
Deeney,395,3,38,2018-09-02T15:00:00Z,True,17,16,90,7,9,6,3,9,3,6,0,0
Deeney,395,3,48,2018-09-15T16:30:00Z,True,17,13,90,2,12,9,3,6,3,3,6,6
Deeney,395,3,55,2018-09-22T11:30:00Z,False,17,8,90,2,12,9,3,4,3,1,8,0
Deeney,395,3,60,2018-09-29T14:00:00Z,False,17,0,90,1,13,9,4,12,6,6,1,-2
Deeney,395,3,79,2018-10-06T14:00:00Z,True,17,1,90,2,13,9,4,13,10,3,0,6
Deeney,395,3,89,2018-10-20T14:00:00Z,False,17,19,0,0,13,9,4,15,8,7,-2,-4
Deeney,395,3,99,2018-10-27T14:00:00Z,True,17,9,0,0,16,9,7,3,1,2,13,7
Deeney,395,3,107,2018-11-03T15:00:00Z,False,17,14,0,0,19,12,7,3,0,3,16,7
Deeney,395,3,119,2018-11-10T15:00:00Z,False,17,15,50,1,19,12,7,7,3,4,12,4
Deeney,395,3,127,2018-11-24T15:00:00Z,True,17,11,90,2,20,12,8,30,16,14,-10,-2
Deeney,395,3,135,2018-12-01T15:00:00Z,False,17,10,35,1,20,12,8,18,8,10,2,0
Deeney,395,3,145,2018-12-04T20:00:00Z,True,17,12,90,2,20,12,8,38,24,14,-18,-2
Deeney,395,3,155,2018-12-10T20:00:00Z,False,17,7,90,2,20,12,8,23,17,6,-3,-9
Deeney,395,3,168,2018-12-15T15:00:00Z,True,17,4,80,2,21,12,9,14,13,1,7,11
Deeney,395,3,178,2018-12-22T15:00:00Z,False,17,18,85,6,24,15,9,24,13,11,0,-4
Deeney,395,3,189,2018-12-26T19:30:00Z,True,17,5,90,2,27,15,12,37,21,16,-10,-1
Deeney,395,3,199,2018-12-29T15:00:00Z,True,17,14,36,1,27,15,12,17,7,10,10,5
Deeney,395,3,201,2019-01-02T19:45:00Z,False,17,1,90,15,28,16,12,26,17,9,2,-5
Deeney,395,3,214,2019-01-12T15:00:00Z,False,17,6,90,2,29,16,13,22,9,13,7,4
Deeney,395,3,228,2019-01-19T15:00:00Z,True,17,3,90,2,32,16,16,21,13,8,11,8
Deeney,395,3,239,2019-01-30T20:00:00Z,False,17,16,90,2,33,17,16,51,18,33,-18,-2
Deeney,395,3,240,2019-02-02T15:00:00Z,False,17,2,90,2,33,17,16,26,18,8,7,-2
Deeney,395,3,258,2019-02-09T15:00:00Z,True,17,7,90,1,34,17,17,33,21,12,1,5
Deeney,395,3,263,2019-02-22T19:45:00Z,False,17,4,90,15,37,20,17,25,17,8,12,0
Deeney,395,3,276,2019-02-27T20:00:00Z,False,17,11,72,2,40,20,20,66,35,31,-26,-15
Deeney,395,3,287,2019-03-03T12:00:00Z,True,17,10,90,11,40,20,20,35,17,18,5,2
Deeney,395,3,297,2019-03-09T17:30:00Z,False,17,12,24,4,43,23,20,71,42,29,-28,-22
Deeney,395,3,318,2019-03-30T15:00:00Z,False,17,13,90,2,43,23,20,58,29,29,-15,-9
Deeney,395,3,328,2019-04-02T18:45:00Z,True,17,8,90,7,43,23,20,17,15,2,26,21
Deeney,395,3,339,2019-04-15T19:00:00Z,True,17,0,10,-2,46,26,20,63,44,19,-17,7
Deeney,395,3,345,2019-04-20T14:00:00Z,False,17,9,0,0,46,26,20,14,8,6,32,12
Deeney,395,3,307,2019-04-23T18:45:00Z,True,17,15,0,0,49,26,23,36,21,15,13,11
Deeney,395,3,359,2019-04-27T14:00:00Z,True,17,19,0,0,50,27,23,51,31,20,-1,7
Deeney,395,3,363,2019-05-05T13:00:00Z,False,17,5,82,2,50,27,23,68,39,29,-18,-16
Deeney,395,3,379,2019-05-12T14:00:00Z,True,17,18,90,2,50,27,23,49,31,18,1,9
Okaka,396,3,8,2018-08-11T14:00:00Z,True,17,2,0,0,0,0,0,0,0,0,0,0
Okaka,396,3,11,2018-08-19T12:30:00Z,False,17,3,0,0,3,3,0,1,0,1,2,0
Okaka,396,3,28,2018-08-26T12:30:00Z,True,17,6,0,0,6,3,3,3,0,3,3,0
Okaka,396,3,38,2018-09-02T15:00:00Z,True,17,16,0,0,9,6,3,9,3,6,0,0
Okaka,396,3,48,2018-09-15T16:30:00Z,True,17,13,0,0,12,9,3,6,3,3,6,6
Okaka,396,3,55,2018-09-22T11:30:00Z,False,17,8,0,0,12,9,3,4,3,1,8,0
Okaka,396,3,60,2018-09-29T14:00:00Z,False,17,0,0,0,13,9,4,12,6,6,1,-2
Okaka,396,3,79,2018-10-06T14:00:00Z,True,17,1,0,0,13,9,4,13,10,3,0,6
Okaka,396,3,89,2018-10-20T14:00:00Z,False,17,19,0,0,13,9,4,15,8,7,-2,-4
Okaka,396,3,99,2018-10-27T14:00:00Z,True,17,9,0,0,16,9,7,3,1,2,13,7
Okaka,396,3,107,2018-11-03T15:00:00Z,False,17,14,13,0,19,12,7,3,0,3,16,7
Okaka,396,3,119,2018-11-10T15:00:00Z,False,17,15,0,0,19,12,7,7,3,4,12,4
Okaka,396,3,127,2018-11-24T15:00:00Z,True,17,11,0,0,20,12,8,30,16,14,-10,-2
Okaka,396,3,135,2018-12-01T15:00:00Z,False,17,10,0,0,20,12,8,18,8,10,2,0
Okaka,396,3,145,2018-12-04T20:00:00Z,True,17,12,0,0,20,12,8,38,24,14,-18,-2
Okaka,396,3,155,2018-12-10T20:00:00Z,False,17,7,0,0,20,12,8,23,17,6,-3,-9
Okaka,396,3,168,2018-12-15T15:00:00Z,True,17,4,9,1,21,12,9,14,13,1,7,11
Okaka,396,3,178,2018-12-22T15:00:00Z,False,17,18,0,0,24,15,9,24,13,11,0,-4
Okaka,396,3,189,2018-12-26T19:30:00Z,True,17,5,0,0,27,15,12,37,21,16,-10,-1
Okaka,396,3,199,2018-12-29T15:00:00Z,True,17,14,0,0,27,15,12,17,7,10,10,5
Okaka,396,3,201,2019-01-02T19:45:00Z,False,17,1,0,0,28,16,12,26,17,9,2,-5
Okaka,396,3,214,2019-01-12T15:00:00Z,False,17,6,0,0,29,16,13,22,9,13,7,4
Okaka,396,3,228,2019-01-19T15:00:00Z,True,17,3,0,0,32,16,16,21,13,8,11,8
Okaka,396,3,239,2019-01-30T20:00:00Z,False,17,16,0,0,33,17,16,51,18,33,-18,-2
Okaka,396,3,240,2019-02-02T15:00:00Z,False,17,2,0,0,33,17,16,26,18,8,7,-2
Okaka,396,3,258,2019-02-09T15:00:00Z,True,17,7,0,0,34,17,17,33,21,12,1,5
Okaka,396,3,263,2019-02-22T19:45:00Z,False,17,4,0,0,37,20,17,25,17,8,12,0
Okaka,396,3,276,2019-02-27T20:00:00Z,False,17,11,0,0,40,20,20,66,35,31,-26,-15
Okaka,396,3,287,2019-03-03T12:00:00Z,True,17,10,0,0,40,20,20,35,17,18,5,2
Okaka,396,3,297,2019-03-09T17:30:00Z,False,17,12,0,0,43,23,20,71,42,29,-28,-22
Okaka,396,3,318,2019-03-30T15:00:00Z,False,17,13,0,0,43,23,20,58,29,29,-15,-9
Okaka,396,3,328,2019-04-02T18:45:00Z,True,17,8,0,0,43,23,20,17,15,2,26,21
Okaka,396,3,339,2019-04-15T19:00:00Z,True,17,0,0,0,46,26,20,63,44,19,-17,7
Okaka,396,3,345,2019-04-20T14:00:00Z,False,17,9,0,0,46,26,20,14,8,6,32,12
Okaka,396,3,307,2019-04-23T18:45:00Z,True,17,15,0,0,49,26,23,36,21,15,13,11
Okaka,396,3,359,2019-04-27T14:00:00Z,True,17,19,0,0,50,27,23,51,31,20,-1,7
Okaka,396,3,363,2019-05-05T13:00:00Z,False,17,5,0,0,50,27,23,68,39,29,-18,-16
Okaka,396,3,379,2019-05-12T14:00:00Z,True,17,18,0,0,50,27,23,49,31,18,1,9
Sinclair,397,3,8,2018-08-11T14:00:00Z,True,17,2,0,0,0,0,0,0,0,0,0,0
Sinclair,397,3,11,2018-08-19T12:30:00Z,False,17,3,0,0,3,3,0,1,0,1,2,0
Sinclair,397,3,28,2018-08-26T12:30:00Z,True,17,6,0,0,6,3,3,3,0,3,3,0
Sinclair,397,3,38,2018-09-02T15:00:00Z,True,17,16,0,0,9,6,3,9,3,6,0,0
Sinclair,397,3,48,2018-09-15T16:30:00Z,True,17,13,0,0,12,9,3,6,3,3,6,6
Sinclair,397,3,55,2018-09-22T11:30:00Z,False,17,8,0,0,12,9,3,4,3,1,8,0
Sinclair,397,3,60,2018-09-29T14:00:00Z,False,17,0,0,0,13,9,4,12,6,6,1,-2
Sinclair,397,3,79,2018-10-06T14:00:00Z,True,17,1,0,0,13,9,4,13,10,3,0,6
Sinclair,397,3,89,2018-10-20T14:00:00Z,False,17,19,0,0,13,9,4,15,8,7,-2,-4
Sinclair,397,3,99,2018-10-27T14:00:00Z,True,17,9,0,0,16,9,7,3,1,2,13,7
Sinclair,397,3,107,2018-11-03T15:00:00Z,False,17,14,0,0,19,12,7,3,0,3,16,7
Sinclair,397,3,119,2018-11-10T15:00:00Z,False,17,15,0,0,19,12,7,7,3,4,12,4
Sinclair,397,3,127,2018-11-24T15:00:00Z,True,17,11,0,0,20,12,8,30,16,14,-10,-2
Sinclair,397,3,135,2018-12-01T15:00:00Z,False,17,10,0,0,20,12,8,18,8,10,2,0
Sinclair,397,3,145,2018-12-04T20:00:00Z,True,17,12,0,0,20,12,8,38,24,14,-18,-2
Sinclair,397,3,155,2018-12-10T20:00:00Z,False,17,7,0,0,20,12,8,23,17,6,-3,-9
Sinclair,397,3,168,2018-12-15T15:00:00Z,True,17,4,0,0,21,12,9,14,13,1,7,11
Sinclair,397,3,178,2018-12-22T15:00:00Z,False,17,18,0,0,24,15,9,24,13,11,0,-4
Sinclair,397,3,189,2018-12-26T19:30:00Z,True,17,5,0,0,27,15,12,37,21,16,-10,-1
Sinclair,397,3,199,2018-12-29T15:00:00Z,True,17,14,0,0,27,15,12,17,7,10,10,5
Sinclair,397,3,201,2019-01-02T19:45:00Z,False,17,1,0,0,28,16,12,26,17,9,2,-5
Sinclair,397,3,214,2019-01-12T15:00:00Z,False,17,6,0,0,29,16,13,22,9,13,7,4
Sinclair,397,3,228,2019-01-19T15:00:00Z,True,17,3,0,0,32,16,16,21,13,8,11,8
Sinclair,397,3,239,2019-01-30T20:00:00Z,False,17,16,0,0,33,17,16,51,18,33,-18,-2
Sinclair,397,3,240,2019-02-02T15:00:00Z,False,17,2,0,0,33,17,16,26,18,8,7,-2
Sinclair,397,3,258,2019-02-09T15:00:00Z,True,17,7,0,0,34,17,17,33,21,12,1,5
Sinclair,397,3,263,2019-02-22T19:45:00Z,False,17,4,0,0,37,20,17,25,17,8,12,0
Sinclair,397,3,276,2019-02-27T20:00:00Z,False,17,11,0,0,40,20,20,66,35,31,-26,-15
Sinclair,397,3,287,2019-03-03T12:00:00Z,True,17,10,0,0,40,20,20,35,17,18,5,2
Sinclair,397,3,297,2019-03-09T17:30:00Z,False,17,12,0,0,43,23,20,71,42,29,-28,-22
Sinclair,397,3,318,2019-03-30T15:00:00Z,False,17,13,0,0,43,23,20,58,29,29,-15,-9
Sinclair,397,3,328,2019-04-02T18:45:00Z,True,17,8,0,0,43,23,20,17,15,2,26,21
Sinclair,397,3,339,2019-04-15T19:00:00Z,True,17,0,0,0,46,26,20,63,44,19,-17,7
Sinclair,397,3,345,2019-04-20T14:00:00Z,False,17,9,0,0,46,26,20,14,8,6,32,12
Sinclair,397,3,307,2019-04-23T18:45:00Z,True,17,15,0,0,49,26,23,36,21,15,13,11
Sinclair,397,3,359,2019-04-27T14:00:00Z,True,17,19,0,0,50,27,23,51,31,20,-1,7
Sinclair,397,3,363,2019-05-05T13:00:00Z,False,17,5,0,0,50,27,23,68,39,29,-18,-16
Sinclair,397,3,379,2019-05-12T14:00:00Z,True,17,18,0,0,50,27,23,49,31,18,1,9
Adrian,398,0,4,2018-08-12T12:30:00Z,False,18,11,0,0,0,0,0,0,0,0,0,0
Adrian,398,0,19,2018-08-18T14:00:00Z,True,18,1,0,0,0,0,0,3,3,0,-3,0
Adrian,398,0,20,2018-08-25T14:00:00Z,False,18,0,0,0,0,0,0,0,0,0,0,0
Adrian,398,0,39,2018-09-01T14:00:00Z,True,18,19,0,0,0,0,0,2,2,0,-2,0
Adrian,398,0,42,2018-09-16T15:00:00Z,False,18,7,0,0,0,0,0,6,4,2,-6,-4
Adrian,398,0,59,2018-09-23T12:30:00Z,True,18,5,0,0,3,0,3,15,9,6,-12,-6
Adrian,398,0,68,2018-09-29T11:30:00Z,True,18,13,0,0,4,1,3,10,4,6,-6,-5
Adrian,398,0,70,2018-10-05T19:00:00Z,False,18,2,0,0,7,4,3,5,4,1,2,-1
Adrian,398,0,88,2018-10-20T14:00:00Z,True,18,16,0,0,7,4,3,18,6,12,-11,-8
Adrian,398,0,94,2018-10-27T16:30:00Z,False,18,10,0,0,7,4,3,12,6,6,-5,-3
Adrian,398,0,108,2018-11-03T15:00:00Z,True,18,3,0,0,8,4,4,8,4,4,0,0
Adrian,398,0,114,2018-11-10T15:00:00Z,False,18,9,0,0,11,7,4,6,4,2,5,0
Adrian,398,0,128,2018-11-24T15:00:00Z,True,18,12,0,0,12,7,5,32,21,11,-20,-4
Adrian,398,0,138,2018-12-01T15:00:00Z,False,18,14,0,0,12,7,5,12,6,6,0,-1
Adrian,398,0,146,2018-12-04T19:45:00Z,True,18,4,0,0,15,7,8,11,10,1,4,6
Adrian,398,0,159,2018-12-08T15:00:00Z,True,18,6,0,0,18,10,8,12,5,7,6,3
Adrian,398,0,162,2018-12-15T17:30:00Z,False,18,8,0,0,21,13,8,9,8,1,12,0
Adrian,398,0,178,2018-12-22T15:00:00Z,True,18,17,0,0,24,13,11,24,15,9,0,4
Adrian,398,0,187,2018-12-27T19:45:00Z,False,18,15,0,0,24,13,11,15,8,7,9,3
Adrian,398,0,191,2018-12-30T14:15:00Z,False,18,3,0,0,27,13,14,12,7,5,15,7
Adrian,398,0,208,2019-01-02T19:45:00Z,True,18,2,0,0,27,13,14,25,18,7,2,6
Adrian,398,0,219,2019-01-12T12:30:00Z,True,18,0,0,0,28,14,14,41,26,15,-13,-1
Adrian,398,0,221,2019-01-19T15:00:00Z,False,18,1,0,0,31,17,14,27,18,9,4,-4
Adrian,398,0,235,2019-01-29T19:45:00Z,False,18,19,0,0,31,17,14,32,17,15,-1,-3
Adrian,398,0,249,2019-02-04T20:00:00Z,True,18,11,0,0,31,17,14,61,32,29,-30,-12
Adrian,398,0,251,2019-02-09T15:00:00Z,False,18,6,0,0,32,18,14,26,12,14,6,2
Adrian,398,0,269,2019-02-22T19:45:00Z,True,18,8,0,0,33,18,15,17,15,2,16,16
Adrian,398,0,277,2019-02-27T20:00:00Z,False,18,12,0,0,36,21,15,65,39,26,-29,-24
Adrian,398,0,288,2019-03-02T17:30:00Z,True,18,14,0,0,36,21,15,31,19,12,5,9
Adrian,398,0,291,2019-03-09T15:00:00Z,False,18,4,0,0,39,24,15,25,17,8,14,-2
Adrian,398,0,308,2019-03-16T15:00:00Z,True,18,9,0,0,39,24,15,14,8,6,25,18
Adrian,398,0,319,2019-03-30T17:30:00Z,True,18,7,0,0,42,27,15,40,25,15,2,12
Adrian,398,0,321,2019-04-08T19:00:00Z,False,18,5,0,0,42,27,15,63,35,28,-21,-20
Adrian,398,0,336,2019-04-13T16:30:00Z,False,18,13,0,0,42,27,15,61,32,29,-19,-17
Adrian,398,0,348,2019-04-20T14:00:00Z,True,18,10,0,0,42,27,15,47,23,24,-5,3
Adrian,398,0,358,2019-04-27T11:30:00Z,False,18,16,0,0,43,28,15,70,37,33,-27,-22
Adrian,398,0,368,2019-05-04T14:00:00Z,True,18,15,0,0,46,28,18,38,22,16,8,12
Adrian,398,0,379,2019-05-12T14:00:00Z,False,18,17,0,0,49,31,18,50,27,23,-1,-9
Fabianski,399,0,4,2018-08-12T12:30:00Z,False,18,11,90,1,0,0,0,0,0,0,0,0
Fabianski,399,0,19,2018-08-18T14:00:00Z,True,18,1,90,2,0,0,0,3,3,0,-3,0
Fabianski,399,0,20,2018-08-25T14:00:00Z,False,18,0,90,5,0,0,0,0,0,0,0,0
Fabianski,399,0,39,2018-09-01T14:00:00Z,True,18,19,90,3,0,0,0,2,2,0,-2,0
Fabianski,399,0,42,2018-09-16T15:00:00Z,False,18,7,90,3,0,0,0,6,4,2,-6,-4
Fabianski,399,0,59,2018-09-23T12:30:00Z,True,18,5,90,11,3,0,3,15,9,6,-12,-6
Fabianski,399,0,68,2018-09-29T11:30:00Z,True,18,13,90,3,4,1,3,10,4,6,-6,-5
Fabianski,399,0,70,2018-10-05T19:00:00Z,False,18,2,90,3,7,4,3,5,4,1,2,-1
Fabianski,399,0,88,2018-10-20T14:00:00Z,True,18,16,90,2,7,4,3,18,6,12,-11,-8
Fabianski,399,0,94,2018-10-27T16:30:00Z,False,18,10,90,6,7,4,3,12,6,6,-5,-3
Fabianski,399,0,108,2018-11-03T15:00:00Z,True,18,3,90,1,8,4,4,8,4,4,0,0
Fabianski,399,0,114,2018-11-10T15:00:00Z,False,18,9,90,5,11,7,4,6,4,2,5,0
Fabianski,399,0,128,2018-11-24T15:00:00Z,True,18,12,90,0,12,7,5,32,21,11,-20,-4
Fabianski,399,0,138,2018-12-01T15:00:00Z,False,18,14,90,8,12,7,5,12,6,6,0,-1
Fabianski,399,0,146,2018-12-04T19:45:00Z,True,18,4,90,9,15,7,8,11,10,1,4,6
Fabianski,399,0,159,2018-12-08T15:00:00Z,True,18,6,90,1,18,10,8,12,5,7,6,3
Fabianski,399,0,162,2018-12-15T17:30:00Z,False,18,8,90,9,21,13,8,9,8,1,12,0
Fabianski,399,0,178,2018-12-22T15:00:00Z,True,18,17,90,2,24,13,11,24,15,9,0,4
Fabianski,399,0,187,2018-12-27T19:45:00Z,False,18,15,90,3,24,13,11,15,8,7,9,3
Fabianski,399,0,191,2018-12-30T14:15:00Z,False,18,3,90,2,27,13,14,12,7,5,15,7
Fabianski,399,0,208,2019-01-02T19:45:00Z,True,18,2,90,2,27,13,14,25,18,7,2,6
Fabianski,399,0,219,2019-01-12T12:30:00Z,True,18,0,90,9,28,14,14,41,26,15,-13,-1
Fabianski,399,0,221,2019-01-19T15:00:00Z,False,18,1,90,2,31,17,14,27,18,9,4,-4
Fabianski,399,0,235,2019-01-29T19:45:00Z,False,18,19,90,3,31,17,14,32,17,15,-1,-3
Fabianski,399,0,249,2019-02-04T20:00:00Z,True,18,11,90,3,31,17,14,61,32,29,-30,-12
Fabianski,399,0,251,2019-02-09T15:00:00Z,False,18,6,90,3,32,18,14,26,12,14,6,2
Fabianski,399,0,269,2019-02-22T19:45:00Z,True,18,8,90,3,33,18,15,17,15,2,16,16
Fabianski,399,0,277,2019-02-27T20:00:00Z,False,18,12,90,3,36,21,15,65,39,26,-29,-24
Fabianski,399,0,288,2019-03-02T17:30:00Z,True,18,14,90,6,36,21,15,31,19,12,5,9
Fabianski,399,0,291,2019-03-09T15:00:00Z,False,18,4,90,2,39,24,15,25,17,8,14,-2
Fabianski,399,0,308,2019-03-16T15:00:00Z,True,18,9,90,1,39,24,15,14,8,6,25,18
Fabianski,399,0,319,2019-03-30T17:30:00Z,True,18,7,90,3,42,27,15,40,25,15,2,12
Fabianski,399,0,321,2019-04-08T19:00:00Z,False,18,5,90,2,42,27,15,63,35,28,-21,-20
Fabianski,399,0,336,2019-04-13T16:30:00Z,False,18,13,90,1,42,27,15,61,32,29,-19,-17
Fabianski,399,0,348,2019-04-20T14:00:00Z,True,18,10,90,2,42,27,15,47,23,24,-5,3
Fabianski,399,0,358,2019-04-27T11:30:00Z,False,18,16,90,9,43,28,15,70,37,33,-27,-22
Fabianski,399,0,368,2019-05-04T14:00:00Z,True,18,15,90,6,46,28,18,38,22,16,8,12
Fabianski,399,0,379,2019-05-12T14:00:00Z,False,18,17,90,4,49,31,18,50,27,23,-1,-9
Reid,400,1,4,2018-08-12T12:30:00Z,False,18,11,0,0,0,0,0,0,0,0,0,0
Reid,400,1,19,2018-08-18T14:00:00Z,True,18,1,0,0,0,0,0,3,3,0,-3,0
Reid,400,1,20,2018-08-25T14:00:00Z,False,18,0,0,0,0,0,0,0,0,0,0,0
Reid,400,1,39,2018-09-01T14:00:00Z,True,18,19,0,0,0,0,0,2,2,0,-2,0
Reid,400,1,42,2018-09-16T15:00:00Z,False,18,7,0,0,0,0,0,6,4,2,-6,-4
Reid,400,1,59,2018-09-23T12:30:00Z,True,18,5,0,0,3,0,3,15,9,6,-12,-6
Reid,400,1,68,2018-09-29T11:30:00Z,True,18,13,0,0,4,1,3,10,4,6,-6,-5
Reid,400,1,70,2018-10-05T19:00:00Z,False,18,2,0,0,7,4,3,5,4,1,2,-1
Reid,400,1,88,2018-10-20T14:00:00Z,True,18,16,0,0,7,4,3,18,6,12,-11,-8
Reid,400,1,94,2018-10-27T16:30:00Z,False,18,10,0,0,7,4,3,12,6,6,-5,-3
Reid,400,1,108,2018-11-03T15:00:00Z,True,18,3,0,0,8,4,4,8,4,4,0,0
Reid,400,1,114,2018-11-10T15:00:00Z,False,18,9,0,0,11,7,4,6,4,2,5,0
Reid,400,1,128,2018-11-24T15:00:00Z,True,18,12,0,0,12,7,5,32,21,11,-20,-4
Reid,400,1,138,2018-12-01T15:00:00Z,False,18,14,0,0,12,7,5,12,6,6,0,-1
Reid,400,1,146,2018-12-04T19:45:00Z,True,18,4,0,0,15,7,8,11,10,1,4,6
Reid,400,1,159,2018-12-08T15:00:00Z,True,18,6,0,0,18,10,8,12,5,7,6,3
Reid,400,1,162,2018-12-15T17:30:00Z,False,18,8,0,0,21,13,8,9,8,1,12,0
Reid,400,1,178,2018-12-22T15:00:00Z,True,18,17,0,0,24,13,11,24,15,9,0,4
Reid,400,1,187,2018-12-27T19:45:00Z,False,18,15,0,0,24,13,11,15,8,7,9,3
Reid,400,1,191,2018-12-30T14:15:00Z,False,18,3,0,0,27,13,14,12,7,5,15,7
Reid,400,1,208,2019-01-02T19:45:00Z,True,18,2,0,0,27,13,14,25,18,7,2,6
Reid,400,1,219,2019-01-12T12:30:00Z,True,18,0,0,0,28,14,14,41,26,15,-13,-1
Reid,400,1,221,2019-01-19T15:00:00Z,False,18,1,0,0,31,17,14,27,18,9,4,-4
Reid,400,1,235,2019-01-29T19:45:00Z,False,18,19,0,0,31,17,14,32,17,15,-1,-3
Reid,400,1,249,2019-02-04T20:00:00Z,True,18,11,0,0,31,17,14,61,32,29,-30,-12
Reid,400,1,251,2019-02-09T15:00:00Z,False,18,6,0,0,32,18,14,26,12,14,6,2
Reid,400,1,269,2019-02-22T19:45:00Z,True,18,8,0,0,33,18,15,17,15,2,16,16
Reid,400,1,277,2019-02-27T20:00:00Z,False,18,12,0,0,36,21,15,65,39,26,-29,-24
Reid,400,1,288,2019-03-02T17:30:00Z,True,18,14,0,0,36,21,15,31,19,12,5,9
Reid,400,1,291,2019-03-09T15:00:00Z,False,18,4,0,0,39,24,15,25,17,8,14,-2
Reid,400,1,308,2019-03-16T15:00:00Z,True,18,9,0,0,39,24,15,14,8,6,25,18
Reid,400,1,319,2019-03-30T17:30:00Z,True,18,7,0,0,42,27,15,40,25,15,2,12
Reid,400,1,321,2019-04-08T19:00:00Z,False,18,5,0,0,42,27,15,63,35,28,-21,-20
Reid,400,1,336,2019-04-13T16:30:00Z,False,18,13,0,0,42,27,15,61,32,29,-19,-17
Reid,400,1,348,2019-04-20T14:00:00Z,True,18,10,0,0,42,27,15,47,23,24,-5,3
Reid,400,1,358,2019-04-27T11:30:00Z,False,18,16,0,0,43,28,15,70,37,33,-27,-22
Reid,400,1,368,2019-05-04T14:00:00Z,True,18,15,0,0,46,28,18,38,22,16,8,12
Reid,400,1,379,2019-05-12T14:00:00Z,False,18,17,0,0,49,31,18,50,27,23,-1,-9
Cresswell,401,1,4,2018-08-12T12:30:00Z,False,18,11,0,0,0,0,0,0,0,0,0,0
Cresswell,401,1,19,2018-08-18T14:00:00Z,True,18,1,0,0,0,0,0,3,3,0,-3,0
Cresswell,401,1,20,2018-08-25T14:00:00Z,False,18,0,0,0,0,0,0,0,0,0,0,0
Cresswell,401,1,39,2018-09-01T14:00:00Z,True,18,19,90,1,0,0,0,2,2,0,-2,0
Cresswell,401,1,42,2018-09-16T15:00:00Z,False,18,7,0,0,0,0,0,6,4,2,-6,-4
Cresswell,401,1,59,2018-09-23T12:30:00Z,True,18,5,0,0,3,0,3,15,9,6,-12,-6
Cresswell,401,1,68,2018-09-29T11:30:00Z,True,18,13,0,0,4,1,3,10,4,6,-6,-5
Cresswell,401,1,70,2018-10-05T19:00:00Z,False,18,2,0,0,7,4,3,5,4,1,2,-1
Cresswell,401,1,88,2018-10-20T14:00:00Z,True,18,16,90,2,7,4,3,18,6,12,-11,-8
Cresswell,401,1,94,2018-10-27T16:30:00Z,False,18,10,15,1,7,4,3,12,6,6,-5,-3
Cresswell,401,1,108,2018-11-03T15:00:00Z,True,18,3,90,1,8,4,4,8,4,4,0,0
Cresswell,401,1,114,2018-11-10T15:00:00Z,False,18,9,90,2,11,7,4,6,4,2,5,0
Cresswell,401,1,128,2018-11-24T15:00:00Z,True,18,12,45,1,12,7,5,32,21,11,-20,-4
Cresswell,401,1,138,2018-12-01T15:00:00Z,False,18,14,55,1,12,7,5,12,6,6,0,-1
Cresswell,401,1,146,2018-12-04T19:45:00Z,True,18,4,0,0,15,7,8,11,10,1,4,6
Cresswell,401,1,159,2018-12-08T15:00:00Z,True,18,6,0,0,18,10,8,12,5,7,6,3
Cresswell,401,1,162,2018-12-15T17:30:00Z,False,18,8,0,0,21,13,8,9,8,1,12,0
Cresswell,401,1,178,2018-12-22T15:00:00Z,True,18,17,0,0,24,13,11,24,15,9,0,4
Cresswell,401,1,187,2018-12-27T19:45:00Z,False,18,15,90,2,24,13,11,15,8,7,9,3
Cresswell,401,1,191,2018-12-30T14:15:00Z,False,18,3,90,1,27,13,14,12,7,5,15,7
Cresswell,401,1,208,2019-01-02T19:45:00Z,True,18,2,90,1,27,13,14,25,18,7,2,6
Cresswell,401,1,219,2019-01-12T12:30:00Z,True,18,0,90,6,28,14,14,41,26,15,-13,-1
Cresswell,401,1,221,2019-01-19T15:00:00Z,False,18,1,90,1,31,17,14,27,18,9,4,-4
Cresswell,401,1,235,2019-01-29T19:45:00Z,False,18,19,0,0,31,17,14,32,17,15,-1,-3
Cresswell,401,1,249,2019-02-04T20:00:00Z,True,18,11,90,2,31,17,14,61,32,29,-30,-12
Cresswell,401,1,251,2019-02-09T15:00:00Z,False,18,6,90,2,32,18,14,26,12,14,6,2
Cresswell,401,1,269,2019-02-22T19:45:00Z,True,18,8,90,2,33,18,15,17,15,2,16,16
Cresswell,401,1,277,2019-02-27T20:00:00Z,False,18,12,0,0,36,21,15,65,39,26,-29,-24
Cresswell,401,1,288,2019-03-02T17:30:00Z,True,18,14,33,1,36,21,15,31,19,12,5,9
Cresswell,401,1,291,2019-03-09T15:00:00Z,False,18,4,90,1,39,24,15,25,17,8,14,-2
Cresswell,401,1,308,2019-03-16T15:00:00Z,True,18,9,90,4,39,24,15,14,8,6,25,18
Cresswell,401,1,319,2019-03-30T17:30:00Z,True,18,7,90,1,42,27,15,40,25,15,2,12
Cresswell,401,1,321,2019-04-08T19:00:00Z,False,18,5,90,1,42,27,15,63,35,28,-21,-20
Cresswell,401,1,336,2019-04-13T16:30:00Z,False,18,13,0,0,42,27,15,61,32,29,-19,-17
Cresswell,401,1,348,2019-04-20T14:00:00Z,True,18,10,0,0,42,27,15,47,23,24,-5,3
Cresswell,401,1,358,2019-04-27T11:30:00Z,False,18,16,0,0,43,28,15,70,37,33,-27,-22
Cresswell,401,1,368,2019-05-04T14:00:00Z,True,18,15,0,0,46,28,18,38,22,16,8,12
Cresswell,401,1,379,2019-05-12T14:00:00Z,False,18,17,0,0,49,31,18,50,27,23,-1,-9
Ogbonna,402,1,4,2018-08-12T12:30:00Z,False,18,11,90,0,0,0,0,0,0,0,0,0
Ogbonna,402,1,19,2018-08-18T14:00:00Z,True,18,1,90,0,0,0,0,3,3,0,-3,0
Ogbonna,402,1,20,2018-08-25T14:00:00Z,False,18,0,0,0,0,0,0,0,0,0,0,0
Ogbonna,402,1,39,2018-09-01T14:00:00Z,True,18,19,0,0,0,0,0,2,2,0,-2,0
Ogbonna,402,1,42,2018-09-16T15:00:00Z,False,18,7,0,0,0,0,0,6,4,2,-6,-4
Ogbonna,402,1,59,2018-09-23T12:30:00Z,True,18,5,0,0,3,0,3,15,9,6,-12,-6
Ogbonna,402,1,68,2018-09-29T11:30:00Z,True,18,13,0,0,4,1,3,10,4,6,-6,-5
Ogbonna,402,1,70,2018-10-05T19:00:00Z,False,18,2,0,0,7,4,3,5,4,1,2,-1
Ogbonna,402,1,88,2018-10-20T14:00:00Z,True,18,16,0,0,7,4,3,18,6,12,-11,-8
Ogbonna,402,1,94,2018-10-27T16:30:00Z,False,18,10,9,1,7,4,3,12,6,6,-5,-3
Ogbonna,402,1,108,2018-11-03T15:00:00Z,True,18,3,1,1,8,4,4,8,4,4,0,0
Ogbonna,402,1,114,2018-11-10T15:00:00Z,False,18,9,0,0,11,7,4,6,4,2,5,0
Ogbonna,402,1,128,2018-11-24T15:00:00Z,True,18,12,0,0,12,7,5,32,21,11,-20,-4
Ogbonna,402,1,138,2018-12-01T15:00:00Z,False,18,14,0,0,12,7,5,12,6,6,0,-1
Ogbonna,402,1,146,2018-12-04T19:45:00Z,True,18,4,90,2,15,7,8,11,10,1,4,6
Ogbonna,402,1,159,2018-12-08T15:00:00Z,True,18,6,0,0,18,10,8,12,5,7,6,3
Ogbonna,402,1,162,2018-12-15T17:30:00Z,False,18,8,0,0,21,13,8,9,8,1,12,0
Ogbonna,402,1,178,2018-12-22T15:00:00Z,True,18,17,56,1,24,13,11,24,15,9,0,4
Ogbonna,402,1,187,2018-12-27T19:45:00Z,False,18,15,90,2,24,13,11,15,8,7,9,3
Ogbonna,402,1,191,2018-12-30T14:15:00Z,False,18,3,90,1,27,13,14,12,7,5,15,7
Ogbonna,402,1,208,2019-01-02T19:45:00Z,True,18,2,90,1,27,13,14,25,18,7,2,6
Ogbonna,402,1,219,2019-01-12T12:30:00Z,True,18,0,90,6,28,14,14,41,26,15,-13,-1
Ogbonna,402,1,221,2019-01-19T15:00:00Z,False,18,1,90,1,31,17,14,27,18,9,4,-4
Ogbonna,402,1,235,2019-01-29T19:45:00Z,False,18,19,90,1,31,17,14,32,17,15,-1,-3
Ogbonna,402,1,249,2019-02-04T20:00:00Z,True,18,11,90,2,31,17,14,61,32,29,-30,-12
Ogbonna,402,1,251,2019-02-09T15:00:00Z,False,18,6,90,2,32,18,14,26,12,14,6,2
Ogbonna,402,1,269,2019-02-22T19:45:00Z,True,18,8,90,6,33,18,15,17,15,2,16,16
Ogbonna,402,1,277,2019-02-27T20:00:00Z,False,18,12,90,2,36,21,15,65,39,26,-29,-24
Ogbonna,402,1,288,2019-03-02T17:30:00Z,True,18,14,90,7,36,21,15,31,19,12,5,9
Ogbonna,402,1,291,2019-03-09T15:00:00Z,False,18,4,90,1,39,24,15,25,17,8,14,-2
Ogbonna,402,1,308,2019-03-16T15:00:00Z,True,18,9,90,7,39,24,15,14,8,6,25,18
Ogbonna,402,1,319,2019-03-30T17:30:00Z,True,18,7,90,1,42,27,15,40,25,15,2,12
Ogbonna,402,1,321,2019-04-08T19:00:00Z,False,18,5,90,0,42,27,15,63,35,28,-21,-20
Ogbonna,402,1,336,2019-04-13T16:30:00Z,False,18,13,90,1,42,27,15,61,32,29,-19,-17
Ogbonna,402,1,348,2019-04-20T14:00:00Z,True,18,10,90,1,42,27,15,47,23,24,-5,3
Ogbonna,402,1,358,2019-04-27T11:30:00Z,False,18,16,5,1,43,28,15,70,37,33,-27,-22
Ogbonna,402,1,368,2019-05-04T14:00:00Z,True,18,15,0,0,46,28,18,38,22,16,8,12
Ogbonna,402,1,379,2019-05-12T14:00:00Z,False,18,17,0,0,49,31,18,50,27,23,-1,-9
Byram,403,1,4,2018-08-12T12:30:00Z,False,18,11,0,0,0,0,0,0,0,0,0,0
Byram,403,1,19,2018-08-18T14:00:00Z,True,18,1,0,0,0,0,0,3,3,0,-3,0
Byram,403,1,20,2018-08-25T14:00:00Z,False,18,0,0,0,0,0,0,0,0,0,0,0
Byram,403,1,39,2018-09-01T14:00:00Z,True,18,19,0,0,0,0,0,2,2,0,-2,0
Byram,403,1,42,2018-09-16T15:00:00Z,False,18,7,0,0,0,0,0,6,4,2,-6,-4
Byram,403,1,59,2018-09-23T12:30:00Z,True,18,5,0,0,3,0,3,15,9,6,-12,-6
Byram,403,1,68,2018-09-29T11:30:00Z,True,18,13,0,0,4,1,3,10,4,6,-6,-5
Byram,403,1,70,2018-10-05T19:00:00Z,False,18,2,0,0,7,4,3,5,4,1,2,-1
Byram,403,1,88,2018-10-20T14:00:00Z,True,18,16,0,0,7,4,3,18,6,12,-11,-8
Byram,403,1,94,2018-10-27T16:30:00Z,False,18,10,0,0,7,4,3,12,6,6,-5,-3
Byram,403,1,108,2018-11-03T15:00:00Z,True,18,3,0,0,8,4,4,8,4,4,0,0
Byram,403,1,114,2018-11-10T15:00:00Z,False,18,9,0,0,11,7,4,6,4,2,5,0
Byram,403,1,128,2018-11-24T15:00:00Z,True,18,12,0,0,12,7,5,32,21,11,-20,-4
Byram,403,1,138,2018-12-01T15:00:00Z,False,18,14,0,0,12,7,5,12,6,6,0,-1
Byram,403,1,146,2018-12-04T19:45:00Z,True,18,4,0,0,15,7,8,11,10,1,4,6
Byram,403,1,159,2018-12-08T15:00:00Z,True,18,6,0,0,18,10,8,12,5,7,6,3
Byram,403,1,162,2018-12-15T17:30:00Z,False,18,8,0,0,21,13,8,9,8,1,12,0
Byram,403,1,178,2018-12-22T15:00:00Z,True,18,17,0,0,24,13,11,24,15,9,0,4
Byram,403,1,187,2018-12-27T19:45:00Z,False,18,15,0,0,24,13,11,15,8,7,9,3
Byram,403,1,191,2018-12-30T14:15:00Z,False,18,3,0,0,27,13,14,12,7,5,15,7
Byram,403,1,208,2019-01-02T19:45:00Z,True,18,2,0,0,27,13,14,25,18,7,2,6
Byram,403,1,219,2019-01-12T12:30:00Z,True,18,0,0,0,28,14,14,41,26,15,-13,-1
Byram,403,1,221,2019-01-19T15:00:00Z,False,18,1,0,0,31,17,14,27,18,9,4,-4
Byram,403,1,235,2019-01-29T19:45:00Z,False,18,19,0,0,31,17,14,32,17,15,-1,-3
Byram,403,1,249,2019-02-04T20:00:00Z,True,18,11,0,0,31,17,14,61,32,29,-30,-12
Byram,403,1,251,2019-02-09T15:00:00Z,False,18,6,0,0,32,18,14,26,12,14,6,2
Byram,403,1,269,2019-02-22T19:45:00Z,True,18,8,0,0,33,18,15,17,15,2,16,16
Byram,403,1,277,2019-02-27T20:00:00Z,False,18,12,0,0,36,21,15,65,39,26,-29,-24
Byram,403,1,288,2019-03-02T17:30:00Z,True,18,14,0,0,36,21,15,31,19,12,5,9
Byram,403,1,291,2019-03-09T15:00:00Z,False,18,4,0,0,39,24,15,25,17,8,14,-2
Byram,403,1,308,2019-03-16T15:00:00Z,True,18,9,0,0,39,24,15,14,8,6,25,18
Byram,403,1,319,2019-03-30T17:30:00Z,True,18,7,0,0,42,27,15,40,25,15,2,12
Byram,403,1,321,2019-04-08T19:00:00Z,False,18,5,0,0,42,27,15,63,35,28,-21,-20
Byram,403,1,336,2019-04-13T16:30:00Z,False,18,13,0,0,42,27,15,61,32,29,-19,-17
Byram,403,1,348,2019-04-20T14:00:00Z,True,18,10,0,0,42,27,15,47,23,24,-5,3
Byram,403,1,358,2019-04-27T11:30:00Z,False,18,16,0,0,43,28,15,70,37,33,-27,-22
Byram,403,1,368,2019-05-04T14:00:00Z,True,18,15,0,0,46,28,18,38,22,16,8,12
Byram,403,1,379,2019-05-12T14:00:00Z,False,18,17,0,0,49,31,18,50,27,23,-1,-9
Zabaleta,404,1,4,2018-08-12T12:30:00Z,False,18,11,0,0,0,0,0,0,0,0,0,0
Zabaleta,404,1,19,2018-08-18T14:00:00Z,True,18,1,90,0,0,0,0,3,3,0,-3,0
Zabaleta,404,1,20,2018-08-25T14:00:00Z,False,18,0,0,0,0,0,0,0,0,0,0,0
Zabaleta,404,1,39,2018-09-01T14:00:00Z,True,18,19,0,0,0,0,0,2,2,0,-2,0
Zabaleta,404,1,42,2018-09-16T15:00:00Z,False,18,7,90,1,0,0,0,6,4,2,-6,-4
Zabaleta,404,1,59,2018-09-23T12:30:00Z,True,18,5,90,7,3,0,3,15,9,6,-12,-6
Zabaleta,404,1,68,2018-09-29T11:30:00Z,True,18,13,90,8,4,1,3,10,4,6,-6,-5
Zabaleta,404,1,70,2018-10-05T19:00:00Z,False,18,2,90,2,7,4,3,5,4,1,2,-1
Zabaleta,404,1,88,2018-10-20T14:00:00Z,True,18,16,90,2,7,4,3,18,6,12,-11,-8
Zabaleta,404,1,94,2018-10-27T16:30:00Z,False,18,10,90,1,7,4,3,12,6,6,-5,-3
Zabaleta,404,1,108,2018-11-03T15:00:00Z,True,18,3,90,1,8,4,4,8,4,4,0,0
Zabaleta,404,1,114,2018-11-10T15:00:00Z,False,18,9,72,2,11,7,4,6,4,2,5,0
Zabaleta,404,1,128,2018-11-24T15:00:00Z,True,18,12,90,0,12,7,5,32,21,11,-20,-4
Zabaleta,404,1,138,2018-12-01T15:00:00Z,False,18,14,90,5,12,7,5,12,6,6,0,-1
Zabaleta,404,1,146,2018-12-04T19:45:00Z,True,18,4,0,0,15,7,8,11,10,1,4,6
Zabaleta,404,1,159,2018-12-08T15:00:00Z,True,18,6,90,1,18,10,8,12,5,7,6,3
Zabaleta,404,1,162,2018-12-15T17:30:00Z,False,18,8,90,6,21,13,8,9,8,1,12,0
Zabaleta,404,1,178,2018-12-22T15:00:00Z,True,18,17,90,1,24,13,11,24,15,9,0,4
Zabaleta,404,1,187,2018-12-27T19:45:00Z,False,18,15,0,0,24,13,11,15,8,7,9,3
Zabaleta,404,1,191,2018-12-30T14:15:00Z,False,18,3,0,0,27,13,14,12,7,5,15,7
Zabaleta,404,1,208,2019-01-02T19:45:00Z,True,18,2,90,1,27,13,14,25,18,7,2,6
Zabaleta,404,1,219,2019-01-12T12:30:00Z,True,18,0,90,6,28,14,14,41,26,15,-13,-1
Zabaleta,404,1,221,2019-01-19T15:00:00Z,False,18,1,90,1,31,17,14,27,18,9,4,-4
Zabaleta,404,1,235,2019-01-29T19:45:00Z,False,18,19,90,1,31,17,14,32,17,15,-1,-3
Zabaleta,404,1,249,2019-02-04T20:00:00Z,True,18,11,0,0,31,17,14,61,32,29,-30,-12
Zabaleta,404,1,251,2019-02-09T15:00:00Z,False,18,6,6,1,32,18,14,26,12,14,6,2
Zabaleta,404,1,269,2019-02-22T19:45:00Z,True,18,8,45,1,33,18,15,17,15,2,16,16
Zabaleta,404,1,277,2019-02-27T20:00:00Z,False,18,12,27,1,36,21,15,65,39,26,-29,-24
Zabaleta,404,1,288,2019-03-02T17:30:00Z,True,18,14,0,0,36,21,15,31,19,12,5,9
Zabaleta,404,1,291,2019-03-09T15:00:00Z,False,18,4,0,0,39,24,15,25,17,8,14,-2
Zabaleta,404,1,308,2019-03-16T15:00:00Z,True,18,9,90,1,39,24,15,14,8,6,25,18
Zabaleta,404,1,319,2019-03-30T17:30:00Z,True,18,7,90,1,42,27,15,40,25,15,2,12
Zabaleta,404,1,321,2019-04-08T19:00:00Z,False,18,5,0,0,42,27,15,63,35,28,-21,-20
Zabaleta,404,1,336,2019-04-13T16:30:00Z,False,18,13,75,2,42,27,15,61,32,29,-19,-17
Zabaleta,404,1,348,2019-04-20T14:00:00Z,True,18,10,90,1,42,27,15,47,23,24,-5,3
Zabaleta,404,1,358,2019-04-27T11:30:00Z,False,18,16,0,0,43,28,15,70,37,33,-27,-22
Zabaleta,404,1,368,2019-05-04T14:00:00Z,True,18,15,0,0,46,28,18,38,22,16,8,12
Zabaleta,404,1,379,2019-05-12T14:00:00Z,False,18,17,64,2,49,31,18,50,27,23,-1,-9
Rice,405,1,4,2018-08-12T12:30:00Z,False,18,11,45,0,0,0,0,0,0,0,0,0
Rice,405,1,19,2018-08-18T14:00:00Z,True,18,1,0,0,0,0,0,3,3,0,-3,0
Rice,405,1,20,2018-08-25T14:00:00Z,False,18,0,0,0,0,0,0,0,0,0,0,0
Rice,405,1,39,2018-09-01T14:00:00Z,True,18,19,0,0,0,0,0,2,2,0,-2,0
Rice,405,1,42,2018-09-16T15:00:00Z,False,18,7,90,1,0,0,0,6,4,2,-6,-4
Rice,405,1,59,2018-09-23T12:30:00Z,True,18,5,90,6,3,0,3,15,9,6,-12,-6
Rice,405,1,68,2018-09-29T11:30:00Z,True,18,13,90,2,4,1,3,10,4,6,-6,-5
Rice,405,1,70,2018-10-05T19:00:00Z,False,18,2,90,2,7,4,3,5,4,1,2,-1
Rice,405,1,88,2018-10-20T14:00:00Z,True,18,16,90,2,7,4,3,18,6,12,-11,-8
Rice,405,1,94,2018-10-27T16:30:00Z,False,18,10,90,2,7,4,3,12,6,6,-5,-3
Rice,405,1,108,2018-11-03T15:00:00Z,True,18,3,90,1,8,4,4,8,4,4,0,0
Rice,405,1,114,2018-11-10T15:00:00Z,False,18,9,90,2,11,7,4,6,4,2,5,0
Rice,405,1,128,2018-11-24T15:00:00Z,True,18,12,90,0,12,7,5,32,21,11,-20,-4
Rice,405,1,138,2018-12-01T15:00:00Z,False,18,14,90,6,12,7,5,12,6,6,0,-1
Rice,405,1,146,2018-12-04T19:45:00Z,True,18,4,90,2,15,7,8,11,10,1,4,6
Rice,405,1,159,2018-12-08T15:00:00Z,True,18,6,90,1,18,10,8,12,5,7,6,3
Rice,405,1,162,2018-12-15T17:30:00Z,False,18,8,90,7,21,13,8,9,8,1,12,0
Rice,405,1,178,2018-12-22T15:00:00Z,True,18,17,90,1,24,13,11,24,15,9,0,4
Rice,405,1,187,2018-12-27T19:45:00Z,False,18,15,90,3,24,13,11,15,8,7,9,3
Rice,405,1,191,2018-12-30T14:15:00Z,False,18,3,90,0,27,13,14,12,7,5,15,7
Rice,405,1,208,2019-01-02T19:45:00Z,True,18,2,90,1,27,13,14,25,18,7,2,6
Rice,405,1,219,2019-01-12T12:30:00Z,True,18,0,90,15,28,14,14,41,26,15,-13,-1
Rice,405,1,221,2019-01-19T15:00:00Z,False,18,1,90,1,31,17,14,27,18,9,4,-4
Rice,405,1,235,2019-01-29T19:45:00Z,False,18,19,90,1,31,17,14,32,17,15,-1,-3
Rice,405,1,249,2019-02-04T20:00:00Z,True,18,11,90,2,31,17,14,61,32,29,-30,-12
Rice,405,1,251,2019-02-09T15:00:00Z,False,18,6,90,2,32,18,14,26,12,14,6,2
Rice,405,1,269,2019-02-22T19:45:00Z,True,18,8,90,2,33,18,15,17,15,2,16,16
Rice,405,1,277,2019-02-27T20:00:00Z,False,18,12,90,2,36,21,15,65,39,26,-29,-24
Rice,405,1,288,2019-03-02T17:30:00Z,True,18,14,90,15,36,21,15,31,19,12,5,9
Rice,405,1,291,2019-03-09T15:00:00Z,False,18,4,90,1,39,24,15,25,17,8,14,-2
Rice,405,1,308,2019-03-16T15:00:00Z,True,18,9,90,1,39,24,15,14,8,6,25,18
Rice,405,1,319,2019-03-30T17:30:00Z,True,18,7,90,0,42,27,15,40,25,15,2,12
Rice,405,1,321,2019-04-08T19:00:00Z,False,18,5,90,1,42,27,15,63,35,28,-21,-20
Rice,405,1,336,2019-04-13T16:30:00Z,False,18,13,90,2,42,27,15,61,32,29,-19,-17
Rice,405,1,348,2019-04-20T14:00:00Z,True,18,10,90,0,42,27,15,47,23,24,-5,3
Rice,405,1,358,2019-04-27T11:30:00Z,False,18,16,90,6,43,28,15,70,37,33,-27,-22
Rice,405,1,368,2019-05-04T14:00:00Z,True,18,15,0,0,46,28,18,38,22,16,8,12
Rice,405,1,379,2019-05-12T14:00:00Z,False,18,17,78,2,49,31,18,50,27,23,-1,-9
Oxford,406,1,4,2018-08-12T12:30:00Z,False,18,11,0,0,0,0,0,0,0,0,0,0
Oxford,406,1,19,2018-08-18T14:00:00Z,True,18,1,0,0,0,0,0,3,3,0,-3,0
Oxford,406,1,20,2018-08-25T14:00:00Z,False,18,0,0,0,0,0,0,0,0,0,0,0
Oxford,406,1,39,2018-09-01T14:00:00Z,True,18,19,0,0,0,0,0,2,2,0,-2,0
Oxford,406,1,42,2018-09-16T15:00:00Z,False,18,7,0,0,0,0,0,6,4,2,-6,-4
Oxford,406,1,59,2018-09-23T12:30:00Z,True,18,5,0,0,3,0,3,15,9,6,-12,-6
Oxford,406,1,68,2018-09-29T11:30:00Z,True,18,13,0,0,4,1,3,10,4,6,-6,-5
Oxford,406,1,70,2018-10-05T19:00:00Z,False,18,2,0,0,7,4,3,5,4,1,2,-1
Oxford,406,1,88,2018-10-20T14:00:00Z,True,18,16,0,0,7,4,3,18,6,12,-11,-8
Oxford,406,1,94,2018-10-27T16:30:00Z,False,18,10,0,0,7,4,3,12,6,6,-5,-3
Oxford,406,1,108,2018-11-03T15:00:00Z,True,18,3,0,0,8,4,4,8,4,4,0,0
Oxford,406,1,114,2018-11-10T15:00:00Z,False,18,9,0,0,11,7,4,6,4,2,5,0
Oxford,406,1,128,2018-11-24T15:00:00Z,True,18,12,0,0,12,7,5,32,21,11,-20,-4
Oxford,406,1,138,2018-12-01T15:00:00Z,False,18,14,0,0,12,7,5,12,6,6,0,-1
Oxford,406,1,146,2018-12-04T19:45:00Z,True,18,4,0,0,15,7,8,11,10,1,4,6
Oxford,406,1,159,2018-12-08T15:00:00Z,True,18,6,0,0,18,10,8,12,5,7,6,3
Oxford,406,1,162,2018-12-15T17:30:00Z,False,18,8,0,0,21,13,8,9,8,1,12,0
Oxford,406,1,178,2018-12-22T15:00:00Z,True,18,17,0,0,24,13,11,24,15,9,0,4
Oxford,406,1,187,2018-12-27T19:45:00Z,False,18,15,0,0,24,13,11,15,8,7,9,3
Oxford,406,1,191,2018-12-30T14:15:00Z,False,18,3,0,0,27,13,14,12,7,5,15,7
Oxford,406,1,208,2019-01-02T19:45:00Z,True,18,2,0,0,27,13,14,25,18,7,2,6
Oxford,406,1,219,2019-01-12T12:30:00Z,True,18,0,0,0,28,14,14,41,26,15,-13,-1
Oxford,406,1,221,2019-01-19T15:00:00Z,False,18,1,0,0,31,17,14,27,18,9,4,-4
Oxford,406,1,235,2019-01-29T19:45:00Z,False,18,19,0,0,31,17,14,32,17,15,-1,-3
Oxford,406,1,249,2019-02-04T20:00:00Z,True,18,11,0,0,31,17,14,61,32,29,-30,-12
Oxford,406,1,251,2019-02-09T15:00:00Z,False,18,6,0,0,32,18,14,26,12,14,6,2
Oxford,406,1,269,2019-02-22T19:45:00Z,True,18,8,0,0,33,18,15,17,15,2,16,16
Oxford,406,1,277,2019-02-27T20:00:00Z,False,18,12,0,0,36,21,15,65,39,26,-29,-24
Oxford,406,1,288,2019-03-02T17:30:00Z,True,18,14,0,0,36,21,15,31,19,12,5,9
Oxford,406,1,291,2019-03-09T15:00:00Z,False,18,4,0,0,39,24,15,25,17,8,14,-2
Oxford,406,1,308,2019-03-16T15:00:00Z,True,18,9,0,0,39,24,15,14,8,6,25,18
Oxford,406,1,319,2019-03-30T17:30:00Z,True,18,7,0,0,42,27,15,40,25,15,2,12
Oxford,406,1,321,2019-04-08T19:00:00Z,False,18,5,0,0,42,27,15,63,35,28,-21,-20
Oxford,406,1,336,2019-04-13T16:30:00Z,False,18,13,0,0,42,27,15,61,32,29,-19,-17
Oxford,406,1,348,2019-04-20T14:00:00Z,True,18,10,0,0,42,27,15,47,23,24,-5,3
Oxford,406,1,358,2019-04-27T11:30:00Z,False,18,16,0,0,43,28,15,70,37,33,-27,-22
Oxford,406,1,368,2019-05-04T14:00:00Z,True,18,15,0,0,46,28,18,38,22,16,8,12
Oxford,406,1,379,2019-05-12T14:00:00Z,False,18,17,0,0,49,31,18,50,27,23,-1,-9
Fredericks,407,1,4,2018-08-12T12:30:00Z,False,18,11,90,0,0,0,0,0,0,0,0,0
Fredericks,407,1,19,2018-08-18T14:00:00Z,True,18,1,0,0,0,0,0,3,3,0,-3,0
Fredericks,407,1,20,2018-08-25T14:00:00Z,False,18,0,90,0,0,0,0,0,0,0,0,0
Fredericks,407,1,39,2018-09-01T14:00:00Z,True,18,19,90,1,0,0,0,2,2,0,-2,0
Fredericks,407,1,42,2018-09-16T15:00:00Z,False,18,7,0,0,0,0,0,6,4,2,-6,-4
Fredericks,407,1,59,2018-09-23T12:30:00Z,True,18,5,0,0,3,0,3,15,9,6,-12,-6
Fredericks,407,1,68,2018-09-29T11:30:00Z,True,18,13,0,0,4,1,3,10,4,6,-6,-5
Fredericks,407,1,70,2018-10-05T19:00:00Z,False,18,2,0,0,7,4,3,5,4,1,2,-1
Fredericks,407,1,88,2018-10-20T14:00:00Z,True,18,16,0,0,7,4,3,18,6,12,-11,-8
Fredericks,407,1,94,2018-10-27T16:30:00Z,False,18,10,0,0,7,4,3,12,6,6,-5,-3
Fredericks,407,1,108,2018-11-03T15:00:00Z,True,18,3,0,0,8,4,4,8,4,4,0,0
Fredericks,407,1,114,2018-11-10T15:00:00Z,False,18,9,17,1,11,7,4,6,4,2,5,0
Fredericks,407,1,128,2018-11-24T15:00:00Z,True,18,12,0,0,12,7,5,32,21,11,-20,-4
Fredericks,407,1,138,2018-12-01T15:00:00Z,False,18,14,0,0,12,7,5,12,6,6,0,-1
Fredericks,407,1,146,2018-12-04T19:45:00Z,True,18,4,0,0,15,7,8,11,10,1,4,6
Fredericks,407,1,159,2018-12-08T15:00:00Z,True,18,6,0,0,18,10,8,12,5,7,6,3
Fredericks,407,1,162,2018-12-15T17:30:00Z,False,18,8,0,0,21,13,8,9,8,1,12,0
Fredericks,407,1,178,2018-12-22T15:00:00Z,True,18,17,0,0,24,13,11,24,15,9,0,4
Fredericks,407,1,187,2018-12-27T19:45:00Z,False,18,15,0,0,24,13,11,15,8,7,9,3
Fredericks,407,1,191,2018-12-30T14:15:00Z,False,18,3,0,0,27,13,14,12,7,5,15,7
Fredericks,407,1,208,2019-01-02T19:45:00Z,True,18,2,0,0,27,13,14,25,18,7,2,6
Fredericks,407,1,219,2019-01-12T12:30:00Z,True,18,0,0,0,28,14,14,41,26,15,-13,-1
Fredericks,407,1,221,2019-01-19T15:00:00Z,False,18,1,0,0,31,17,14,27,18,9,4,-4
Fredericks,407,1,235,2019-01-29T19:45:00Z,False,18,19,0,0,31,17,14,32,17,15,-1,-3
Fredericks,407,1,249,2019-02-04T20:00:00Z,True,18,11,90,2,31,17,14,61,32,29,-30,-12
Fredericks,407,1,251,2019-02-09T15:00:00Z,False,18,6,83,2,32,18,14,26,12,14,6,2
Fredericks,407,1,269,2019-02-22T19:45:00Z,True,18,8,45,1,33,18,15,17,15,2,16,16
Fredericks,407,1,277,2019-02-27T20:00:00Z,False,18,12,90,1,36,21,15,65,39,26,-29,-24
Fredericks,407,1,288,2019-03-02T17:30:00Z,True,18,14,90,8,36,21,15,31,19,12,5,9
Fredericks,407,1,291,2019-03-09T15:00:00Z,False,18,4,90,1,39,24,15,25,17,8,14,-2
Fredericks,407,1,308,2019-03-16T15:00:00Z,True,18,9,0,0,39,24,15,14,8,6,25,18
Fredericks,407,1,319,2019-03-30T17:30:00Z,True,18,7,0,0,42,27,15,40,25,15,2,12
Fredericks,407,1,321,2019-04-08T19:00:00Z,False,18,5,90,1,42,27,15,63,35,28,-21,-20
Fredericks,407,1,336,2019-04-13T16:30:00Z,False,18,13,14,0,42,27,15,61,32,29,-19,-17
Fredericks,407,1,348,2019-04-20T14:00:00Z,True,18,10,0,0,42,27,15,47,23,24,-5,3
Fredericks,407,1,358,2019-04-27T11:30:00Z,False,18,16,90,5,43,28,15,70,37,33,-27,-22
Fredericks,407,1,368,2019-05-04T14:00:00Z,True,18,15,90,14,46,28,18,38,22,16,8,12
Fredericks,407,1,379,2019-05-12T14:00:00Z,False,18,17,25,1,49,31,18,50,27,23,-1,-9
Diop,408,1,4,2018-08-12T12:30:00Z,False,18,11,0,0,0,0,0,0,0,0,0,0
Diop,408,1,19,2018-08-18T14:00:00Z,True,18,1,0,0,0,0,0,3,3,0,-3,0
Diop,408,1,20,2018-08-25T14:00:00Z,False,18,0,90,-2,0,0,0,0,0,0,0,0
Diop,408,1,39,2018-09-01T14:00:00Z,True,18,19,90,2,0,0,0,2,2,0,-2,0
Diop,408,1,42,2018-09-16T15:00:00Z,False,18,7,90,2,0,0,0,6,4,2,-6,-4
Diop,408,1,59,2018-09-23T12:30:00Z,True,18,5,90,6,3,0,3,15,9,6,-12,-6
Diop,408,1,68,2018-09-29T11:30:00Z,True,18,13,90,2,4,1,3,10,4,6,-6,-5
Diop,408,1,70,2018-10-05T19:00:00Z,False,18,2,90,2,7,4,3,5,4,1,2,-1
Diop,408,1,88,2018-10-20T14:00:00Z,True,18,16,90,2,7,4,3,18,6,12,-11,-8
Diop,408,1,94,2018-10-27T16:30:00Z,False,18,10,90,2,7,4,3,12,6,6,-5,-3
Diop,408,1,108,2018-11-03T15:00:00Z,True,18,3,90,1,8,4,4,8,4,4,0,0
Diop,408,1,114,2018-11-10T15:00:00Z,False,18,9,90,2,11,7,4,6,4,2,5,0
Diop,408,1,128,2018-11-24T15:00:00Z,True,18,12,90,0,12,7,5,32,21,11,-20,-4
Diop,408,1,138,2018-12-01T15:00:00Z,False,18,14,90,6,12,7,5,12,6,6,0,-1
Diop,408,1,146,2018-12-04T19:45:00Z,True,18,4,90,2,15,7,8,11,10,1,4,6
Diop,408,1,159,2018-12-08T15:00:00Z,True,18,6,90,0,18,10,8,12,5,7,6,3
Diop,408,1,162,2018-12-15T17:30:00Z,False,18,8,90,7,21,13,8,9,8,1,12,0
Diop,408,1,178,2018-12-22T15:00:00Z,True,18,17,90,0,24,13,11,24,15,9,0,4
Diop,408,1,187,2018-12-27T19:45:00Z,False,18,15,90,2,24,13,11,15,8,7,9,3
Diop,408,1,191,2018-12-30T14:15:00Z,False,18,3,90,1,27,13,14,12,7,5,15,7
Diop,408,1,208,2019-01-02T19:45:00Z,True,18,2,90,1,27,13,14,25,18,7,2,6
Diop,408,1,219,2019-01-12T12:30:00Z,True,18,0,90,7,28,14,14,41,26,15,-13,-1
Diop,408,1,221,2019-01-19T15:00:00Z,False,18,1,90,1,31,17,14,27,18,9,4,-4
Diop,408,1,235,2019-01-29T19:45:00Z,False,18,19,90,1,31,17,14,32,17,15,-1,-3
Diop,408,1,249,2019-02-04T20:00:00Z,True,18,11,90,2,31,17,14,61,32,29,-30,-12
Diop,408,1,251,2019-02-09T15:00:00Z,False,18,6,90,2,32,18,14,26,12,14,6,2
Diop,408,1,269,2019-02-22T19:45:00Z,True,18,8,90,8,33,18,15,17,15,2,16,16
Diop,408,1,277,2019-02-27T20:00:00Z,False,18,12,90,2,36,21,15,65,39,26,-29,-24
Diop,408,1,288,2019-03-02T17:30:00Z,True,18,14,90,5,36,21,15,31,19,12,5,9
Diop,408,1,291,2019-03-09T15:00:00Z,False,18,4,90,1,39,24,15,25,17,8,14,-2
Diop,408,1,308,2019-03-16T15:00:00Z,True,18,9,90,1,39,24,15,14,8,6,25,18
Diop,408,1,319,2019-03-30T17:30:00Z,True,18,7,90,1,42,27,15,40,25,15,2,12
Diop,408,1,321,2019-04-08T19:00:00Z,False,18,5,0,0,42,27,15,63,35,28,-21,-20
Diop,408,1,336,2019-04-13T16:30:00Z,False,18,13,0,0,42,27,15,61,32,29,-19,-17
Diop,408,1,348,2019-04-20T14:00:00Z,True,18,10,0,0,42,27,15,47,23,24,-5,3
Diop,408,1,358,2019-04-27T11:30:00Z,False,18,16,90,9,43,28,15,70,37,33,-27,-22
Diop,408,1,368,2019-05-04T14:00:00Z,True,18,15,90,7,46,28,18,38,22,16,8,12
Diop,408,1,379,2019-05-12T14:00:00Z,False,18,17,90,2,49,31,18,50,27,23,-1,-9
Masuaku,409,2,4,2018-08-12T12:30:00Z,False,18,11,90,2,0,0,0,0,0,0,0,0
Masuaku,409,2,19,2018-08-18T14:00:00Z,True,18,1,90,2,0,0,0,3,3,0,-3,0
Masuaku,409,2,20,2018-08-25T14:00:00Z,False,18,0,90,2,0,0,0,0,0,0,0,0
Masuaku,409,2,39,2018-09-01T14:00:00Z,True,18,19,0,0,0,0,0,2,2,0,-2,0
Masuaku,409,2,42,2018-09-16T15:00:00Z,False,18,7,90,1,0,0,0,6,4,2,-6,-4
Masuaku,409,2,59,2018-09-23T12:30:00Z,True,18,5,90,3,3,0,3,15,9,6,-12,-6
Masuaku,409,2,68,2018-09-29T11:30:00Z,True,18,13,90,2,4,1,3,10,4,6,-6,-5
Masuaku,409,2,70,2018-10-05T19:00:00Z,False,18,2,90,2,7,4,3,5,4,1,2,-1
Masuaku,409,2,88,2018-10-20T14:00:00Z,True,18,16,0,0,7,4,3,18,6,12,-11,-8
Masuaku,409,2,94,2018-10-27T16:30:00Z,False,18,10,90,2,7,4,3,12,6,6,-5,-3
Masuaku,409,2,108,2018-11-03T15:00:00Z,True,18,3,0,0,8,4,4,8,4,4,0,0
Masuaku,409,2,114,2018-11-10T15:00:00Z,False,18,9,0,0,11,7,4,6,4,2,5,0
Masuaku,409,2,128,2018-11-24T15:00:00Z,True,18,12,45,1,12,7,5,32,21,11,-20,-4
Masuaku,409,2,138,2018-12-01T15:00:00Z,False,18,14,34,1,12,7,5,12,6,6,0,-1
Masuaku,409,2,146,2018-12-04T19:45:00Z,True,18,4,90,5,15,7,8,11,10,1,4,6
Masuaku,409,2,159,2018-12-08T15:00:00Z,True,18,6,90,2,18,10,8,12,5,7,6,3
Masuaku,409,2,162,2018-12-15T17:30:00Z,False,18,8,90,3,21,13,8,9,8,1,12,0
Masuaku,409,2,178,2018-12-22T15:00:00Z,True,18,17,90,2,24,13,11,24,15,9,0,4
Masuaku,409,2,187,2018-12-27T19:45:00Z,False,18,15,1,1,24,13,11,15,8,7,9,3
Masuaku,409,2,191,2018-12-30T14:15:00Z,False,18,3,0,0,27,13,14,12,7,5,15,7
Masuaku,409,2,208,2019-01-02T19:45:00Z,True,18,2,0,0,27,13,14,25,18,7,2,6
Masuaku,409,2,219,2019-01-12T12:30:00Z,True,18,0,0,0,28,14,14,41,26,15,-13,-1
Masuaku,409,2,221,2019-01-19T15:00:00Z,False,18,1,0,0,31,17,14,27,18,9,4,-4
Masuaku,409,2,235,2019-01-29T19:45:00Z,False,18,19,90,2,31,17,14,32,17,15,-1,-3
Masuaku,409,2,249,2019-02-04T20:00:00Z,True,18,11,1,1,31,17,14,61,32,29,-30,-12
Masuaku,409,2,251,2019-02-09T15:00:00Z,False,18,6,0,0,32,18,14,26,12,14,6,2
Masuaku,409,2,269,2019-02-22T19:45:00Z,True,18,8,0,0,33,18,15,17,15,2,16,16
Masuaku,409,2,277,2019-02-27T20:00:00Z,False,18,12,0,0,36,21,15,65,39,26,-29,-24
Masuaku,409,2,288,2019-03-02T17:30:00Z,True,18,14,56,0,36,21,15,31,19,12,5,9
Masuaku,409,2,291,2019-03-09T15:00:00Z,False,18,4,0,0,39,24,15,25,17,8,14,-2
Masuaku,409,2,308,2019-03-16T15:00:00Z,True,18,9,0,0,39,24,15,14,8,6,25,18
Masuaku,409,2,319,2019-03-30T17:30:00Z,True,18,7,0,0,42,27,15,40,25,15,2,12
Masuaku,409,2,321,2019-04-08T19:00:00Z,False,18,5,0,0,42,27,15,63,35,28,-21,-20
Masuaku,409,2,336,2019-04-13T16:30:00Z,False,18,13,90,2,42,27,15,61,32,29,-19,-17
Masuaku,409,2,348,2019-04-20T14:00:00Z,True,18,10,90,2,42,27,15,47,23,24,-5,3
Masuaku,409,2,358,2019-04-27T11:30:00Z,False,18,16,90,3,43,28,15,70,37,33,-27,-22
Masuaku,409,2,368,2019-05-04T14:00:00Z,True,18,15,90,6,46,28,18,38,22,16,8,12
Masuaku,409,2,379,2019-05-12T14:00:00Z,False,18,17,90,2,49,31,18,50,27,23,-1,-9
Noble,410,2,4,2018-08-12T12:30:00Z,False,18,11,90,2,0,0,0,0,0,0,0,0
Noble,410,2,19,2018-08-18T14:00:00Z,True,18,1,76,1,0,0,0,3,3,0,-3,0
Noble,410,2,20,2018-08-25T14:00:00Z,False,18,0,0,0,0,0,0,0,0,0,0,0
Noble,410,2,39,2018-09-01T14:00:00Z,True,18,19,0,0,0,0,0,2,2,0,-2,0
Noble,410,2,42,2018-09-16T15:00:00Z,False,18,7,70,5,0,0,0,6,4,2,-6,-4
Noble,410,2,59,2018-09-23T12:30:00Z,True,18,5,84,3,3,0,3,15,9,6,-12,-6
Noble,410,2,68,2018-09-29T11:30:00Z,True,18,13,90,5,4,1,3,10,4,6,-6,-5
Noble,410,2,70,2018-10-05T19:00:00Z,False,18,2,82,2,7,4,3,5,4,1,2,-1
Noble,410,2,88,2018-10-20T14:00:00Z,True,18,16,71,1,7,4,3,18,6,12,-11,-8
Noble,410,2,94,2018-10-27T16:30:00Z,False,18,10,37,-2,7,4,3,12,6,6,-5,-3
Noble,410,2,108,2018-11-03T15:00:00Z,True,18,3,0,0,8,4,4,8,4,4,0,0
Noble,410,2,114,2018-11-10T15:00:00Z,False,18,9,0,0,11,7,4,6,4,2,5,0
Noble,410,2,128,2018-11-24T15:00:00Z,True,18,12,0,0,12,7,5,32,21,11,-20,-4
Noble,410,2,138,2018-12-01T15:00:00Z,False,18,14,84,2,12,7,5,12,6,6,0,-1
Noble,410,2,146,2018-12-04T19:45:00Z,True,18,4,90,2,15,7,8,11,10,1,4,6
Noble,410,2,159,2018-12-08T15:00:00Z,True,18,6,90,2,18,10,8,12,5,7,6,3
Noble,410,2,162,2018-12-15T17:30:00Z,False,18,8,61,2,21,13,8,9,8,1,12,0
Noble,410,2,178,2018-12-22T15:00:00Z,True,18,17,55,1,24,13,11,24,15,9,0,4
Noble,410,2,187,2018-12-27T19:45:00Z,False,18,15,12,1,24,13,11,15,8,7,9,3
Noble,410,2,191,2018-12-30T14:15:00Z,False,18,3,90,1,27,13,14,12,7,5,15,7
Noble,410,2,208,2019-01-02T19:45:00Z,True,18,2,27,4,27,13,14,25,18,7,2,6
Noble,410,2,219,2019-01-12T12:30:00Z,True,18,0,90,3,28,14,14,41,26,15,-13,-1
Noble,410,2,221,2019-01-19T15:00:00Z,False,18,1,78,2,31,17,14,27,18,9,4,-4
Noble,410,2,235,2019-01-29T19:45:00Z,False,18,19,67,2,31,17,14,32,17,15,-1,-3
Noble,410,2,249,2019-02-04T20:00:00Z,True,18,11,78,2,31,17,14,61,32,29,-30,-12
Noble,410,2,251,2019-02-09T15:00:00Z,False,18,6,90,9,32,18,14,26,12,14,6,2
Noble,410,2,269,2019-02-22T19:45:00Z,True,18,8,90,2,33,18,15,17,15,2,16,16
Noble,410,2,277,2019-02-27T20:00:00Z,False,18,12,0,0,36,21,15,65,39,26,-29,-24
Noble,410,2,288,2019-03-02T17:30:00Z,True,18,14,78,7,36,21,15,31,19,12,5,9
Noble,410,2,291,2019-03-09T15:00:00Z,False,18,4,57,1,39,24,15,25,17,8,14,-2
Noble,410,2,308,2019-03-16T15:00:00Z,True,18,9,58,6,39,24,15,14,8,6,25,18
Noble,410,2,319,2019-03-30T17:30:00Z,True,18,7,0,0,42,27,15,40,25,15,2,12
Noble,410,2,321,2019-04-08T19:00:00Z,False,18,5,69,2,42,27,15,63,35,28,-21,-20
Noble,410,2,336,2019-04-13T16:30:00Z,False,18,13,90,2,42,27,15,61,32,29,-19,-17
Noble,410,2,348,2019-04-20T14:00:00Z,True,18,10,84,5,42,27,15,47,23,24,-5,3
Noble,410,2,358,2019-04-27T11:30:00Z,False,18,16,84,3,43,28,15,70,37,33,-27,-22
Noble,410,2,368,2019-05-04T14:00:00Z,True,18,15,77,6,46,28,18,38,22,16,8,12
Noble,410,2,379,2019-05-12T14:00:00Z,False,18,17,90,15,49,31,18,50,27,23,-1,-9
Kouyate,411,2,2,2018-08-11T14:00:00Z,False,6,8,2,1,0,0,0,0,0,0,0,0
Kouyate,411,2,14,2018-08-20T19:00:00Z,True,6,11,0,0,3,0,3,3,3,0,0,0
Kouyate,411,2,28,2018-08-26T12:30:00Z,False,6,17,0,0,3,0,3,6,3,3,-3,0
Kouyate,411,2,34,2018-09-01T14:00:00Z,True,6,15,18,1,3,0,3,1,1,0,2,0
Kouyate,411,2,43,2018-09-15T14:00:00Z,False,6,9,90,3,3,0,3,2,1,1,1,2
Kouyate,411,2,54,2018-09-22T14:00:00Z,True,6,14,62,3,6,0,6,1,0,1,5,-1
Kouyate,411,2,61,2018-10-01T19:00:00Z,False,6,1,6,0,7,1,6,10,7,3,-3,-1
Kouyate,411,2,72,2018-10-06T14:00:00Z,True,6,19,18,0,7,1,6,12,8,4,-5,-3
Kouyate,411,2,84,2018-10-21T15:00:00Z,False,6,7,90,2,7,1,6,12,7,5,-5,-1
Kouyate,411,2,92,2018-10-28T13:30:00Z,True,6,0,87,5,7,1,6,21,12,9,-14,-8
Kouyate,411,2,103,2018-11-04T16:00:00Z,False,6,5,90,2,8,2,6,24,11,13,-16,-5
Kouyate,411,2,113,2018-11-10T17:30:00Z,True,6,16,90,2,8,2,6,24,6,18,-16,-16
Kouyate,411,2,125,2018-11-24T15:00:00Z,False,6,13,90,3,8,2,6,20,10,10,-12,-4
Kouyate,411,2,133,2018-12-01T15:00:00Z,True,6,3,90,6,9,2,7,9,4,5,0,-3
Kouyate,411,2,141,2018-12-04T19:45:00Z,False,6,2,57,1,12,5,7,18,11,7,-6,-4
Kouyate,411,2,159,2018-12-08T15:00:00Z,False,6,18,90,2,12,5,7,18,10,8,-6,-3
Kouyate,411,2,161,2018-12-15T15:00:00Z,True,6,10,64,3,12,5,7,22,11,11,-10,-6
Kouyate,411,2,176,2018-12-22T15:00:00Z,False,6,12,0,0,15,8,7,44,27,17,-29,-20
Kouyate,411,2,182,2018-12-26T15:00:00Z,True,6,4,90,3,18,8,10,14,13,1,4,7
Kouyate,411,2,192,2018-12-30T12:00:00Z,True,6,5,77,2,19,9,10,40,21,19,-21,-10
Kouyate,411,2,209,2019-01-02T19:45:00Z,False,6,19,90,3,19,9,10,29,14,15,-10,-4
Kouyate,411,2,214,2019-01-12T15:00:00Z,True,6,17,90,2,22,9,13,29,16,13,-7,-4
Kouyate,411,2,224,2019-01-19T15:00:00Z,False,6,11,74,2,22,9,13,57,28,29,-35,-15
Kouyate,411,2,238,2019-01-30T19:45:00Z,False,6,15,70,3,22,9,13,22,11,11,0,2
Kouyate,411,2,244,2019-02-02T15:00:00Z,True,6,8,0,0,23,9,14,17,15,2,6,7
Kouyate,411,2,251,2019-02-09T15:00:00Z,True,6,18,0,0,26,12,14,32,18,14,-6,-2
Kouyate,411,2,266,2019-02-23T17:30:00Z,False,6,10,10,1,27,13,14,32,14,18,-5,0
Kouyate,411,2,272,2019-02-27T20:00:00Z,True,6,13,7,1,30,13,17,52,26,26,-22,-13
Kouyate,411,2,282,2019-03-02T15:00:00Z,False,6,3,90,5,30,13,17,30,17,13,0,0
Kouyate,411,2,293,2019-03-09T12:30:00Z,True,6,2,0,0,33,13,20,30,22,8,3,5
Kouyate,411,2,314,2019-03-30T15:00:00Z,True,6,9,10,1,33,13,20,14,8,6,19,7
Kouyate,411,2,306,2019-04-03T18:45:00Z,False,6,16,78,2,36,16,20,61,28,33,-25,-8
Kouyate,411,2,325,2019-04-06T14:00:00Z,False,6,14,5,1,36,16,20,35,22,13,1,-2
Kouyate,411,2,332,2019-04-14T13:05:00Z,True,6,12,68,2,39,16,23,80,48,32,-41,-16
Kouyate,411,2,340,2019-04-21T15:00:00Z,False,6,0,90,2,39,16,23,66,44,22,-27,-21
Kouyate,411,2,352,2019-04-27T14:00:00Z,True,6,7,90,2,42,16,26,49,31,18,-7,-2
Kouyate,411,2,362,2019-05-04T16:30:00Z,False,6,4,6,1,43,17,26,31,20,11,12,6
Kouyate,411,2,372,2019-05-12T14:00:00Z,True,6,1,0,0,46,17,29,45,29,16,1,1
Obiang,412,2,4,2018-08-12T12:30:00Z,False,18,11,0,0,0,0,0,0,0,0,0,0
Obiang,412,2,19,2018-08-18T14:00:00Z,True,18,1,0,0,0,0,0,3,3,0,-3,0
Obiang,412,2,20,2018-08-25T14:00:00Z,False,18,0,0,0,0,0,0,0,0,0,0,0
Obiang,412,2,39,2018-09-01T14:00:00Z,True,18,19,26,1,0,0,0,2,2,0,-2,0
Obiang,412,2,42,2018-09-16T15:00:00Z,False,18,7,90,6,0,0,0,6,4,2,-6,-4
Obiang,412,2,59,2018-09-23T12:30:00Z,True,18,5,90,3,3,0,3,15,9,6,-12,-6
Obiang,412,2,68,2018-09-29T11:30:00Z,True,18,13,90,2,4,1,3,10,4,6,-6,-5
Obiang,412,2,70,2018-10-05T19:00:00Z,False,18,2,59,1,7,4,3,5,4,1,2,-1
Obiang,412,2,88,2018-10-20T14:00:00Z,True,18,16,0,0,7,4,3,18,6,12,-11,-8
Obiang,412,2,94,2018-10-27T16:30:00Z,False,18,10,0,0,7,4,3,12,6,6,-5,-3
Obiang,412,2,108,2018-11-03T15:00:00Z,True,18,3,60,2,8,4,4,8,4,4,0,0
Obiang,412,2,114,2018-11-10T15:00:00Z,False,18,9,63,2,11,7,4,6,4,2,5,0
Obiang,412,2,128,2018-11-24T15:00:00Z,True,18,12,90,2,12,7,5,32,21,11,-20,-4
Obiang,412,2,138,2018-12-01T15:00:00Z,False,18,14,19,1,12,7,5,12,6,6,0,-1
Obiang,412,2,146,2018-12-04T19:45:00Z,True,18,4,0,0,15,7,8,11,10,1,4,6
Obiang,412,2,159,2018-12-08T15:00:00Z,True,18,6,6,1,18,10,8,12,5,7,6,3
Obiang,412,2,162,2018-12-15T17:30:00Z,False,18,8,28,1,21,13,8,9,8,1,12,0
Obiang,412,2,178,2018-12-22T15:00:00Z,True,18,17,0,0,24,13,11,24,15,9,0,4
Obiang,412,2,187,2018-12-27T19:45:00Z,False,18,15,90,2,24,13,11,15,8,7,9,3
Obiang,412,2,191,2018-12-30T14:15:00Z,False,18,3,0,0,27,13,14,12,7,5,15,7
Obiang,412,2,208,2019-01-02T19:45:00Z,True,18,2,62,2,27,13,14,25,18,7,2,6
Obiang,412,2,219,2019-01-12T12:30:00Z,True,18,0,8,1,28,14,14,41,26,15,-13,-1
Obiang,412,2,221,2019-01-19T15:00:00Z,False,18,1,0,0,31,17,14,27,18,9,4,-4
Obiang,412,2,235,2019-01-29T19:45:00Z,False,18,19,21,1,31,17,14,32,17,15,-1,-3
Obiang,412,2,249,2019-02-04T20:00:00Z,True,18,11,11,1,31,17,14,61,32,29,-30,-12
Obiang,412,2,251,2019-02-09T15:00:00Z,False,18,6,17,1,32,18,14,26,12,14,6,2
Obiang,412,2,269,2019-02-22T19:45:00Z,True,18,8,0,0,33,18,15,17,15,2,16,16
Obiang,412,2,277,2019-02-27T20:00:00Z,False,18,12,90,2,36,21,15,65,39,26,-29,-24
Obiang,412,2,288,2019-03-02T17:30:00Z,True,18,14,11,1,36,21,15,31,19,12,5,9
Obiang,412,2,291,2019-03-09T15:00:00Z,False,18,4,0,0,39,24,15,25,17,8,14,-2
Obiang,412,2,308,2019-03-16T15:00:00Z,True,18,9,0,0,39,24,15,14,8,6,25,18
Obiang,412,2,319,2019-03-30T17:30:00Z,True,18,7,45,1,42,27,15,40,25,15,2,12
Obiang,412,2,321,2019-04-08T19:00:00Z,False,18,5,20,1,42,27,15,63,35,28,-21,-20
Obiang,412,2,336,2019-04-13T16:30:00Z,False,18,13,0,0,42,27,15,61,32,29,-19,-17
Obiang,412,2,348,2019-04-20T14:00:00Z,True,18,10,17,4,42,27,15,47,23,24,-5,3
Obiang,412,2,358,2019-04-27T11:30:00Z,False,18,16,13,1,43,28,15,70,37,33,-27,-22
Obiang,412,2,368,2019-05-04T14:00:00Z,True,18,15,90,3,46,28,18,38,22,16,8,12
Obiang,412,2,379,2019-05-12T14:00:00Z,False,18,17,0,0,49,31,18,50,27,23,-1,-9
Lanzini,413,2,4,2018-08-12T12:30:00Z,False,18,11,0,0,0,0,0,0,0,0,0,0
Lanzini,413,2,19,2018-08-18T14:00:00Z,True,18,1,0,0,0,0,0,3,3,0,-3,0
Lanzini,413,2,20,2018-08-25T14:00:00Z,False,18,0,0,0,0,0,0,0,0,0,0,0
Lanzini,413,2,39,2018-09-01T14:00:00Z,True,18,19,0,0,0,0,0,2,2,0,-2,0
Lanzini,413,2,42,2018-09-16T15:00:00Z,False,18,7,0,0,0,0,0,6,4,2,-6,-4
Lanzini,413,2,59,2018-09-23T12:30:00Z,True,18,5,0,0,3,0,3,15,9,6,-12,-6
Lanzini,413,2,68,2018-09-29T11:30:00Z,True,18,13,0,0,4,1,3,10,4,6,-6,-5
Lanzini,413,2,70,2018-10-05T19:00:00Z,False,18,2,0,0,7,4,3,5,4,1,2,-1
Lanzini,413,2,88,2018-10-20T14:00:00Z,True,18,16,0,0,7,4,3,18,6,12,-11,-8
Lanzini,413,2,94,2018-10-27T16:30:00Z,False,18,10,0,0,7,4,3,12,6,6,-5,-3
Lanzini,413,2,108,2018-11-03T15:00:00Z,True,18,3,0,0,8,4,4,8,4,4,0,0
Lanzini,413,2,114,2018-11-10T15:00:00Z,False,18,9,0,0,11,7,4,6,4,2,5,0
Lanzini,413,2,128,2018-11-24T15:00:00Z,True,18,12,0,0,12,7,5,32,21,11,-20,-4
Lanzini,413,2,138,2018-12-01T15:00:00Z,False,18,14,0,0,12,7,5,12,6,6,0,-1
Lanzini,413,2,146,2018-12-04T19:45:00Z,True,18,4,0,0,15,7,8,11,10,1,4,6
Lanzini,413,2,159,2018-12-08T15:00:00Z,True,18,6,0,0,18,10,8,12,5,7,6,3
Lanzini,413,2,162,2018-12-15T17:30:00Z,False,18,8,0,0,21,13,8,9,8,1,12,0
Lanzini,413,2,178,2018-12-22T15:00:00Z,True,18,17,0,0,24,13,11,24,15,9,0,4
Lanzini,413,2,187,2018-12-27T19:45:00Z,False,18,15,0,0,24,13,11,15,8,7,9,3
Lanzini,413,2,191,2018-12-30T14:15:00Z,False,18,3,0,0,27,13,14,12,7,5,15,7
Lanzini,413,2,208,2019-01-02T19:45:00Z,True,18,2,0,0,27,13,14,25,18,7,2,6
Lanzini,413,2,219,2019-01-12T12:30:00Z,True,18,0,0,0,28,14,14,41,26,15,-13,-1
Lanzini,413,2,221,2019-01-19T15:00:00Z,False,18,1,0,0,31,17,14,27,18,9,4,-4
Lanzini,413,2,235,2019-01-29T19:45:00Z,False,18,19,0,0,31,17,14,32,17,15,-1,-3
Lanzini,413,2,249,2019-02-04T20:00:00Z,True,18,11,0,0,31,17,14,61,32,29,-30,-12
Lanzini,413,2,251,2019-02-09T15:00:00Z,False,18,6,0,0,32,18,14,26,12,14,6,2
Lanzini,413,2,269,2019-02-22T19:45:00Z,True,18,8,14,0,33,18,15,17,15,2,16,16
Lanzini,413,2,277,2019-02-27T20:00:00Z,False,18,12,45,1,36,21,15,65,39,26,-29,-24
Lanzini,413,2,288,2019-03-02T17:30:00Z,True,18,14,90,3,36,21,15,31,19,12,5,9
Lanzini,413,2,291,2019-03-09T15:00:00Z,False,18,4,57,1,39,24,15,25,17,8,14,-2
Lanzini,413,2,308,2019-03-16T15:00:00Z,True,18,9,90,5,39,24,15,14,8,6,25,18
Lanzini,413,2,319,2019-03-30T17:30:00Z,True,18,7,90,2,42,27,15,40,25,15,2,12
Lanzini,413,2,321,2019-04-08T19:00:00Z,False,18,5,90,2,42,27,15,63,35,28,-21,-20
Lanzini,413,2,336,2019-04-13T16:30:00Z,False,18,13,61,7,42,27,15,61,32,29,-19,-17
Lanzini,413,2,348,2019-04-20T14:00:00Z,True,18,10,0,0,42,27,15,47,23,24,-5,3
Lanzini,413,2,358,2019-04-27T11:30:00Z,False,18,16,0,0,43,28,15,70,37,33,-27,-22
Lanzini,413,2,368,2019-05-04T14:00:00Z,True,18,15,82,2,46,28,18,38,22,16,8,12
Lanzini,413,2,379,2019-05-12T14:00:00Z,False,18,17,66,8,49,31,18,50,27,23,-1,-9
Antonio,414,2,4,2018-08-12T12:30:00Z,False,18,11,90,1,0,0,0,0,0,0,0,0
Antonio,414,2,19,2018-08-18T14:00:00Z,True,18,1,0,0,0,0,0,3,3,0,-3,0
Antonio,414,2,20,2018-08-25T14:00:00Z,False,18,0,62,2,0,0,0,0,0,0,0,0
Antonio,414,2,39,2018-09-01T14:00:00Z,True,18,19,74,3,0,0,0,2,2,0,-2,0
Antonio,414,2,42,2018-09-16T15:00:00Z,False,18,7,26,1,0,0,0,6,4,2,-6,-4
Antonio,414,2,59,2018-09-23T12:30:00Z,True,18,5,64,3,3,0,3,15,9,6,-12,-6
Antonio,414,2,68,2018-09-29T11:30:00Z,True,18,13,7,1,4,1,3,10,4,6,-6,-5
Antonio,414,2,70,2018-10-05T19:00:00Z,False,18,2,30,1,7,4,3,5,4,1,2,-1
Antonio,414,2,88,2018-10-20T14:00:00Z,True,18,16,18,1,7,4,3,18,6,12,-11,-8
Antonio,414,2,94,2018-10-27T16:30:00Z,False,18,10,29,1,7,4,3,12,6,6,-5,-3
Antonio,414,2,108,2018-11-03T15:00:00Z,True,18,3,4,4,8,4,4,8,4,4,0,0
Antonio,414,2,114,2018-11-10T15:00:00Z,False,18,9,26,4,11,7,4,6,4,2,5,0
Antonio,414,2,128,2018-11-24T15:00:00Z,True,18,12,90,2,12,7,5,32,21,11,-20,-4
Antonio,414,2,138,2018-12-01T15:00:00Z,False,18,14,0,0,12,7,5,12,6,6,0,-1
Antonio,414,2,146,2018-12-04T19:45:00Z,True,18,4,90,7,15,7,8,11,10,1,4,6
Antonio,414,2,159,2018-12-08T15:00:00Z,True,18,6,0,0,18,10,8,12,5,7,6,3
Antonio,414,2,162,2018-12-15T17:30:00Z,False,18,8,84,8,21,13,8,9,8,1,12,0
Antonio,414,2,178,2018-12-22T15:00:00Z,True,18,17,90,1,24,13,11,24,15,9,0,4
Antonio,414,2,187,2018-12-27T19:45:00Z,False,18,15,90,7,24,13,11,15,8,7,9,3
Antonio,414,2,191,2018-12-30T14:15:00Z,False,18,3,90,2,27,13,14,12,7,5,15,7
Antonio,414,2,208,2019-01-02T19:45:00Z,True,18,2,27,4,27,13,14,25,18,7,2,6
Antonio,414,2,219,2019-01-12T12:30:00Z,True,18,0,81,3,28,14,14,41,26,15,-13,-1
Antonio,414,2,221,2019-01-19T15:00:00Z,False,18,1,90,2,31,17,14,27,18,9,4,-4
Antonio,414,2,235,2019-01-29T19:45:00Z,False,18,19,90,2,31,17,14,32,17,15,-1,-3
Antonio,414,2,249,2019-02-04T20:00:00Z,True,18,11,90,8,31,17,14,61,32,29,-30,-12
Antonio,414,2,251,2019-02-09T15:00:00Z,False,18,6,72,7,32,18,14,26,12,14,6,2
Antonio,414,2,269,2019-02-22T19:45:00Z,True,18,8,90,7,33,18,15,17,15,2,16,16
Antonio,414,2,277,2019-02-27T20:00:00Z,False,18,12,90,1,36,21,15,65,39,26,-29,-24
Antonio,414,2,288,2019-03-02T17:30:00Z,True,18,14,0,0,36,21,15,31,19,12,5,9
Antonio,414,2,291,2019-03-09T15:00:00Z,False,18,4,32,1,39,24,15,25,17,8,14,-2
Antonio,414,2,308,2019-03-16T15:00:00Z,True,18,9,45,1,39,24,15,14,8,6,25,18
Antonio,414,2,319,2019-03-30T17:30:00Z,True,18,7,45,1,42,27,15,40,25,15,2,12
Antonio,414,2,321,2019-04-08T19:00:00Z,False,18,5,0,0,42,27,15,63,35,28,-21,-20
Antonio,414,2,336,2019-04-13T16:30:00Z,False,18,13,17,1,42,27,15,61,32,29,-19,-17
Antonio,414,2,348,2019-04-20T14:00:00Z,True,18,10,90,7,42,27,15,47,23,24,-5,3
Antonio,414,2,358,2019-04-27T11:30:00Z,False,18,16,90,8,43,28,15,70,37,33,-27,-22
Antonio,414,2,368,2019-05-04T14:00:00Z,True,18,15,90,3,46,28,18,38,22,16,8,12
Antonio,414,2,379,2019-05-12T14:00:00Z,False,18,17,90,13,49,31,18,50,27,23,-1,-9
Fernandes,415,2,4,2018-08-12T12:30:00Z,False,18,11,0,0,0,0,0,0,0,0,0,0
Fernandes,415,2,19,2018-08-18T14:00:00Z,True,18,1,0,0,0,0,0,3,3,0,-3,0
Fernandes,415,2,20,2018-08-25T14:00:00Z,False,18,0,0,0,0,0,0,0,0,0,0,0
Fernandes,415,2,39,2018-09-01T14:00:00Z,True,18,19,0,0,0,0,0,2,2,0,-2,0
Fernandes,415,2,42,2018-09-16T15:00:00Z,False,18,7,0,0,0,0,0,6,4,2,-6,-4
Fernandes,415,2,59,2018-09-23T12:30:00Z,True,18,5,0,0,3,0,3,15,9,6,-12,-6
Fernandes,415,2,68,2018-09-29T11:30:00Z,True,18,13,0,0,4,1,3,10,4,6,-6,-5
Fernandes,415,2,70,2018-10-05T19:00:00Z,False,18,2,0,0,7,4,3,5,4,1,2,-1
Fernandes,415,2,88,2018-10-20T14:00:00Z,True,18,16,0,0,7,4,3,18,6,12,-11,-8
Fernandes,415,2,94,2018-10-27T16:30:00Z,False,18,10,0,0,7,4,3,12,6,6,-5,-3
Fernandes,415,2,108,2018-11-03T15:00:00Z,True,18,3,0,0,8,4,4,8,4,4,0,0
Fernandes,415,2,114,2018-11-10T15:00:00Z,False,18,9,0,0,11,7,4,6,4,2,5,0
Fernandes,415,2,128,2018-11-24T15:00:00Z,True,18,12,0,0,12,7,5,32,21,11,-20,-4
Fernandes,415,2,138,2018-12-01T15:00:00Z,False,18,14,0,0,12,7,5,12,6,6,0,-1
Fernandes,415,2,146,2018-12-04T19:45:00Z,True,18,4,0,0,15,7,8,11,10,1,4,6
Fernandes,415,2,159,2018-12-08T15:00:00Z,True,18,6,0,0,18,10,8,12,5,7,6,3
Fernandes,415,2,162,2018-12-15T17:30:00Z,False,18,8,0,0,21,13,8,9,8,1,12,0
Fernandes,415,2,178,2018-12-22T15:00:00Z,True,18,17,0,0,24,13,11,24,15,9,0,4
Fernandes,415,2,187,2018-12-27T19:45:00Z,False,18,15,0,0,24,13,11,15,8,7,9,3
Fernandes,415,2,191,2018-12-30T14:15:00Z,False,18,3,0,0,27,13,14,12,7,5,15,7
Fernandes,415,2,208,2019-01-02T19:45:00Z,True,18,2,0,0,27,13,14,25,18,7,2,6
Fernandes,415,2,219,2019-01-12T12:30:00Z,True,18,0,0,0,28,14,14,41,26,15,-13,-1
Fernandes,415,2,221,2019-01-19T15:00:00Z,False,18,1,0,0,31,17,14,27,18,9,4,-4
Fernandes,415,2,235,2019-01-29T19:45:00Z,False,18,19,0,0,31,17,14,32,17,15,-1,-3
Fernandes,415,2,249,2019-02-04T20:00:00Z,True,18,11,0,0,31,17,14,61,32,29,-30,-12
Fernandes,415,2,251,2019-02-09T15:00:00Z,False,18,6,0,0,32,18,14,26,12,14,6,2
Fernandes,415,2,269,2019-02-22T19:45:00Z,True,18,8,0,0,33,18,15,17,15,2,16,16
Fernandes,415,2,277,2019-02-27T20:00:00Z,False,18,12,0,0,36,21,15,65,39,26,-29,-24
Fernandes,415,2,288,2019-03-02T17:30:00Z,True,18,14,0,0,36,21,15,31,19,12,5,9
Fernandes,415,2,291,2019-03-09T15:00:00Z,False,18,4,0,0,39,24,15,25,17,8,14,-2
Fernandes,415,2,308,2019-03-16T15:00:00Z,True,18,9,0,0,39,24,15,14,8,6,25,18
Fernandes,415,2,319,2019-03-30T17:30:00Z,True,18,7,0,0,42,27,15,40,25,15,2,12
Fernandes,415,2,321,2019-04-08T19:00:00Z,False,18,5,0,0,42,27,15,63,35,28,-21,-20
Fernandes,415,2,336,2019-04-13T16:30:00Z,False,18,13,0,0,42,27,15,61,32,29,-19,-17
Fernandes,415,2,348,2019-04-20T14:00:00Z,True,18,10,0,0,42,27,15,47,23,24,-5,3
Fernandes,415,2,358,2019-04-27T11:30:00Z,False,18,16,0,0,43,28,15,70,37,33,-27,-22
Fernandes,415,2,368,2019-05-04T14:00:00Z,True,18,15,0,0,46,28,18,38,22,16,8,12
Fernandes,415,2,379,2019-05-12T14:00:00Z,False,18,17,0,0,49,31,18,50,27,23,-1,-9
Arnautovic,416,3,4,2018-08-12T12:30:00Z,False,18,11,66,2,0,0,0,0,0,0,0,0
Arnautovic,416,3,19,2018-08-18T14:00:00Z,True,18,1,90,8,0,0,0,3,3,0,-3,0
Arnautovic,416,3,20,2018-08-25T14:00:00Z,False,18,0,58,5,0,0,0,0,0,0,0,0
Arnautovic,416,3,39,2018-09-01T14:00:00Z,True,18,19,90,2,0,0,0,2,2,0,-2,0
Arnautovic,416,3,42,2018-09-16T15:00:00Z,False,18,7,63,12,0,0,0,6,4,2,-6,-4
Arnautovic,416,3,59,2018-09-23T12:30:00Z,True,18,5,0,0,3,0,3,15,9,6,-12,-6
Arnautovic,416,3,68,2018-09-29T11:30:00Z,True,18,13,82,7,4,1,3,10,4,6,-6,-5
Arnautovic,416,3,70,2018-10-05T19:00:00Z,False,18,2,90,1,7,4,3,5,4,1,2,-1
Arnautovic,416,3,88,2018-10-20T14:00:00Z,True,18,16,90,1,7,4,3,18,6,12,-11,-8
Arnautovic,416,3,94,2018-10-27T16:30:00Z,False,18,10,0,0,7,4,3,12,6,6,-5,-3
Arnautovic,416,3,108,2018-11-03T15:00:00Z,True,18,3,90,12,8,4,4,8,4,4,0,0
Arnautovic,416,3,114,2018-11-10T15:00:00Z,False,18,9,90,2,11,7,4,6,4,2,5,0
Arnautovic,416,3,128,2018-11-24T15:00:00Z,True,18,12,90,2,12,7,5,32,21,11,-20,-4
Arnautovic,416,3,138,2018-12-01T15:00:00Z,False,18,14,70,5,12,7,5,12,6,6,0,-1
Arnautovic,416,3,146,2018-12-04T19:45:00Z,True,18,4,39,0,15,7,8,11,10,1,4,6
Arnautovic,416,3,159,2018-12-08T15:00:00Z,True,18,6,0,0,18,10,8,12,5,7,6,3
Arnautovic,416,3,162,2018-12-15T17:30:00Z,False,18,8,0,0,21,13,8,9,8,1,12,0
Arnautovic,416,3,178,2018-12-22T15:00:00Z,True,18,17,0,0,24,13,11,24,15,9,0,4
Arnautovic,416,3,187,2018-12-27T19:45:00Z,False,18,15,0,0,24,13,11,15,8,7,9,3
Arnautovic,416,3,191,2018-12-30T14:15:00Z,False,18,3,72,2,27,13,14,12,7,5,15,7
Arnautovic,416,3,208,2019-01-02T19:45:00Z,True,18,2,90,13,27,13,14,25,18,7,2,6
Arnautovic,416,3,219,2019-01-12T12:30:00Z,True,18,0,70,2,28,14,14,41,26,15,-13,-1
Arnautovic,416,3,221,2019-01-19T15:00:00Z,False,18,1,0,0,31,17,14,27,18,9,4,-4
Arnautovic,416,3,235,2019-01-29T19:45:00Z,False,18,19,76,2,31,17,14,32,17,15,-1,-3
Arnautovic,416,3,249,2019-02-04T20:00:00Z,True,18,11,0,0,31,17,14,61,32,29,-30,-12
Arnautovic,416,3,251,2019-02-09T15:00:00Z,False,18,6,22,1,32,18,14,26,12,14,6,2
Arnautovic,416,3,269,2019-02-22T19:45:00Z,True,18,8,26,4,33,18,15,17,15,2,16,16
Arnautovic,416,3,277,2019-02-27T20:00:00Z,False,18,12,0,0,36,21,15,65,39,26,-29,-24
Arnautovic,416,3,288,2019-03-02T17:30:00Z,True,18,14,20,1,36,21,15,31,19,12,5,9
Arnautovic,416,3,291,2019-03-09T15:00:00Z,False,18,4,45,1,39,24,15,25,17,8,14,-2
Arnautovic,416,3,308,2019-03-16T15:00:00Z,True,18,9,67,2,39,24,15,14,8,6,25,18
Arnautovic,416,3,319,2019-03-30T17:30:00Z,True,18,7,66,2,42,27,15,40,25,15,2,12
Arnautovic,416,3,321,2019-04-08T19:00:00Z,False,18,5,90,2,42,27,15,63,35,28,-21,-20
Arnautovic,416,3,336,2019-04-13T16:30:00Z,False,18,13,0,0,42,27,15,61,32,29,-19,-17
Arnautovic,416,3,348,2019-04-20T14:00:00Z,True,18,10,77,2,42,27,15,47,23,24,-5,3
Arnautovic,416,3,358,2019-04-27T11:30:00Z,False,18,16,79,5,43,28,15,70,37,33,-27,-22
Arnautovic,416,3,368,2019-05-04T14:00:00Z,True,18,15,90,13,46,28,18,38,22,16,8,12
Arnautovic,416,3,379,2019-05-12T14:00:00Z,False,18,17,90,6,49,31,18,50,27,23,-1,-9
Carroll,417,3,4,2018-08-12T12:30:00Z,False,18,11,0,0,0,0,0,0,0,0,0,0
Carroll,417,3,19,2018-08-18T14:00:00Z,True,18,1,0,0,0,0,0,3,3,0,-3,0
Carroll,417,3,20,2018-08-25T14:00:00Z,False,18,0,0,0,0,0,0,0,0,0,0,0
Carroll,417,3,39,2018-09-01T14:00:00Z,True,18,19,0,0,0,0,0,2,2,0,-2,0
Carroll,417,3,42,2018-09-16T15:00:00Z,False,18,7,0,0,0,0,0,6,4,2,-6,-4
Carroll,417,3,59,2018-09-23T12:30:00Z,True,18,5,0,0,3,0,3,15,9,6,-12,-6
Carroll,417,3,68,2018-09-29T11:30:00Z,True,18,13,0,0,4,1,3,10,4,6,-6,-5
Carroll,417,3,70,2018-10-05T19:00:00Z,False,18,2,0,0,7,4,3,5,4,1,2,-1
Carroll,417,3,88,2018-10-20T14:00:00Z,True,18,16,0,0,7,4,3,18,6,12,-11,-8
Carroll,417,3,94,2018-10-27T16:30:00Z,False,18,10,0,0,7,4,3,12,6,6,-5,-3
Carroll,417,3,108,2018-11-03T15:00:00Z,True,18,3,0,0,8,4,4,8,4,4,0,0
Carroll,417,3,114,2018-11-10T15:00:00Z,False,18,9,0,0,11,7,4,6,4,2,5,0
Carroll,417,3,128,2018-11-24T15:00:00Z,True,18,12,0,0,12,7,5,32,21,11,-20,-4
Carroll,417,3,138,2018-12-01T15:00:00Z,False,18,14,0,0,12,7,5,12,6,6,0,-1
Carroll,417,3,146,2018-12-04T19:45:00Z,True,18,4,26,1,15,7,8,11,10,1,4,6
Carroll,417,3,159,2018-12-08T15:00:00Z,True,18,6,45,1,18,10,8,12,5,7,6,3
Carroll,417,3,162,2018-12-15T17:30:00Z,False,18,8,17,1,21,13,8,9,8,1,12,0
Carroll,417,3,178,2018-12-22T15:00:00Z,True,18,17,34,1,24,13,11,24,15,9,0,4
Carroll,417,3,187,2018-12-27T19:45:00Z,False,18,15,35,1,24,13,11,15,8,7,9,3
Carroll,417,3,191,2018-12-30T14:15:00Z,False,18,3,45,0,27,13,14,12,7,5,15,7
Carroll,417,3,208,2019-01-02T19:45:00Z,True,18,2,45,1,27,13,14,25,18,7,2,6
Carroll,417,3,219,2019-01-12T12:30:00Z,True,18,0,19,1,28,14,14,41,26,15,-13,-1
Carroll,417,3,221,2019-01-19T15:00:00Z,False,18,1,65,1,31,17,14,27,18,9,4,-4
Carroll,417,3,235,2019-01-29T19:45:00Z,False,18,19,22,1,31,17,14,32,17,15,-1,-3
Carroll,417,3,249,2019-02-04T20:00:00Z,True,18,11,11,1,31,17,14,61,32,29,-30,-12
Carroll,417,3,251,2019-02-09T15:00:00Z,False,18,6,0,0,32,18,14,26,12,14,6,2
Carroll,417,3,269,2019-02-22T19:45:00Z,True,18,8,0,0,33,18,15,17,15,2,16,16
Carroll,417,3,277,2019-02-27T20:00:00Z,False,18,12,90,2,36,21,15,65,39,26,-29,-24
Carroll,417,3,288,2019-03-02T17:30:00Z,True,18,14,0,0,36,21,15,31,19,12,5,9
Carroll,417,3,291,2019-03-09T15:00:00Z,False,18,4,0,0,39,24,15,25,17,8,14,-2
Carroll,417,3,308,2019-03-16T15:00:00Z,True,18,9,0,0,39,24,15,14,8,6,25,18
Carroll,417,3,319,2019-03-30T17:30:00Z,True,18,7,0,0,42,27,15,40,25,15,2,12
Carroll,417,3,321,2019-04-08T19:00:00Z,False,18,5,0,0,42,27,15,63,35,28,-21,-20
Carroll,417,3,336,2019-04-13T16:30:00Z,False,18,13,0,0,42,27,15,61,32,29,-19,-17
Carroll,417,3,348,2019-04-20T14:00:00Z,True,18,10,0,0,42,27,15,47,23,24,-5,3
Carroll,417,3,358,2019-04-27T11:30:00Z,False,18,16,0,0,43,28,15,70,37,33,-27,-22
Carroll,417,3,368,2019-05-04T14:00:00Z,True,18,15,0,0,46,28,18,38,22,16,8,12
Carroll,417,3,379,2019-05-12T14:00:00Z,False,18,17,0,0,49,31,18,50,27,23,-1,-9
Chicharito,418,3,4,2018-08-12T12:30:00Z,False,18,11,28,1,0,0,0,0,0,0,0,0
Chicharito,418,3,19,2018-08-18T14:00:00Z,True,18,1,66,5,0,0,0,3,3,0,-3,0
Chicharito,418,3,20,2018-08-25T14:00:00Z,False,18,0,31,1,0,0,0,0,0,0,0,0
Chicharito,418,3,39,2018-09-01T14:00:00Z,True,18,19,15,1,0,0,0,2,2,0,-2,0
Chicharito,418,3,42,2018-09-16T15:00:00Z,False,18,7,0,0,0,0,0,6,4,2,-6,-4
Chicharito,418,3,59,2018-09-23T12:30:00Z,True,18,5,0,0,3,0,3,15,9,6,-12,-6
Chicharito,418,3,68,2018-09-29T11:30:00Z,True,18,13,0,0,4,1,3,10,4,6,-6,-5
Chicharito,418,3,70,2018-10-05T19:00:00Z,False,18,2,0,0,7,4,3,5,4,1,2,-1
Chicharito,418,3,88,2018-10-20T14:00:00Z,True,18,16,33,1,7,4,3,18,6,12,-11,-8
Chicharito,418,3,94,2018-10-27T16:30:00Z,False,18,10,60,2,7,4,3,12,6,6,-5,-3
Chicharito,418,3,108,2018-11-03T15:00:00Z,True,18,3,29,6,8,4,4,8,4,4,0,0
Chicharito,418,3,114,2018-11-10T15:00:00Z,False,18,9,45,1,11,7,4,6,4,2,5,0
Chicharito,418,3,128,2018-11-24T15:00:00Z,True,18,12,35,1,12,7,5,32,21,11,-20,-4
Chicharito,418,3,138,2018-12-01T15:00:00Z,False,18,14,90,13,12,7,5,12,6,6,0,-1
Chicharito,418,3,146,2018-12-04T19:45:00Z,True,18,4,63,2,15,7,8,11,10,1,4,6
Chicharito,418,3,159,2018-12-08T15:00:00Z,True,18,6,74,9,18,10,8,12,5,7,6,3
Chicharito,418,3,162,2018-12-15T17:30:00Z,False,18,8,72,5,21,13,8,9,8,1,12,0
Chicharito,418,3,178,2018-12-22T15:00:00Z,True,18,17,74,2,24,13,11,24,15,9,0,4
Chicharito,418,3,187,2018-12-27T19:45:00Z,False,18,15,0,0,24,13,11,15,8,7,9,3
Chicharito,418,3,191,2018-12-30T14:15:00Z,False,18,3,0,0,27,13,14,12,7,5,15,7
Chicharito,418,3,208,2019-01-02T19:45:00Z,True,18,2,0,0,27,13,14,25,18,7,2,6
Chicharito,418,3,219,2019-01-12T12:30:00Z,True,18,0,0,0,28,14,14,41,26,15,-13,-1
Chicharito,418,3,221,2019-01-19T15:00:00Z,False,18,1,24,1,31,17,14,27,18,9,4,-4
Chicharito,418,3,235,2019-01-29T19:45:00Z,False,18,19,13,1,31,17,14,32,17,15,-1,-3
Chicharito,418,3,249,2019-02-04T20:00:00Z,True,18,11,78,1,31,17,14,61,32,29,-30,-12
Chicharito,418,3,251,2019-02-09T15:00:00Z,False,18,6,67,2,32,18,14,26,12,14,6,2
Chicharito,418,3,269,2019-02-22T19:45:00Z,True,18,8,63,9,33,18,15,17,15,2,16,16
Chicharito,418,3,277,2019-02-27T20:00:00Z,False,18,12,0,0,36,21,15,65,39,26,-29,-24
Chicharito,418,3,288,2019-03-02T17:30:00Z,True,18,14,69,5,36,21,15,31,19,12,5,9
Chicharito,418,3,291,2019-03-09T15:00:00Z,False,18,4,90,1,39,24,15,25,17,8,14,-2
Chicharito,418,3,308,2019-03-16T15:00:00Z,True,18,9,45,12,39,24,15,14,8,6,25,18
Chicharito,418,3,319,2019-03-30T17:30:00Z,True,18,7,45,1,42,27,15,40,25,15,2,12
Chicharito,418,3,321,2019-04-08T19:00:00Z,False,18,5,45,1,42,27,15,63,35,28,-21,-20
Chicharito,418,3,336,2019-04-13T16:30:00Z,False,18,13,72,2,42,27,15,61,32,29,-19,-17
Chicharito,418,3,348,2019-04-20T14:00:00Z,True,18,10,0,0,42,27,15,47,23,24,-5,3
Chicharito,418,3,358,2019-04-27T11:30:00Z,False,18,16,0,0,43,28,15,70,37,33,-27,-22
Chicharito,418,3,368,2019-05-04T14:00:00Z,True,18,15,0,0,46,28,18,38,22,16,8,12
Chicharito,418,3,379,2019-05-12T14:00:00Z,False,18,17,0,0,49,31,18,50,27,23,-1,-9
Hugill,419,3,4,2018-08-12T12:30:00Z,False,18,11,0,0,0,0,0,0,0,0,0,0
Hugill,419,3,19,2018-08-18T14:00:00Z,True,18,1,0,0,0,0,0,3,3,0,-3,0
Hugill,419,3,20,2018-08-25T14:00:00Z,False,18,0,0,0,0,0,0,0,0,0,0,0
Hugill,419,3,39,2018-09-01T14:00:00Z,True,18,19,0,0,0,0,0,2,2,0,-2,0
Hugill,419,3,42,2018-09-16T15:00:00Z,False,18,7,0,0,0,0,0,6,4,2,-6,-4
Hugill,419,3,59,2018-09-23T12:30:00Z,True,18,5,0,0,3,0,3,15,9,6,-12,-6
Hugill,419,3,68,2018-09-29T11:30:00Z,True,18,13,0,0,4,1,3,10,4,6,-6,-5
Hugill,419,3,70,2018-10-05T19:00:00Z,False,18,2,0,0,7,4,3,5,4,1,2,-1
Hugill,419,3,88,2018-10-20T14:00:00Z,True,18,16,0,0,7,4,3,18,6,12,-11,-8
Hugill,419,3,94,2018-10-27T16:30:00Z,False,18,10,0,0,7,4,3,12,6,6,-5,-3
Hugill,419,3,108,2018-11-03T15:00:00Z,True,18,3,0,0,8,4,4,8,4,4,0,0
Hugill,419,3,114,2018-11-10T15:00:00Z,False,18,9,0,0,11,7,4,6,4,2,5,0
Hugill,419,3,128,2018-11-24T15:00:00Z,True,18,12,0,0,12,7,5,32,21,11,-20,-4
Hugill,419,3,138,2018-12-01T15:00:00Z,False,18,14,0,0,12,7,5,12,6,6,0,-1
Hugill,419,3,146,2018-12-04T19:45:00Z,True,18,4,0,0,15,7,8,11,10,1,4,6
Hugill,419,3,159,2018-12-08T15:00:00Z,True,18,6,0,0,18,10,8,12,5,7,6,3
Hugill,419,3,162,2018-12-15T17:30:00Z,False,18,8,0,0,21,13,8,9,8,1,12,0
Hugill,419,3,178,2018-12-22T15:00:00Z,True,18,17,0,0,24,13,11,24,15,9,0,4
Hugill,419,3,187,2018-12-27T19:45:00Z,False,18,15,0,0,24,13,11,15,8,7,9,3
Hugill,419,3,191,2018-12-30T14:15:00Z,False,18,3,0,0,27,13,14,12,7,5,15,7
Hugill,419,3,208,2019-01-02T19:45:00Z,True,18,2,0,0,27,13,14,25,18,7,2,6
Hugill,419,3,219,2019-01-12T12:30:00Z,True,18,0,0,0,28,14,14,41,26,15,-13,-1
Hugill,419,3,221,2019-01-19T15:00:00Z,False,18,1,0,0,31,17,14,27,18,9,4,-4
Hugill,419,3,235,2019-01-29T19:45:00Z,False,18,19,0,0,31,17,14,32,17,15,-1,-3
Hugill,419,3,249,2019-02-04T20:00:00Z,True,18,11,0,0,31,17,14,61,32,29,-30,-12
Hugill,419,3,251,2019-02-09T15:00:00Z,False,18,6,0,0,32,18,14,26,12,14,6,2
Hugill,419,3,269,2019-02-22T19:45:00Z,True,18,8,0,0,33,18,15,17,15,2,16,16
Hugill,419,3,277,2019-02-27T20:00:00Z,False,18,12,0,0,36,21,15,65,39,26,-29,-24
Hugill,419,3,288,2019-03-02T17:30:00Z,True,18,14,0,0,36,21,15,31,19,12,5,9
Hugill,419,3,291,2019-03-09T15:00:00Z,False,18,4,0,0,39,24,15,25,17,8,14,-2
Hugill,419,3,308,2019-03-16T15:00:00Z,True,18,9,0,0,39,24,15,14,8,6,25,18
Hugill,419,3,319,2019-03-30T17:30:00Z,True,18,7,0,0,42,27,15,40,25,15,2,12
Hugill,419,3,321,2019-04-08T19:00:00Z,False,18,5,0,0,42,27,15,63,35,28,-21,-20
Hugill,419,3,336,2019-04-13T16:30:00Z,False,18,13,0,0,42,27,15,61,32,29,-19,-17
Hugill,419,3,348,2019-04-20T14:00:00Z,True,18,10,0,0,42,27,15,47,23,24,-5,3
Hugill,419,3,358,2019-04-27T11:30:00Z,False,18,16,0,0,43,28,15,70,37,33,-27,-22
Hugill,419,3,368,2019-05-04T14:00:00Z,True,18,15,0,0,46,28,18,38,22,16,8,12
Hugill,419,3,379,2019-05-12T14:00:00Z,False,18,17,0,0,49,31,18,50,27,23,-1,-9
Ruddy,420,0,9,2018-08-11T16:30:00Z,True,19,7,0,0,0,0,0,0,0,0,0,0
Ruddy,420,0,16,2018-08-18T14:00:00Z,False,19,10,0,0,1,1,0,0,0,0,1,0
Ruddy,420,0,29,2018-08-25T11:30:00Z,True,19,12,0,0,1,1,0,6,3,3,-5,-2
Ruddy,420,0,39,2018-09-01T14:00:00Z,False,19,18,0,0,2,2,0,0,0,0,2,0
Ruddy,420,0,49,2018-09-16T12:30:00Z,True,19,3,0,0,5,2,3,1,0,1,4,1
Ruddy,420,0,58,2018-09-22T14:00:00Z,False,19,13,0,0,8,5,3,9,3,6,-1,0
Ruddy,420,0,69,2018-09-29T14:00:00Z,True,19,15,0,0,9,5,4,5,2,3,4,2
Ruddy,420,0,72,2018-10-06T14:00:00Z,False,19,6,0,0,12,8,4,7,1,6,5,3
Ruddy,420,0,89,2018-10-20T14:00:00Z,True,19,17,0,0,15,8,7,13,9,4,2,4
Ruddy,420,0,90,2018-10-27T14:00:00Z,False,19,2,0,0,15,8,7,11,7,4,4,0
Ruddy,420,0,109,2018-11-03T19:45:00Z,True,19,16,0,0,15,8,7,21,6,15,-6,-7
Ruddy,420,0,110,2018-11-11T16:30:00Z,False,19,0,0,0,15,8,7,23,13,10,-8,-6
Ruddy,420,0,129,2018-11-25T16:00:00Z,True,19,9,0,0,16,8,8,7,5,2,9,6
Ruddy,420,0,131,2018-11-30T20:00:00Z,False,19,4,0,0,16,8,8,8,7,1,8,1
Ruddy,420,0,147,2018-12-05T19:45:00Z,True,19,5,0,0,16,8,8,31,18,13,-15,-5
Ruddy,420,0,158,2018-12-09T16:00:00Z,False,19,14,0,0,19,11,8,13,6,7,6,2
Ruddy,420,0,169,2018-12-15T15:00:00Z,True,19,1,0,0,22,11,11,23,14,9,-1,2
Ruddy,420,0,179,2018-12-21T20:00:00Z,True,19,11,0,0,25,14,11,45,22,23,-20,-9
Ruddy,420,0,183,2018-12-26T12:30:00Z,False,19,8,0,0,25,14,11,10,8,2,15,3
Ruddy,420,0,198,2018-12-29T15:00:00Z,False,19,16,0,0,26,14,12,45,18,27,-19,-6
Ruddy,420,0,209,2019-01-02T19:45:00Z,True,19,6,0,0,29,14,15,19,9,10,10,4
Ruddy,420,0,217,2019-01-14T20:00:00Z,False,19,12,0,0,29,14,15,50,30,20,-21,-15
Ruddy,420,0,229,2019-01-19T12:30:00Z,True,19,10,0,0,29,14,15,31,14,17,-2,-3
Ruddy,420,0,235,2019-01-29T19:45:00Z,True,19,18,0,0,32,17,15,31,17,14,1,3
Ruddy,420,0,245,2019-02-02T15:00:00Z,False,19,7,0,0,35,20,15,33,21,12,2,-6
Ruddy,420,0,259,2019-02-11T20:00:00Z,True,19,14,0,0,38,20,18,24,13,11,14,9
Ruddy,420,0,261,2019-02-23T15:00:00Z,False,19,1,0,0,39,21,18,33,24,9,6,-6
Ruddy,420,0,273,2019-02-26T19:45:00Z,False,19,9,0,0,40,21,19,11,5,6,29,14
Ruddy,420,0,289,2019-03-02T15:00:00Z,True,19,4,90,7,40,21,19,25,17,8,15,13
Ruddy,420,0,292,2019-03-10T14:05:00Z,False,19,5,0,0,43,24,19,56,31,25,-13,-12
Ruddy,420,0,312,2019-03-30T15:00:00Z,False,19,3,0,0,44,24,20,30,17,13,14,3
Ruddy,420,0,329,2019-04-02T18:45:00Z,True,19,13,0,0,44,24,20,61,32,29,-17,-5
Ruddy,420,0,337,2019-04-13T14:00:00Z,False,19,15,0,0,47,27,20,33,18,15,14,2
Ruddy,420,0,349,2019-04-20T14:00:00Z,True,19,2,0,0,47,27,20,33,22,11,14,16
Ruddy,420,0,309,2019-04-24T18:45:00Z,True,19,0,0,0,48,28,20,66,44,22,-18,6
Ruddy,420,0,359,2019-04-27T14:00:00Z,False,19,17,0,0,51,31,20,50,27,23,1,-7
Ruddy,420,0,369,2019-05-04T14:00:00Z,True,19,8,0,0,54,31,23,26,21,5,28,26
Ruddy,420,0,375,2019-05-12T14:00:00Z,False,19,11,0,0,57,34,23,94,50,44,-37,-27
Norris,421,0,9,2018-08-11T16:30:00Z,True,19,7,0,0,0,0,0,0,0,0,0,0
Norris,421,0,16,2018-08-18T14:00:00Z,False,19,10,0,0,1,1,0,0,0,0,1,0
Norris,421,0,29,2018-08-25T11:30:00Z,True,19,12,0,0,1,1,0,6,3,3,-5,-2
Norris,421,0,39,2018-09-01T14:00:00Z,False,19,18,0,0,2,2,0,0,0,0,2,0
Norris,421,0,49,2018-09-16T12:30:00Z,True,19,3,0,0,5,2,3,1,0,1,4,1
Norris,421,0,58,2018-09-22T14:00:00Z,False,19,13,0,0,8,5,3,9,3,6,-1,0
Norris,421,0,69,2018-09-29T14:00:00Z,True,19,15,0,0,9,5,4,5,2,3,4,2
Norris,421,0,72,2018-10-06T14:00:00Z,False,19,6,0,0,12,8,4,7,1,6,5,3
Norris,421,0,89,2018-10-20T14:00:00Z,True,19,17,0,0,15,8,7,13,9,4,2,4
Norris,421,0,90,2018-10-27T14:00:00Z,False,19,2,0,0,15,8,7,11,7,4,4,0
Norris,421,0,109,2018-11-03T19:45:00Z,True,19,16,0,0,15,8,7,21,6,15,-6,-7
Norris,421,0,110,2018-11-11T16:30:00Z,False,19,0,0,0,15,8,7,23,13,10,-8,-6
Norris,421,0,129,2018-11-25T16:00:00Z,True,19,9,0,0,16,8,8,7,5,2,9,6
Norris,421,0,131,2018-11-30T20:00:00Z,False,19,4,0,0,16,8,8,8,7,1,8,1
Norris,421,0,147,2018-12-05T19:45:00Z,True,19,5,0,0,16,8,8,31,18,13,-15,-5
Norris,421,0,158,2018-12-09T16:00:00Z,False,19,14,0,0,19,11,8,13,6,7,6,2
Norris,421,0,169,2018-12-15T15:00:00Z,True,19,1,0,0,22,11,11,23,14,9,-1,2
Norris,421,0,179,2018-12-21T20:00:00Z,True,19,11,0,0,25,14,11,45,22,23,-20,-9
Norris,421,0,183,2018-12-26T12:30:00Z,False,19,8,0,0,25,14,11,10,8,2,15,3
Norris,421,0,198,2018-12-29T15:00:00Z,False,19,16,0,0,26,14,12,45,18,27,-19,-6
Norris,421,0,209,2019-01-02T19:45:00Z,True,19,6,0,0,29,14,15,19,9,10,10,4
Norris,421,0,217,2019-01-14T20:00:00Z,False,19,12,0,0,29,14,15,50,30,20,-21,-15
Norris,421,0,229,2019-01-19T12:30:00Z,True,19,10,0,0,29,14,15,31,14,17,-2,-3
Norris,421,0,235,2019-01-29T19:45:00Z,True,19,18,0,0,32,17,15,31,17,14,1,3
Norris,421,0,245,2019-02-02T15:00:00Z,False,19,7,0,0,35,20,15,33,21,12,2,-6
Norris,421,0,259,2019-02-11T20:00:00Z,True,19,14,0,0,38,20,18,24,13,11,14,9
Norris,421,0,261,2019-02-23T15:00:00Z,False,19,1,0,0,39,21,18,33,24,9,6,-6
Norris,421,0,273,2019-02-26T19:45:00Z,False,19,9,0,0,40,21,19,11,5,6,29,14
Norris,421,0,289,2019-03-02T15:00:00Z,True,19,4,0,0,40,21,19,25,17,8,15,13
Norris,421,0,292,2019-03-10T14:05:00Z,False,19,5,0,0,43,24,19,56,31,25,-13,-12
Norris,421,0,312,2019-03-30T15:00:00Z,False,19,3,0,0,44,24,20,30,17,13,14,3
Norris,421,0,329,2019-04-02T18:45:00Z,True,19,13,0,0,44,24,20,61,32,29,-17,-5
Norris,421,0,337,2019-04-13T14:00:00Z,False,19,15,0,0,47,27,20,33,18,15,14,2
Norris,421,0,349,2019-04-20T14:00:00Z,True,19,2,0,0,47,27,20,33,22,11,14,16
Norris,421,0,309,2019-04-24T18:45:00Z,True,19,0,0,0,48,28,20,66,44,22,-18,6
Norris,421,0,359,2019-04-27T14:00:00Z,False,19,17,0,0,51,31,20,50,27,23,1,-7
Norris,421,0,369,2019-05-04T14:00:00Z,True,19,8,1,1,54,31,23,26,21,5,28,26
Norris,421,0,375,2019-05-12T14:00:00Z,False,19,11,0,0,57,34,23,94,50,44,-37,-27
Boly,422,1,9,2018-08-11T16:30:00Z,True,19,7,90,1,0,0,0,0,0,0,0,0
Boly,422,1,16,2018-08-18T14:00:00Z,False,19,10,90,1,1,1,0,0,0,0,1,0
Boly,422,1,29,2018-08-25T11:30:00Z,True,19,12,90,8,1,1,0,6,3,3,-5,-2
Boly,422,1,39,2018-09-01T14:00:00Z,False,19,18,90,8,2,2,0,0,0,0,2,0
Boly,422,1,49,2018-09-16T12:30:00Z,True,19,3,90,7,5,2,3,1,0,1,4,1
Boly,422,1,58,2018-09-22T14:00:00Z,False,19,13,90,2,8,5,3,9,3,6,-1,0
Boly,422,1,69,2018-09-29T14:00:00Z,True,19,15,90,6,9,5,4,5,2,3,4,2
Boly,422,1,72,2018-10-06T14:00:00Z,False,19,6,90,6,12,8,4,7,1,6,5,3
Boly,422,1,89,2018-10-20T14:00:00Z,True,19,17,90,1,15,8,7,13,9,4,2,4
Boly,422,1,90,2018-10-27T14:00:00Z,False,19,2,90,2,15,8,7,11,7,4,4,0
Boly,422,1,109,2018-11-03T19:45:00Z,True,19,16,90,1,15,8,7,21,6,15,-6,-7
Boly,422,1,110,2018-11-11T16:30:00Z,False,19,0,90,2,15,8,7,23,13,10,-8,-6
Boly,422,1,129,2018-11-25T16:00:00Z,True,19,9,90,1,16,8,8,7,5,2,9,6
Boly,422,1,131,2018-11-30T20:00:00Z,False,19,4,90,1,16,8,8,8,7,1,8,1
Boly,422,1,147,2018-12-05T19:45:00Z,True,19,5,90,2,16,8,8,31,18,13,-15,-5
Boly,422,1,158,2018-12-09T16:00:00Z,False,19,14,90,2,19,11,8,13,6,7,6,2
Boly,422,1,169,2018-12-15T15:00:00Z,True,19,1,90,6,22,11,11,23,14,9,-1,2
Boly,422,1,179,2018-12-21T20:00:00Z,True,19,11,90,1,25,14,11,45,22,23,-20,-9
Boly,422,1,183,2018-12-26T12:30:00Z,False,19,8,90,2,25,14,11,10,8,2,15,3
Boly,422,1,198,2018-12-29T15:00:00Z,False,19,16,90,10,26,14,12,45,18,27,-19,-6
Boly,422,1,209,2019-01-02T19:45:00Z,True,19,6,90,0,29,14,15,19,9,10,10,4
Boly,422,1,217,2019-01-14T20:00:00Z,False,19,12,18,-3,29,14,15,50,30,20,-21,-15
Boly,422,1,229,2019-01-19T12:30:00Z,True,19,10,0,0,29,14,15,31,14,17,-2,-3
Boly,422,1,235,2019-01-29T19:45:00Z,True,19,18,0,0,32,17,15,31,17,14,1,3
Boly,422,1,245,2019-02-02T15:00:00Z,False,19,7,90,2,35,20,15,33,21,12,2,-6
Boly,422,1,259,2019-02-11T20:00:00Z,True,19,14,90,11,38,20,18,24,13,11,14,9
Boly,422,1,261,2019-02-23T15:00:00Z,False,19,1,90,2,39,21,18,33,24,9,6,-6
Boly,422,1,273,2019-02-26T19:45:00Z,False,19,9,90,2,40,21,19,11,5,6,29,14
Boly,422,1,289,2019-03-02T15:00:00Z,True,19,4,90,6,40,21,19,25,17,8,15,13
Boly,422,1,292,2019-03-10T14:05:00Z,False,19,5,90,1,43,24,19,56,31,25,-13,-12
Boly,422,1,312,2019-03-30T15:00:00Z,False,19,3,90,1,44,24,20,30,17,13,14,3
Boly,422,1,329,2019-04-02T18:45:00Z,True,19,13,90,2,44,24,20,61,32,29,-17,-5
Boly,422,1,337,2019-04-13T14:00:00Z,False,19,15,90,9,47,27,20,33,18,15,14,2
Boly,422,1,349,2019-04-20T14:00:00Z,True,19,2,90,6,47,27,20,33,22,11,14,16
Boly,422,1,309,2019-04-24T18:45:00Z,True,19,0,90,2,48,28,20,66,44,22,-18,6
Boly,422,1,359,2019-04-27T14:00:00Z,False,19,17,90,2,51,31,20,50,27,23,1,-7
Boly,422,1,369,2019-05-04T14:00:00Z,True,19,8,90,6,54,31,23,26,21,5,28,26
Boly,422,1,375,2019-05-12T14:00:00Z,False,19,11,90,1,57,34,23,94,50,44,-37,-27
Douglas,423,1,9,2018-08-11T16:30:00Z,True,19,7,0,0,0,0,0,0,0,0,0,0
Douglas,423,1,16,2018-08-18T14:00:00Z,False,19,10,0,0,1,1,0,0,0,0,1,0
Douglas,423,1,29,2018-08-25T11:30:00Z,True,19,12,0,0,1,1,0,6,3,3,-5,-2
Douglas,423,1,39,2018-09-01T14:00:00Z,False,19,18,0,0,2,2,0,0,0,0,2,0
Douglas,423,1,49,2018-09-16T12:30:00Z,True,19,3,0,0,5,2,3,1,0,1,4,1
Douglas,423,1,58,2018-09-22T14:00:00Z,False,19,13,0,0,8,5,3,9,3,6,-1,0
Douglas,423,1,69,2018-09-29T14:00:00Z,True,19,15,0,0,9,5,4,5,2,3,4,2
Douglas,423,1,72,2018-10-06T14:00:00Z,False,19,6,0,0,12,8,4,7,1,6,5,3
Douglas,423,1,89,2018-10-20T14:00:00Z,True,19,17,0,0,15,8,7,13,9,4,2,4
Douglas,423,1,90,2018-10-27T14:00:00Z,False,19,2,0,0,15,8,7,11,7,4,4,0
Douglas,423,1,109,2018-11-03T19:45:00Z,True,19,16,0,0,15,8,7,21,6,15,-6,-7
Douglas,423,1,110,2018-11-11T16:30:00Z,False,19,0,0,0,15,8,7,23,13,10,-8,-6
Douglas,423,1,129,2018-11-25T16:00:00Z,True,19,9,0,0,16,8,8,7,5,2,9,6
Douglas,423,1,131,2018-11-30T20:00:00Z,False,19,4,0,0,16,8,8,8,7,1,8,1
Douglas,423,1,147,2018-12-05T19:45:00Z,True,19,5,0,0,16,8,8,31,18,13,-15,-5
Douglas,423,1,158,2018-12-09T16:00:00Z,False,19,14,0,0,19,11,8,13,6,7,6,2
Douglas,423,1,169,2018-12-15T15:00:00Z,True,19,1,0,0,22,11,11,23,14,9,-1,2
Douglas,423,1,179,2018-12-21T20:00:00Z,True,19,11,0,0,25,14,11,45,22,23,-20,-9
Douglas,423,1,183,2018-12-26T12:30:00Z,False,19,8,0,0,25,14,11,10,8,2,15,3
Douglas,423,1,198,2018-12-29T15:00:00Z,False,19,16,0,0,26,14,12,45,18,27,-19,-6
Douglas,423,1,209,2019-01-02T19:45:00Z,True,19,6,0,0,29,14,15,19,9,10,10,4
Douglas,423,1,217,2019-01-14T20:00:00Z,False,19,12,0,0,29,14,15,50,30,20,-21,-15
Douglas,423,1,229,2019-01-19T12:30:00Z,True,19,10,0,0,29,14,15,31,14,17,-2,-3
Douglas,423,1,235,2019-01-29T19:45:00Z,True,19,18,0,0,32,17,15,31,17,14,1,3
Douglas,423,1,245,2019-02-02T15:00:00Z,False,19,7,0,0,35,20,15,33,21,12,2,-6
Douglas,423,1,259,2019-02-11T20:00:00Z,True,19,14,0,0,38,20,18,24,13,11,14,9
Douglas,423,1,261,2019-02-23T15:00:00Z,False,19,1,0,0,39,21,18,33,24,9,6,-6
Douglas,423,1,273,2019-02-26T19:45:00Z,False,19,9,0,0,40,21,19,11,5,6,29,14
Douglas,423,1,289,2019-03-02T15:00:00Z,True,19,4,0,0,40,21,19,25,17,8,15,13
Douglas,423,1,292,2019-03-10T14:05:00Z,False,19,5,0,0,43,24,19,56,31,25,-13,-12
Douglas,423,1,312,2019-03-30T15:00:00Z,False,19,3,0,0,44,24,20,30,17,13,14,3
Douglas,423,1,329,2019-04-02T18:45:00Z,True,19,13,0,0,44,24,20,61,32,29,-17,-5
Douglas,423,1,337,2019-04-13T14:00:00Z,False,19,15,0,0,47,27,20,33,18,15,14,2
Douglas,423,1,349,2019-04-20T14:00:00Z,True,19,2,0,0,47,27,20,33,22,11,14,16
Douglas,423,1,309,2019-04-24T18:45:00Z,True,19,0,0,0,48,28,20,66,44,22,-18,6
Douglas,423,1,359,2019-04-27T14:00:00Z,False,19,17,0,0,51,31,20,50,27,23,1,-7
Douglas,423,1,369,2019-05-04T14:00:00Z,True,19,8,0,0,54,31,23,26,21,5,28,26
Douglas,423,1,375,2019-05-12T14:00:00Z,False,19,11,0,0,57,34,23,94,50,44,-37,-27
Doherty,424,1,9,2018-08-11T16:30:00Z,True,19,7,90,1,0,0,0,0,0,0,0,0
Doherty,424,1,16,2018-08-18T14:00:00Z,False,19,10,68,-1,1,1,0,0,0,0,1,0
Doherty,424,1,29,2018-08-25T11:30:00Z,True,19,12,90,2,1,1,0,6,3,3,-5,-2
Doherty,424,1,39,2018-09-01T14:00:00Z,False,19,18,90,6,2,2,0,0,0,0,2,0
Doherty,424,1,49,2018-09-16T12:30:00Z,True,19,3,90,12,5,2,3,1,0,1,4,1
Doherty,424,1,58,2018-09-22T14:00:00Z,False,19,13,90,2,8,5,3,9,3,6,-1,0
Doherty,424,1,69,2018-09-29T14:00:00Z,True,19,15,90,12,9,5,4,5,2,3,4,2
Doherty,424,1,72,2018-10-06T14:00:00Z,False,19,6,90,15,12,8,4,7,1,6,5,3
Doherty,424,1,89,2018-10-20T14:00:00Z,True,19,17,71,1,15,8,7,13,9,4,2,4
Doherty,424,1,90,2018-10-27T14:00:00Z,False,19,2,90,2,15,8,7,11,7,4,4,0
Doherty,424,1,109,2018-11-03T19:45:00Z,True,19,16,90,1,15,8,7,21,6,15,-6,-7
Doherty,424,1,110,2018-11-11T16:30:00Z,False,19,0,90,1,15,8,7,23,13,10,-8,-6
Doherty,424,1,129,2018-11-25T16:00:00Z,True,19,9,90,1,16,8,8,7,5,2,9,6
Doherty,424,1,131,2018-11-30T20:00:00Z,False,19,4,90,7,16,8,8,8,7,1,8,1
Doherty,424,1,147,2018-12-05T19:45:00Z,True,19,5,90,5,16,8,8,31,18,13,-15,-5
Doherty,424,1,158,2018-12-09T16:00:00Z,False,19,14,90,7,19,11,8,13,6,7,6,2
Doherty,424,1,169,2018-12-15T15:00:00Z,True,19,1,90,6,22,11,11,23,14,9,-1,2
Doherty,424,1,179,2018-12-21T20:00:00Z,True,19,11,90,1,25,14,11,45,22,23,-20,-9
Doherty,424,1,183,2018-12-26T12:30:00Z,False,19,8,90,2,25,14,11,10,8,2,15,3
Doherty,424,1,198,2018-12-29T15:00:00Z,False,19,16,90,5,26,14,12,45,18,27,-19,-6
Doherty,424,1,209,2019-01-02T19:45:00Z,True,19,6,90,1,29,14,15,19,9,10,10,4
Doherty,424,1,217,2019-01-14T20:00:00Z,False,19,12,90,1,29,14,15,50,30,20,-21,-15
Doherty,424,1,229,2019-01-19T12:30:00Z,True,19,10,17,1,29,14,15,31,14,17,-2,-3
Doherty,424,1,235,2019-01-29T19:45:00Z,True,19,18,90,6,32,17,15,31,17,14,1,3
Doherty,424,1,245,2019-02-02T15:00:00Z,False,19,7,90,5,35,20,15,33,21,12,2,-6
Doherty,424,1,259,2019-02-11T20:00:00Z,True,19,14,80,2,38,20,18,24,13,11,14,9
Doherty,424,1,261,2019-02-23T15:00:00Z,False,19,1,90,5,39,21,18,33,24,9,6,-6
Doherty,424,1,273,2019-02-26T19:45:00Z,False,19,9,90,1,40,21,19,11,5,6,29,14
Doherty,424,1,289,2019-03-02T15:00:00Z,True,19,4,43,1,40,21,19,25,17,8,15,13
Doherty,424,1,292,2019-03-10T14:05:00Z,False,19,5,90,1,43,24,19,56,31,25,-13,-12
Doherty,424,1,312,2019-03-30T15:00:00Z,False,19,3,31,1,44,24,20,30,17,13,14,3
Doherty,424,1,329,2019-04-02T18:45:00Z,True,19,13,90,2,44,24,20,61,32,29,-17,-5
Doherty,424,1,337,2019-04-13T14:00:00Z,False,19,15,59,0,47,27,20,33,18,15,14,2
Doherty,424,1,349,2019-04-20T14:00:00Z,True,19,2,83,6,47,27,20,33,22,11,14,16
Doherty,424,1,309,2019-04-24T18:45:00Z,True,19,0,90,7,48,28,20,66,44,22,-18,6
Doherty,424,1,359,2019-04-27T14:00:00Z,False,19,17,90,2,51,31,20,50,27,23,1,-7
Doherty,424,1,369,2019-05-04T14:00:00Z,True,19,8,90,12,54,31,23,26,21,5,28,26
Doherty,424,1,375,2019-05-12T14:00:00Z,False,19,11,79,2,57,34,23,94,50,44,-37,-27
Saiss,425,1,9,2018-08-11T16:30:00Z,True,19,7,0,0,0,0,0,0,0,0,0,0
Saiss,425,1,16,2018-08-18T14:00:00Z,False,19,10,0,0,1,1,0,0,0,0,1,0
Saiss,425,1,29,2018-08-25T11:30:00Z,True,19,12,0,0,1,1,0,6,3,3,-5,-2
Saiss,425,1,39,2018-09-01T14:00:00Z,False,19,18,0,0,2,2,0,0,0,0,2,0
Saiss,425,1,49,2018-09-16T12:30:00Z,True,19,3,0,0,5,2,3,1,0,1,4,1
Saiss,425,1,58,2018-09-22T14:00:00Z,False,19,13,10,1,8,5,3,9,3,6,-1,0
Saiss,425,1,69,2018-09-29T14:00:00Z,True,19,15,0,0,9,5,4,5,2,3,4,2
Saiss,425,1,72,2018-10-06T14:00:00Z,False,19,6,6,1,12,8,4,7,1,6,5,3
Saiss,425,1,89,2018-10-20T14:00:00Z,True,19,17,0,0,15,8,7,13,9,4,2,4
Saiss,425,1,90,2018-10-27T14:00:00Z,False,19,2,0,0,15,8,7,11,7,4,4,0
Saiss,425,1,109,2018-11-03T19:45:00Z,True,19,16,0,0,15,8,7,21,6,15,-6,-7
Saiss,425,1,110,2018-11-11T16:30:00Z,False,19,0,0,0,15,8,7,23,13,10,-8,-6
Saiss,425,1,129,2018-11-25T16:00:00Z,True,19,9,0,0,16,8,8,7,5,2,9,6
Saiss,425,1,131,2018-11-30T20:00:00Z,False,19,4,90,0,16,8,8,8,7,1,8,1
Saiss,425,1,147,2018-12-05T19:45:00Z,True,19,5,90,1,16,8,8,31,18,13,-15,-5
Saiss,425,1,158,2018-12-09T16:00:00Z,False,19,14,59,1,19,11,8,13,6,7,6,2
Saiss,425,1,169,2018-12-15T15:00:00Z,True,19,1,15,1,22,11,11,23,14,9,-1,2
Saiss,425,1,179,2018-12-21T20:00:00Z,True,19,11,90,1,25,14,11,45,22,23,-20,-9
Saiss,425,1,183,2018-12-26T12:30:00Z,False,19,8,90,10,25,14,11,10,8,2,15,3
Saiss,425,1,198,2018-12-29T15:00:00Z,False,19,16,0,0,26,14,12,45,18,27,-19,-6
Saiss,425,1,209,2019-01-02T19:45:00Z,True,19,6,72,5,29,14,15,19,9,10,10,4
Saiss,425,1,217,2019-01-14T20:00:00Z,False,19,12,31,1,29,14,15,50,30,20,-21,-15
Saiss,425,1,229,2019-01-19T12:30:00Z,True,19,10,90,1,29,14,15,31,14,17,-2,-3
Saiss,425,1,235,2019-01-29T19:45:00Z,True,19,18,90,12,32,17,15,31,17,14,1,3
Saiss,425,1,245,2019-02-02T15:00:00Z,False,19,7,41,1,35,20,15,33,21,12,2,-6
Saiss,425,1,259,2019-02-11T20:00:00Z,True,19,14,0,0,38,20,18,24,13,11,14,9
Saiss,425,1,261,2019-02-23T15:00:00Z,False,19,1,2,1,39,21,18,33,24,9,6,-6
Saiss,425,1,273,2019-02-26T19:45:00Z,False,19,9,0,0,40,21,19,11,5,6,29,14
Saiss,425,1,289,2019-03-02T15:00:00Z,True,19,4,90,7,40,21,19,25,17,8,15,13
Saiss,425,1,292,2019-03-10T14:05:00Z,False,19,5,90,1,43,24,19,56,31,25,-13,-12
Saiss,425,1,312,2019-03-30T15:00:00Z,False,19,3,90,1,44,24,20,30,17,13,14,3
Saiss,425,1,329,2019-04-02T18:45:00Z,True,19,13,6,1,44,24,20,61,32,29,-17,-5
Saiss,425,1,337,2019-04-13T14:00:00Z,False,19,15,90,0,47,27,20,33,18,15,14,2
Saiss,425,1,349,2019-04-20T14:00:00Z,True,19,2,0,0,47,27,20,33,22,11,14,16
Saiss,425,1,309,2019-04-24T18:45:00Z,True,19,0,0,0,48,28,20,66,44,22,-18,6
Saiss,425,1,359,2019-04-27T14:00:00Z,False,19,17,0,0,51,31,20,50,27,23,1,-7
Saiss,425,1,369,2019-05-04T14:00:00Z,True,19,8,0,0,54,31,23,26,21,5,28,26
Saiss,425,1,375,2019-05-12T14:00:00Z,False,19,11,0,0,57,34,23,94,50,44,-37,-27
Bennett,426,1,9,2018-08-11T16:30:00Z,True,19,7,90,1,0,0,0,0,0,0,0,0
Bennett,426,1,16,2018-08-18T14:00:00Z,False,19,10,90,1,1,1,0,0,0,0,1,0
Bennett,426,1,29,2018-08-25T11:30:00Z,True,19,12,90,2,1,1,0,6,3,3,-5,-2
Bennett,426,1,39,2018-09-01T14:00:00Z,False,19,18,90,5,2,2,0,0,0,0,2,0
Bennett,426,1,49,2018-09-16T12:30:00Z,True,19,3,90,6,5,2,3,1,0,1,4,1
Bennett,426,1,58,2018-09-22T14:00:00Z,False,19,13,90,2,8,5,3,9,3,6,-1,0
Bennett,426,1,69,2018-09-29T14:00:00Z,True,19,15,90,6,9,5,4,5,2,3,4,2
Bennett,426,1,72,2018-10-06T14:00:00Z,False,19,6,90,7,12,8,4,7,1,6,5,3
Bennett,426,1,89,2018-10-20T14:00:00Z,True,19,17,90,0,15,8,7,13,9,4,2,4
Bennett,426,1,90,2018-10-27T14:00:00Z,False,19,2,90,2,15,8,7,11,7,4,4,0
Bennett,426,1,109,2018-11-03T19:45:00Z,True,19,16,90,0,15,8,7,21,6,15,-6,-7
Bennett,426,1,110,2018-11-11T16:30:00Z,False,19,0,90,2,15,8,7,23,13,10,-8,-6
Bennett,426,1,129,2018-11-25T16:00:00Z,True,19,9,90,1,16,8,8,7,5,2,9,6
Bennett,426,1,131,2018-11-30T20:00:00Z,False,19,4,0,0,16,8,8,8,7,1,8,1
Bennett,426,1,147,2018-12-05T19:45:00Z,True,19,5,90,2,16,8,8,31,18,13,-15,-5
Bennett,426,1,158,2018-12-09T16:00:00Z,False,19,14,90,1,19,11,8,13,6,7,6,2
Bennett,426,1,169,2018-12-15T15:00:00Z,True,19,1,90,6,22,11,11,23,14,9,-1,2
Bennett,426,1,179,2018-12-21T20:00:00Z,True,19,11,90,1,25,14,11,45,22,23,-20,-9
Bennett,426,1,183,2018-12-26T12:30:00Z,False,19,8,90,2,25,14,11,10,8,2,15,3
Bennett,426,1,198,2018-12-29T15:00:00Z,False,19,16,90,2,26,14,12,45,18,27,-19,-6
Bennett,426,1,209,2019-01-02T19:45:00Z,True,19,6,90,0,29,14,15,19,9,10,10,4
Bennett,426,1,217,2019-01-14T20:00:00Z,False,19,12,90,1,29,14,15,50,30,20,-21,-15
Bennett,426,1,229,2019-01-19T12:30:00Z,True,19,10,90,6,29,14,15,31,14,17,-2,-3
Bennett,426,1,235,2019-01-29T19:45:00Z,True,19,18,90,5,32,17,15,31,17,14,1,3
Bennett,426,1,245,2019-02-02T15:00:00Z,False,19,7,90,2,35,20,15,33,21,12,2,-6
Bennett,426,1,259,2019-02-11T20:00:00Z,True,19,14,90,2,38,20,18,24,13,11,14,9
Bennett,426,1,261,2019-02-23T15:00:00Z,False,19,1,90,1,39,21,18,33,24,9,6,-6
Bennett,426,1,273,2019-02-26T19:45:00Z,False,19,9,90,1,40,21,19,11,5,6,29,14
Bennett,426,1,289,2019-03-02T15:00:00Z,True,19,4,90,5,40,21,19,25,17,8,15,13
Bennett,426,1,292,2019-03-10T14:05:00Z,False,19,5,0,0,43,24,19,56,31,25,-13,-12
Bennett,426,1,312,2019-03-30T15:00:00Z,False,19,3,0,0,44,24,20,30,17,13,14,3
Bennett,426,1,329,2019-04-02T18:45:00Z,True,19,13,90,2,44,24,20,61,32,29,-17,-5
Bennett,426,1,337,2019-04-13T14:00:00Z,False,19,15,0,0,47,27,20,33,18,15,14,2
Bennett,426,1,349,2019-04-20T14:00:00Z,True,19,2,90,6,47,27,20,33,22,11,14,16
Bennett,426,1,309,2019-04-24T18:45:00Z,True,19,0,90,1,48,28,20,66,44,22,-18,6
Bennett,426,1,359,2019-04-27T14:00:00Z,False,19,17,90,2,51,31,20,50,27,23,1,-7
Bennett,426,1,369,2019-05-04T14:00:00Z,True,19,8,90,6,54,31,23,26,21,5,28,26
Bennett,426,1,375,2019-05-12T14:00:00Z,False,19,11,90,0,57,34,23,94,50,44,-37,-27
Batth,427,1,9,2018-08-11T16:30:00Z,True,19,7,0,0,0,0,0,0,0,0,0,0
Batth,427,1,16,2018-08-18T14:00:00Z,False,19,10,0,0,1,1,0,0,0,0,1,0
Batth,427,1,29,2018-08-25T11:30:00Z,True,19,12,0,0,1,1,0,6,3,3,-5,-2
Batth,427,1,39,2018-09-01T14:00:00Z,False,19,18,0,0,2,2,0,0,0,0,2,0
Batth,427,1,49,2018-09-16T12:30:00Z,True,19,3,0,0,5,2,3,1,0,1,4,1
Batth,427,1,58,2018-09-22T14:00:00Z,False,19,13,0,0,8,5,3,9,3,6,-1,0
Batth,427,1,69,2018-09-29T14:00:00Z,True,19,15,0,0,9,5,4,5,2,3,4,2
Batth,427,1,72,2018-10-06T14:00:00Z,False,19,6,0,0,12,8,4,7,1,6,5,3
Batth,427,1,89,2018-10-20T14:00:00Z,True,19,17,0,0,15,8,7,13,9,4,2,4
Batth,427,1,90,2018-10-27T14:00:00Z,False,19,2,0,0,15,8,7,11,7,4,4,0
Batth,427,1,109,2018-11-03T19:45:00Z,True,19,16,0,0,15,8,7,21,6,15,-6,-7
Batth,427,1,110,2018-11-11T16:30:00Z,False,19,0,0,0,15,8,7,23,13,10,-8,-6
Batth,427,1,129,2018-11-25T16:00:00Z,True,19,9,0,0,16,8,8,7,5,2,9,6
Batth,427,1,131,2018-11-30T20:00:00Z,False,19,4,0,0,16,8,8,8,7,1,8,1
Batth,427,1,147,2018-12-05T19:45:00Z,True,19,5,0,0,16,8,8,31,18,13,-15,-5
Batth,427,1,158,2018-12-09T16:00:00Z,False,19,14,0,0,19,11,8,13,6,7,6,2
Batth,427,1,169,2018-12-15T15:00:00Z,True,19,1,0,0,22,11,11,23,14,9,-1,2
Batth,427,1,179,2018-12-21T20:00:00Z,True,19,11,0,0,25,14,11,45,22,23,-20,-9
Batth,427,1,183,2018-12-26T12:30:00Z,False,19,8,0,0,25,14,11,10,8,2,15,3
Batth,427,1,198,2018-12-29T15:00:00Z,False,19,16,0,0,26,14,12,45,18,27,-19,-6
Batth,427,1,209,2019-01-02T19:45:00Z,True,19,6,0,0,29,14,15,19,9,10,10,4
Batth,427,1,217,2019-01-14T20:00:00Z,False,19,12,0,0,29,14,15,50,30,20,-21,-15
Batth,427,1,229,2019-01-19T12:30:00Z,True,19,10,0,0,29,14,15,31,14,17,-2,-3
Batth,427,1,235,2019-01-29T19:45:00Z,True,19,18,0,0,32,17,15,31,17,14,1,3
Batth,427,1,245,2019-02-02T15:00:00Z,False,19,7,0,0,35,20,15,33,21,12,2,-6
Batth,427,1,259,2019-02-11T20:00:00Z,True,19,14,0,0,38,20,18,24,13,11,14,9
Batth,427,1,261,2019-02-23T15:00:00Z,False,19,1,0,0,39,21,18,33,24,9,6,-6
Batth,427,1,273,2019-02-26T19:45:00Z,False,19,9,0,0,40,21,19,11,5,6,29,14
Batth,427,1,289,2019-03-02T15:00:00Z,True,19,4,0,0,40,21,19,25,17,8,15,13
Batth,427,1,292,2019-03-10T14:05:00Z,False,19,5,0,0,43,24,19,56,31,25,-13,-12
Batth,427,1,312,2019-03-30T15:00:00Z,False,19,3,0,0,44,24,20,30,17,13,14,3
Batth,427,1,329,2019-04-02T18:45:00Z,True,19,13,0,0,44,24,20,61,32,29,-17,-5
Batth,427,1,337,2019-04-13T14:00:00Z,False,19,15,0,0,47,27,20,33,18,15,14,2
Batth,427,1,349,2019-04-20T14:00:00Z,True,19,2,0,0,47,27,20,33,22,11,14,16
Batth,427,1,309,2019-04-24T18:45:00Z,True,19,0,0,0,48,28,20,66,44,22,-18,6
Batth,427,1,359,2019-04-27T14:00:00Z,False,19,17,0,0,51,31,20,50,27,23,1,-7
Batth,427,1,369,2019-05-04T14:00:00Z,True,19,8,0,0,54,31,23,26,21,5,28,26
Batth,427,1,375,2019-05-12T14:00:00Z,False,19,11,0,0,57,34,23,94,50,44,-37,-27
Miranda,428,1,9,2018-08-11T16:30:00Z,True,19,7,0,0,0,0,0,0,0,0,0,0
Miranda,428,1,16,2018-08-18T14:00:00Z,False,19,10,0,0,1,1,0,0,0,0,1,0
Miranda,428,1,29,2018-08-25T11:30:00Z,True,19,12,0,0,1,1,0,6,3,3,-5,-2
Miranda,428,1,39,2018-09-01T14:00:00Z,False,19,18,0,0,2,2,0,0,0,0,2,0
Miranda,428,1,49,2018-09-16T12:30:00Z,True,19,3,0,0,5,2,3,1,0,1,4,1
Miranda,428,1,58,2018-09-22T14:00:00Z,False,19,13,0,0,8,5,3,9,3,6,-1,0
Miranda,428,1,69,2018-09-29T14:00:00Z,True,19,15,0,0,9,5,4,5,2,3,4,2
Miranda,428,1,72,2018-10-06T14:00:00Z,False,19,6,0,0,12,8,4,7,1,6,5,3
Miranda,428,1,89,2018-10-20T14:00:00Z,True,19,17,0,0,15,8,7,13,9,4,2,4
Miranda,428,1,90,2018-10-27T14:00:00Z,False,19,2,0,0,15,8,7,11,7,4,4,0
Miranda,428,1,109,2018-11-03T19:45:00Z,True,19,16,0,0,15,8,7,21,6,15,-6,-7
Miranda,428,1,110,2018-11-11T16:30:00Z,False,19,0,0,0,15,8,7,23,13,10,-8,-6
Miranda,428,1,129,2018-11-25T16:00:00Z,True,19,9,0,0,16,8,8,7,5,2,9,6
Miranda,428,1,131,2018-11-30T20:00:00Z,False,19,4,0,0,16,8,8,8,7,1,8,1
Miranda,428,1,147,2018-12-05T19:45:00Z,True,19,5,0,0,16,8,8,31,18,13,-15,-5
Miranda,428,1,158,2018-12-09T16:00:00Z,False,19,14,0,0,19,11,8,13,6,7,6,2
Miranda,428,1,169,2018-12-15T15:00:00Z,True,19,1,0,0,22,11,11,23,14,9,-1,2
Miranda,428,1,179,2018-12-21T20:00:00Z,True,19,11,0,0,25,14,11,45,22,23,-20,-9
Miranda,428,1,183,2018-12-26T12:30:00Z,False,19,8,0,0,25,14,11,10,8,2,15,3
Miranda,428,1,198,2018-12-29T15:00:00Z,False,19,16,0,0,26,14,12,45,18,27,-19,-6
Miranda,428,1,209,2019-01-02T19:45:00Z,True,19,6,0,0,29,14,15,19,9,10,10,4
Miranda,428,1,217,2019-01-14T20:00:00Z,False,19,12,0,0,29,14,15,50,30,20,-21,-15
Miranda,428,1,229,2019-01-19T12:30:00Z,True,19,10,0,0,29,14,15,31,14,17,-2,-3
Miranda,428,1,235,2019-01-29T19:45:00Z,True,19,18,0,0,32,17,15,31,17,14,1,3
Miranda,428,1,245,2019-02-02T15:00:00Z,False,19,7,0,0,35,20,15,33,21,12,2,-6
Miranda,428,1,259,2019-02-11T20:00:00Z,True,19,14,0,0,38,20,18,24,13,11,14,9
Miranda,428,1,261,2019-02-23T15:00:00Z,False,19,1,0,0,39,21,18,33,24,9,6,-6
Miranda,428,1,273,2019-02-26T19:45:00Z,False,19,9,0,0,40,21,19,11,5,6,29,14
Miranda,428,1,289,2019-03-02T15:00:00Z,True,19,4,0,0,40,21,19,25,17,8,15,13
Miranda,428,1,292,2019-03-10T14:05:00Z,False,19,5,0,0,43,24,19,56,31,25,-13,-12
Miranda,428,1,312,2019-03-30T15:00:00Z,False,19,3,0,0,44,24,20,30,17,13,14,3
Miranda,428,1,329,2019-04-02T18:45:00Z,True,19,13,0,0,44,24,20,61,32,29,-17,-5
Miranda,428,1,337,2019-04-13T14:00:00Z,False,19,15,0,0,47,27,20,33,18,15,14,2
Miranda,428,1,349,2019-04-20T14:00:00Z,True,19,2,0,0,47,27,20,33,22,11,14,16
Miranda,428,1,309,2019-04-24T18:45:00Z,True,19,0,0,0,48,28,20,66,44,22,-18,6
Miranda,428,1,359,2019-04-27T14:00:00Z,False,19,17,0,0,51,31,20,50,27,23,1,-7
Miranda,428,1,369,2019-05-04T14:00:00Z,True,19,8,0,0,54,31,23,26,21,5,28,26
Miranda,428,1,375,2019-05-12T14:00:00Z,False,19,11,0,0,57,34,23,94,50,44,-37,-27
Coady,429,1,9,2018-08-11T16:30:00Z,True,19,7,90,1,0,0,0,0,0,0,0,0
Coady,429,1,16,2018-08-18T14:00:00Z,False,19,10,90,1,1,1,0,0,0,0,1,0
Coady,429,1,29,2018-08-25T11:30:00Z,True,19,12,90,1,1,1,0,6,3,3,-5,-2
Coady,429,1,39,2018-09-01T14:00:00Z,False,19,18,90,8,2,2,0,0,0,0,2,0
Coady,429,1,49,2018-09-16T12:30:00Z,True,19,3,90,6,5,2,3,1,0,1,4,1
Coady,429,1,58,2018-09-22T14:00:00Z,False,19,13,90,2,8,5,3,9,3,6,-1,0
Coady,429,1,69,2018-09-29T14:00:00Z,True,19,15,90,6,9,5,4,5,2,3,4,2
Coady,429,1,72,2018-10-06T14:00:00Z,False,19,6,90,5,12,8,4,7,1,6,5,3
Coady,429,1,89,2018-10-20T14:00:00Z,True,19,17,90,1,15,8,7,13,9,4,2,4
Coady,429,1,90,2018-10-27T14:00:00Z,False,19,2,90,2,15,8,7,11,7,4,4,0
Coady,429,1,109,2018-11-03T19:45:00Z,True,19,16,90,1,15,8,7,21,6,15,-6,-7
Coady,429,1,110,2018-11-11T16:30:00Z,False,19,0,90,2,15,8,7,23,13,10,-8,-6
Coady,429,1,129,2018-11-25T16:00:00Z,True,19,9,90,1,16,8,8,7,5,2,9,6
Coady,429,1,131,2018-11-30T20:00:00Z,False,19,4,90,1,16,8,8,8,7,1,8,1
Coady,429,1,147,2018-12-05T19:45:00Z,True,19,5,90,1,16,8,8,31,18,13,-15,-5
Coady,429,1,158,2018-12-09T16:00:00Z,False,19,14,90,1,19,11,8,13,6,7,6,2
Coady,429,1,169,2018-12-15T15:00:00Z,True,19,1,90,9,22,11,11,23,14,9,-1,2
Coady,429,1,179,2018-12-21T20:00:00Z,True,19,11,90,1,25,14,11,45,22,23,-20,-9
Coady,429,1,183,2018-12-26T12:30:00Z,False,19,8,90,2,25,14,11,10,8,2,15,3
Coady,429,1,198,2018-12-29T15:00:00Z,False,19,16,90,2,26,14,12,45,18,27,-19,-6
Coady,429,1,209,2019-01-02T19:45:00Z,True,19,6,90,1,29,14,15,19,9,10,10,4
Coady,429,1,217,2019-01-14T20:00:00Z,False,19,12,90,-1,29,14,15,50,30,20,-21,-15
Coady,429,1,229,2019-01-19T12:30:00Z,True,19,10,90,-1,29,14,15,31,14,17,-2,-3
Coady,429,1,235,2019-01-29T19:45:00Z,True,19,18,90,6,32,17,15,31,17,14,1,3
Coady,429,1,245,2019-02-02T15:00:00Z,False,19,7,90,1,35,20,15,33,21,12,2,-6
Coady,429,1,259,2019-02-11T20:00:00Z,True,19,14,90,2,38,20,18,24,13,11,14,9
Coady,429,1,261,2019-02-23T15:00:00Z,False,19,1,90,2,39,21,18,33,24,9,6,-6
Coady,429,1,273,2019-02-26T19:45:00Z,False,19,9,90,2,40,21,19,11,5,6,29,14
Coady,429,1,289,2019-03-02T15:00:00Z,True,19,4,90,6,40,21,19,25,17,8,15,13
Coady,429,1,292,2019-03-10T14:05:00Z,False,19,5,90,2,43,24,19,56,31,25,-13,-12
Coady,429,1,312,2019-03-30T15:00:00Z,False,19,3,90,-1,44,24,20,30,17,13,14,3
Coady,429,1,329,2019-04-02T18:45:00Z,True,19,13,90,2,44,24,20,61,32,29,-17,-5
Coady,429,1,337,2019-04-13T14:00:00Z,False,19,15,90,1,47,27,20,33,18,15,14,2
Coady,429,1,349,2019-04-20T14:00:00Z,True,19,2,90,7,47,27,20,33,22,11,14,16
Coady,429,1,309,2019-04-24T18:45:00Z,True,19,0,90,2,48,28,20,66,44,22,-18,6
Coady,429,1,359,2019-04-27T14:00:00Z,False,19,17,90,2,51,31,20,50,27,23,1,-7
Coady,429,1,369,2019-05-04T14:00:00Z,True,19,8,90,6,54,31,23,26,21,5,28,26
Coady,429,1,375,2019-05-12T14:00:00Z,False,19,11,90,1,57,34,23,94,50,44,-37,-27
Vinagre,430,1,9,2018-08-11T16:30:00Z,True,19,7,14,1,0,0,0,0,0,0,0,0
Vinagre,430,1,16,2018-08-18T14:00:00Z,False,19,10,0,0,1,1,0,0,0,0,1,0
Vinagre,430,1,29,2018-08-25T11:30:00Z,True,19,12,5,1,1,1,0,6,3,3,-5,-2
Vinagre,430,1,39,2018-09-01T14:00:00Z,False,19,18,3,1,2,2,0,0,0,0,2,0
Vinagre,430,1,49,2018-09-16T12:30:00Z,True,19,3,0,0,5,2,3,1,0,1,4,1
Vinagre,430,1,58,2018-09-22T14:00:00Z,False,19,13,0,0,8,5,3,9,3,6,-1,0
Vinagre,430,1,69,2018-09-29T14:00:00Z,True,19,15,0,0,9,5,4,5,2,3,4,2
Vinagre,430,1,72,2018-10-06T14:00:00Z,False,19,6,0,0,12,8,4,7,1,6,5,3
Vinagre,430,1,89,2018-10-20T14:00:00Z,True,19,17,45,1,15,8,7,13,9,4,2,4
Vinagre,430,1,90,2018-10-27T14:00:00Z,False,19,2,0,0,15,8,7,11,7,4,4,0
Vinagre,430,1,109,2018-11-03T19:45:00Z,True,19,16,0,0,15,8,7,21,6,15,-6,-7
Vinagre,430,1,110,2018-11-11T16:30:00Z,False,19,0,0,0,15,8,7,23,13,10,-8,-6
Vinagre,430,1,129,2018-11-25T16:00:00Z,True,19,9,90,1,16,8,8,7,5,2,9,6
Vinagre,430,1,131,2018-11-30T20:00:00Z,False,19,4,81,1,16,8,8,8,7,1,8,1
Vinagre,430,1,147,2018-12-05T19:45:00Z,True,19,5,90,1,16,8,8,31,18,13,-15,-5
Vinagre,430,1,158,2018-12-09T16:00:00Z,False,19,14,90,2,19,11,8,13,6,7,6,2
Vinagre,430,1,169,2018-12-15T15:00:00Z,True,19,1,0,0,22,11,11,23,14,9,-1,2
Vinagre,430,1,179,2018-12-21T20:00:00Z,True,19,11,9,1,25,14,11,45,22,23,-20,-9
Vinagre,430,1,183,2018-12-26T12:30:00Z,False,19,8,8,1,25,14,11,10,8,2,15,3
Vinagre,430,1,198,2018-12-29T15:00:00Z,False,19,16,0,0,26,14,12,45,18,27,-19,-6
Vinagre,430,1,209,2019-01-02T19:45:00Z,True,19,6,0,0,29,14,15,19,9,10,10,4
Vinagre,430,1,217,2019-01-14T20:00:00Z,False,19,12,0,0,29,14,15,50,30,20,-21,-15
Vinagre,430,1,229,2019-01-19T12:30:00Z,True,19,10,72,1,29,14,15,31,14,17,-2,-3
Vinagre,430,1,235,2019-01-29T19:45:00Z,True,19,18,1,1,32,17,15,31,17,14,1,3
Vinagre,430,1,245,2019-02-02T15:00:00Z,False,19,7,0,0,35,20,15,33,21,12,2,-6
Vinagre,430,1,259,2019-02-11T20:00:00Z,True,19,14,0,0,38,20,18,24,13,11,14,9
Vinagre,430,1,261,2019-02-23T15:00:00Z,False,19,1,0,0,39,21,18,33,24,9,6,-6
Vinagre,430,1,273,2019-02-26T19:45:00Z,False,19,9,0,0,40,21,19,11,5,6,29,14
Vinagre,430,1,289,2019-03-02T15:00:00Z,True,19,4,90,6,40,21,19,25,17,8,15,13
Vinagre,430,1,292,2019-03-10T14:05:00Z,False,19,5,0,0,43,24,19,56,31,25,-13,-12
Vinagre,430,1,312,2019-03-30T15:00:00Z,False,19,3,0,0,44,24,20,30,17,13,14,3
Vinagre,430,1,329,2019-04-02T18:45:00Z,True,19,13,75,2,44,24,20,61,32,29,-17,-5
Vinagre,430,1,337,2019-04-13T14:00:00Z,False,19,15,0,0,47,27,20,33,18,15,14,2
Vinagre,430,1,349,2019-04-20T14:00:00Z,True,19,2,23,1,47,27,20,33,22,11,14,16
Vinagre,430,1,309,2019-04-24T18:45:00Z,True,19,0,0,0,48,28,20,66,44,22,-18,6
Vinagre,430,1,359,2019-04-27T14:00:00Z,False,19,17,0,0,51,31,20,50,27,23,1,-7
Vinagre,430,1,369,2019-05-04T14:00:00Z,True,19,8,1,1,54,31,23,26,21,5,28,26
Vinagre,430,1,375,2019-05-12T14:00:00Z,False,19,11,6,1,57,34,23,94,50,44,-37,-27
Jota,431,2,9,2018-08-11T16:30:00Z,True,19,7,90,5,0,0,0,0,0,0,0,0
Jota,431,2,16,2018-08-18T14:00:00Z,False,19,10,45,1,1,1,0,0,0,0,1,0
Jota,431,2,29,2018-08-25T11:30:00Z,True,19,12,90,2,1,1,0,6,3,3,-5,-2
Jota,431,2,39,2018-09-01T14:00:00Z,False,19,18,61,3,2,2,0,0,0,0,2,0
Jota,431,2,49,2018-09-16T12:30:00Z,True,19,3,87,2,5,2,3,1,0,1,4,1
Jota,431,2,58,2018-09-22T14:00:00Z,False,19,13,86,2,8,5,3,9,3,6,-1,0
Jota,431,2,69,2018-09-29T14:00:00Z,True,19,15,76,2,9,5,4,5,2,3,4,2
Jota,431,2,72,2018-10-06T14:00:00Z,False,19,6,86,3,12,8,4,7,1,6,5,3
Jota,431,2,89,2018-10-20T14:00:00Z,True,19,17,90,1,15,8,7,13,9,4,2,4
Jota,431,2,90,2018-10-27T14:00:00Z,False,19,2,29,1,15,8,7,11,7,4,4,0
Jota,431,2,109,2018-11-03T19:45:00Z,True,19,16,0,0,15,8,7,21,6,15,-6,-7
Jota,431,2,110,2018-11-11T16:30:00Z,False,19,0,29,1,15,8,7,23,13,10,-8,-6
Jota,431,2,129,2018-11-25T16:00:00Z,True,19,9,15,1,16,8,8,7,5,2,9,6
Jota,431,2,131,2018-11-30T20:00:00Z,False,19,4,24,1,16,8,8,8,7,1,8,1
Jota,431,2,147,2018-12-05T19:45:00Z,True,19,5,87,8,16,8,8,31,18,13,-15,-5
Jota,431,2,158,2018-12-09T16:00:00Z,False,19,14,90,11,19,11,8,13,6,7,6,2
Jota,431,2,169,2018-12-15T15:00:00Z,True,19,1,45,4,22,11,11,23,14,9,-1,2
Jota,431,2,179,2018-12-21T20:00:00Z,True,19,11,0,0,25,14,11,45,22,23,-20,-9
Jota,431,2,183,2018-12-26T12:30:00Z,False,19,8,0,0,25,14,11,10,8,2,15,3
Jota,431,2,198,2018-12-29T15:00:00Z,False,19,16,0,0,26,14,12,45,18,27,-19,-6
Jota,431,2,209,2019-01-02T19:45:00Z,True,19,6,0,0,29,14,15,19,9,10,10,4
Jota,431,2,217,2019-01-14T20:00:00Z,False,19,12,58,1,29,14,15,50,30,20,-21,-15
Jota,431,2,229,2019-01-19T12:30:00Z,True,19,10,90,19,29,14,15,31,14,17,-2,-3
Jota,431,2,235,2019-01-29T19:45:00Z,True,19,18,88,6,32,17,15,31,17,14,1,3
Jota,431,2,245,2019-02-02T15:00:00Z,False,19,7,76,5,35,20,15,33,21,12,2,-6
Jota,431,2,259,2019-02-11T20:00:00Z,True,19,14,68,1,38,20,18,24,13,11,14,9
Jota,431,2,261,2019-02-23T15:00:00Z,False,19,1,65,1,39,21,18,33,24,9,6,-6
Jota,431,2,273,2019-02-26T19:45:00Z,False,19,9,65,3,40,21,19,11,5,6,29,14
Jota,431,2,289,2019-03-02T15:00:00Z,True,19,4,46,11,40,21,19,25,17,8,15,13
Jota,431,2,292,2019-03-10T14:05:00Z,False,19,5,81,6,43,24,19,56,31,25,-13,-12
Jota,431,2,312,2019-03-30T15:00:00Z,False,19,3,90,2,44,24,20,30,17,13,14,3
Jota,431,2,329,2019-04-02T18:45:00Z,True,19,13,72,8,44,24,20,61,32,29,-17,-5
Jota,431,2,337,2019-04-13T14:00:00Z,False,19,15,86,2,47,27,20,33,18,15,14,2
Jota,431,2,349,2019-04-20T14:00:00Z,True,19,2,90,3,47,27,20,33,22,11,14,16
Jota,431,2,309,2019-04-24T18:45:00Z,True,19,0,77,8,48,28,20,66,44,22,-18,6
Jota,431,2,359,2019-04-27T14:00:00Z,False,19,17,90,12,51,31,20,50,27,23,1,-7
Jota,431,2,369,2019-05-04T14:00:00Z,True,19,8,90,2,54,31,23,26,21,5,28,26
Jota,431,2,375,2019-05-12T14:00:00Z,False,19,11,90,1,57,34,23,94,50,44,-37,-27
Neves,432,2,9,2018-08-11T16:30:00Z,True,19,7,90,12,0,0,0,0,0,0,0,0
Neves,432,2,16,2018-08-18T14:00:00Z,False,19,10,90,2,1,1,0,0,0,0,1,0
Neves,432,2,29,2018-08-25T11:30:00Z,True,19,12,90,2,1,1,0,6,3,3,-5,-2
Neves,432,2,39,2018-09-01T14:00:00Z,False,19,18,90,3,2,2,0,0,0,0,2,0
Neves,432,2,49,2018-09-16T12:30:00Z,True,19,3,90,2,5,2,3,1,0,1,4,1
Neves,432,2,58,2018-09-22T14:00:00Z,False,19,13,90,1,8,5,3,9,3,6,-1,0
Neves,432,2,69,2018-09-29T14:00:00Z,True,19,15,90,3,9,5,4,5,2,3,4,2
Neves,432,2,72,2018-10-06T14:00:00Z,False,19,6,90,3,12,8,4,7,1,6,5,3
Neves,432,2,89,2018-10-20T14:00:00Z,True,19,17,90,1,15,8,7,13,9,4,2,4
Neves,432,2,90,2018-10-27T14:00:00Z,False,19,2,90,2,15,8,7,11,7,4,4,0
Neves,432,2,109,2018-11-03T19:45:00Z,True,19,16,90,7,15,8,7,21,6,15,-6,-7
Neves,432,2,110,2018-11-11T16:30:00Z,False,19,0,90,2,15,8,7,23,13,10,-8,-6
Neves,432,2,129,2018-11-25T16:00:00Z,True,19,9,90,1,16,8,8,7,5,2,9,6
Neves,432,2,131,2018-11-30T20:00:00Z,False,19,4,90,1,16,8,8,8,7,1,8,1
Neves,432,2,147,2018-12-05T19:45:00Z,True,19,5,0,0,16,8,8,31,18,13,-15,-5
Neves,432,2,158,2018-12-09T16:00:00Z,False,19,14,90,3,19,11,8,13,6,7,6,2
Neves,432,2,169,2018-12-15T15:00:00Z,True,19,1,90,3,22,11,11,23,14,9,-1,2
Neves,432,2,179,2018-12-21T20:00:00Z,True,19,11,90,2,25,14,11,45,22,23,-20,-9
Neves,432,2,183,2018-12-26T12:30:00Z,False,19,8,0,0,25,14,11,10,8,2,15,3
Neves,432,2,198,2018-12-29T15:00:00Z,False,19,16,90,2,26,14,12,45,18,27,-19,-6
Neves,432,2,209,2019-01-02T19:45:00Z,True,19,6,17,1,29,14,15,19,9,10,10,4
Neves,432,2,217,2019-01-14T20:00:00Z,False,19,12,90,2,29,14,15,50,30,20,-21,-15
Neves,432,2,229,2019-01-19T12:30:00Z,True,19,10,90,6,29,14,15,31,14,17,-2,-3
Neves,432,2,235,2019-01-29T19:45:00Z,True,19,18,90,2,32,17,15,31,17,14,1,3
Neves,432,2,245,2019-02-02T15:00:00Z,False,19,7,48,6,35,20,15,33,21,12,2,-6
Neves,432,2,259,2019-02-11T20:00:00Z,True,19,14,90,2,38,20,18,24,13,11,14,9
Neves,432,2,261,2019-02-23T15:00:00Z,False,19,1,90,1,39,21,18,33,24,9,6,-6
Neves,432,2,273,2019-02-26T19:45:00Z,False,19,9,90,2,40,21,19,11,5,6,29,14
Neves,432,2,289,2019-03-02T15:00:00Z,True,19,4,0,0,40,21,19,25,17,8,15,13
Neves,432,2,292,2019-03-10T14:05:00Z,False,19,5,90,2,43,24,19,56,31,25,-13,-12
Neves,432,2,312,2019-03-30T15:00:00Z,False,19,3,90,1,44,24,20,30,17,13,14,3
Neves,432,2,329,2019-04-02T18:45:00Z,True,19,13,83,2,44,24,20,61,32,29,-17,-5
Neves,432,2,337,2019-04-13T14:00:00Z,False,19,15,68,2,47,27,20,33,18,15,14,2
Neves,432,2,349,2019-04-20T14:00:00Z,True,19,2,90,3,47,27,20,33,22,11,14,16
Neves,432,2,309,2019-04-24T18:45:00Z,True,19,0,90,9,48,28,20,66,44,22,-18,6
Neves,432,2,359,2019-04-27T14:00:00Z,False,19,17,90,6,51,31,20,50,27,23,1,-7
Neves,432,2,369,2019-05-04T14:00:00Z,True,19,8,90,3,54,31,23,26,21,5,28,26
Neves,432,2,375,2019-05-12T14:00:00Z,False,19,11,90,2,57,34,23,94,50,44,-37,-27
Cavaleiro,433,2,9,2018-08-11T16:30:00Z,True,19,7,0,0,0,0,0,0,0,0,0,0
Cavaleiro,433,2,16,2018-08-18T14:00:00Z,False,19,10,0,0,1,1,0,0,0,0,1,0
Cavaleiro,433,2,29,2018-08-25T11:30:00Z,True,19,12,0,0,1,1,0,6,3,3,-5,-2
Cavaleiro,433,2,39,2018-09-01T14:00:00Z,False,19,18,0,0,2,2,0,0,0,0,2,0
Cavaleiro,433,2,49,2018-09-16T12:30:00Z,True,19,3,0,0,5,2,3,1,0,1,4,1
Cavaleiro,433,2,58,2018-09-22T14:00:00Z,False,19,13,0,0,8,5,3,9,3,6,-1,0
Cavaleiro,433,2,69,2018-09-29T14:00:00Z,True,19,15,13,6,9,5,4,5,2,3,4,2
Cavaleiro,433,2,72,2018-10-06T14:00:00Z,False,19,6,14,0,12,8,4,7,1,6,5,3
Cavaleiro,433,2,89,2018-10-20T14:00:00Z,True,19,17,30,1,15,8,7,13,9,4,2,4
Cavaleiro,433,2,90,2018-10-27T14:00:00Z,False,19,2,29,1,15,8,7,11,7,4,4,0
Cavaleiro,433,2,109,2018-11-03T19:45:00Z,True,19,16,61,2,15,8,7,21,6,15,-6,-7
Cavaleiro,433,2,110,2018-11-11T16:30:00Z,False,19,0,60,11,15,8,7,23,13,10,-8,-6
Cavaleiro,433,2,129,2018-11-25T16:00:00Z,True,19,9,45,1,16,8,8,7,5,2,9,6
Cavaleiro,433,2,131,2018-11-30T20:00:00Z,False,19,4,8,1,16,8,8,8,7,1,8,1
Cavaleiro,433,2,147,2018-12-05T19:45:00Z,True,19,5,2,1,16,8,8,31,18,13,-15,-5
Cavaleiro,433,2,158,2018-12-09T16:00:00Z,False,19,14,0,0,19,11,8,13,6,7,6,2
Cavaleiro,433,2,169,2018-12-15T15:00:00Z,True,19,1,1,6,22,11,11,23,14,9,-1,2
Cavaleiro,433,2,179,2018-12-21T20:00:00Z,True,19,11,27,1,25,14,11,45,22,23,-20,-9
Cavaleiro,433,2,183,2018-12-26T12:30:00Z,False,19,8,45,1,25,14,11,10,8,2,15,3
Cavaleiro,433,2,198,2018-12-29T15:00:00Z,False,19,16,84,5,26,14,12,45,18,27,-19,-6
Cavaleiro,433,2,209,2019-01-02T19:45:00Z,True,19,6,83,2,29,14,15,19,9,10,10,4
Cavaleiro,433,2,217,2019-01-14T20:00:00Z,False,19,12,0,0,29,14,15,50,30,20,-21,-15
Cavaleiro,433,2,229,2019-01-19T12:30:00Z,True,19,10,0,0,29,14,15,31,14,17,-2,-3
Cavaleiro,433,2,235,2019-01-29T19:45:00Z,True,19,18,1,1,32,17,15,31,17,14,1,3
Cavaleiro,433,2,245,2019-02-02T15:00:00Z,False,19,7,0,0,35,20,15,33,21,12,2,-6
Cavaleiro,433,2,259,2019-02-11T20:00:00Z,True,19,14,21,1,38,20,18,24,13,11,14,9
Cavaleiro,433,2,261,2019-02-23T15:00:00Z,False,19,1,24,1,39,21,18,33,24,9,6,-6
Cavaleiro,433,2,273,2019-02-26T19:45:00Z,False,19,9,24,1,40,21,19,11,5,6,29,14
Cavaleiro,433,2,289,2019-03-02T15:00:00Z,True,19,4,15,1,40,21,19,25,17,8,15,13
Cavaleiro,433,2,292,2019-03-10T14:05:00Z,False,19,5,0,0,43,24,19,56,31,25,-13,-12
Cavaleiro,433,2,312,2019-03-30T15:00:00Z,False,19,3,58,1,44,24,20,30,17,13,14,3
Cavaleiro,433,2,329,2019-04-02T18:45:00Z,True,19,13,17,1,44,24,20,61,32,29,-17,-5
Cavaleiro,433,2,337,2019-04-13T14:00:00Z,False,19,15,0,0,47,27,20,33,18,15,14,2
Cavaleiro,433,2,349,2019-04-20T14:00:00Z,True,19,2,0,0,47,27,20,33,22,11,14,16
Cavaleiro,433,2,309,2019-04-24T18:45:00Z,True,19,0,12,1,48,28,20,66,44,22,-18,6
Cavaleiro,433,2,359,2019-04-27T14:00:00Z,False,19,17,3,1,51,31,20,50,27,23,1,-7
Cavaleiro,433,2,369,2019-05-04T14:00:00Z,True,19,8,0,0,54,31,23,26,21,5,28,26
Cavaleiro,433,2,375,2019-05-12T14:00:00Z,False,19,11,0,0,57,34,23,94,50,44,-37,-27
Costa,434,2,9,2018-08-11T16:30:00Z,True,19,7,70,2,0,0,0,0,0,0,0,0
Costa,434,2,16,2018-08-18T14:00:00Z,False,19,10,45,1,1,1,0,0,0,0,1,0
Costa,434,2,29,2018-08-25T11:30:00Z,True,19,12,71,2,1,1,0,6,3,3,-5,-2
Costa,434,2,39,2018-09-01T14:00:00Z,False,19,18,71,3,2,2,0,0,0,0,2,0
Costa,434,2,49,2018-09-16T12:30:00Z,True,19,3,65,3,5,2,3,1,0,1,4,1
Costa,434,2,58,2018-09-22T14:00:00Z,False,19,13,74,2,8,5,3,9,3,6,-1,0
Costa,434,2,69,2018-09-29T14:00:00Z,True,19,15,52,1,9,5,4,5,2,3,4,2
Costa,434,2,72,2018-10-06T14:00:00Z,False,19,6,83,3,12,8,4,7,1,6,5,3
Costa,434,2,89,2018-10-20T14:00:00Z,True,19,17,90,2,15,8,7,13,9,4,2,4
Costa,434,2,90,2018-10-27T14:00:00Z,False,19,2,90,2,15,8,7,11,7,4,4,0
Costa,434,2,109,2018-11-03T19:45:00Z,True,19,16,83,2,15,8,7,21,6,15,-6,-7
Costa,434,2,110,2018-11-11T16:30:00Z,False,19,0,74,2,15,8,7,23,13,10,-8,-6
Costa,434,2,129,2018-11-25T16:00:00Z,True,19,9,74,2,16,8,8,7,5,2,9,6
Costa,434,2,131,2018-11-30T20:00:00Z,False,19,4,65,2,16,8,8,8,7,1,8,1
Costa,434,2,147,2018-12-05T19:45:00Z,True,19,5,18,1,16,8,8,31,18,13,-15,-5
Costa,434,2,158,2018-12-09T16:00:00Z,False,19,14,75,4,19,11,8,13,6,7,6,2
Costa,434,2,169,2018-12-15T15:00:00Z,True,19,1,45,3,22,11,11,23,14,9,-1,2
Costa,434,2,179,2018-12-21T20:00:00Z,True,19,11,0,0,25,14,11,45,22,23,-20,-9
Costa,434,2,183,2018-12-26T12:30:00Z,False,19,8,27,1,25,14,11,10,8,2,15,3
Costa,434,2,198,2018-12-29T15:00:00Z,False,19,16,31,6,26,14,12,45,18,27,-19,-6
Costa,434,2,209,2019-01-02T19:45:00Z,True,19,6,63,3,29,14,15,19,9,10,10,4
Costa,434,2,217,2019-01-14T20:00:00Z,False,19,12,0,0,29,14,15,50,30,20,-21,-15
Costa,434,2,229,2019-01-19T12:30:00Z,True,19,10,0,0,29,14,15,31,14,17,-2,-3
Costa,434,2,235,2019-01-29T19:45:00Z,True,19,18,0,0,32,17,15,31,17,14,1,3
Costa,434,2,245,2019-02-02T15:00:00Z,False,19,7,13,1,35,20,15,33,21,12,2,-6
Costa,434,2,259,2019-02-11T20:00:00Z,True,19,14,21,1,38,20,18,24,13,11,14,9
Costa,434,2,261,2019-02-23T15:00:00Z,False,19,1,0,0,39,21,18,33,24,9,6,-6
Costa,434,2,273,2019-02-26T19:45:00Z,False,19,9,12,1,40,21,19,11,5,6,29,14
Costa,434,2,289,2019-03-02T15:00:00Z,True,19,4,0,0,40,21,19,25,17,8,15,13
Costa,434,2,292,2019-03-10T14:05:00Z,False,19,5,0,0,43,24,19,56,31,25,-13,-12
Costa,434,2,312,2019-03-30T15:00:00Z,False,19,3,18,1,44,24,20,30,17,13,14,3
Costa,434,2,329,2019-04-02T18:45:00Z,True,19,13,0,0,44,24,20,61,32,29,-17,-5
Costa,434,2,337,2019-04-13T14:00:00Z,False,19,15,3,1,47,27,20,33,18,15,14,2
Costa,434,2,349,2019-04-20T14:00:00Z,True,19,2,0,0,47,27,20,33,22,11,14,16
Costa,434,2,309,2019-04-24T18:45:00Z,True,19,0,0,0,48,28,20,66,44,22,-18,6
Costa,434,2,359,2019-04-27T14:00:00Z,False,19,17,0,0,51,31,20,50,27,23,1,-7
Costa,434,2,369,2019-05-04T14:00:00Z,True,19,8,0,0,54,31,23,26,21,5,28,26
Costa,434,2,375,2019-05-12T14:00:00Z,False,19,11,0,0,57,34,23,94,50,44,-37,-27
Enobakhare,435,2,9,2018-08-11T16:30:00Z,True,19,7,0,0,0,0,0,0,0,0,0,0
Enobakhare,435,2,16,2018-08-18T14:00:00Z,False,19,10,0,0,1,1,0,0,0,0,1,0
Enobakhare,435,2,29,2018-08-25T11:30:00Z,True,19,12,0,0,1,1,0,6,3,3,-5,-2
Enobakhare,435,2,39,2018-09-01T14:00:00Z,False,19,18,0,0,2,2,0,0,0,0,2,0
Enobakhare,435,2,49,2018-09-16T12:30:00Z,True,19,3,0,0,5,2,3,1,0,1,4,1
Enobakhare,435,2,58,2018-09-22T14:00:00Z,False,19,13,0,0,8,5,3,9,3,6,-1,0
Enobakhare,435,2,69,2018-09-29T14:00:00Z,True,19,15,0,0,9,5,4,5,2,3,4,2
Enobakhare,435,2,72,2018-10-06T14:00:00Z,False,19,6,0,0,12,8,4,7,1,6,5,3
Enobakhare,435,2,89,2018-10-20T14:00:00Z,True,19,17,0,0,15,8,7,13,9,4,2,4
Enobakhare,435,2,90,2018-10-27T14:00:00Z,False,19,2,0,0,15,8,7,11,7,4,4,0
Enobakhare,435,2,109,2018-11-03T19:45:00Z,True,19,16,0,0,15,8,7,21,6,15,-6,-7
Enobakhare,435,2,110,2018-11-11T16:30:00Z,False,19,0,0,0,15,8,7,23,13,10,-8,-6
Enobakhare,435,2,129,2018-11-25T16:00:00Z,True,19,9,0,0,16,8,8,7,5,2,9,6
Enobakhare,435,2,131,2018-11-30T20:00:00Z,False,19,4,0,0,16,8,8,8,7,1,8,1
Enobakhare,435,2,147,2018-12-05T19:45:00Z,True,19,5,0,0,16,8,8,31,18,13,-15,-5
Enobakhare,435,2,158,2018-12-09T16:00:00Z,False,19,14,0,0,19,11,8,13,6,7,6,2
Enobakhare,435,2,169,2018-12-15T15:00:00Z,True,19,1,0,0,22,11,11,23,14,9,-1,2
Enobakhare,435,2,179,2018-12-21T20:00:00Z,True,19,11,0,0,25,14,11,45,22,23,-20,-9
Enobakhare,435,2,183,2018-12-26T12:30:00Z,False,19,8,0,0,25,14,11,10,8,2,15,3
Enobakhare,435,2,198,2018-12-29T15:00:00Z,False,19,16,0,0,26,14,12,45,18,27,-19,-6
Enobakhare,435,2,209,2019-01-02T19:45:00Z,True,19,6,0,0,29,14,15,19,9,10,10,4
Enobakhare,435,2,217,2019-01-14T20:00:00Z,False,19,12,0,0,29,14,15,50,30,20,-21,-15
Enobakhare,435,2,229,2019-01-19T12:30:00Z,True,19,10,0,0,29,14,15,31,14,17,-2,-3
Enobakhare,435,2,235,2019-01-29T19:45:00Z,True,19,18,0,0,32,17,15,31,17,14,1,3
Enobakhare,435,2,245,2019-02-02T15:00:00Z,False,19,7,0,0,35,20,15,33,21,12,2,-6
Enobakhare,435,2,259,2019-02-11T20:00:00Z,True,19,14,0,0,38,20,18,24,13,11,14,9
Enobakhare,435,2,261,2019-02-23T15:00:00Z,False,19,1,0,0,39,21,18,33,24,9,6,-6
Enobakhare,435,2,273,2019-02-26T19:45:00Z,False,19,9,0,0,40,21,19,11,5,6,29,14
Enobakhare,435,2,289,2019-03-02T15:00:00Z,True,19,4,0,0,40,21,19,25,17,8,15,13
Enobakhare,435,2,292,2019-03-10T14:05:00Z,False,19,5,0,0,43,24,19,56,31,25,-13,-12
Enobakhare,435,2,312,2019-03-30T15:00:00Z,False,19,3,0,0,44,24,20,30,17,13,14,3
Enobakhare,435,2,329,2019-04-02T18:45:00Z,True,19,13,0,0,44,24,20,61,32,29,-17,-5
Enobakhare,435,2,337,2019-04-13T14:00:00Z,False,19,15,0,0,47,27,20,33,18,15,14,2
Enobakhare,435,2,349,2019-04-20T14:00:00Z,True,19,2,0,0,47,27,20,33,22,11,14,16
Enobakhare,435,2,309,2019-04-24T18:45:00Z,True,19,0,0,0,48,28,20,66,44,22,-18,6
Enobakhare,435,2,359,2019-04-27T14:00:00Z,False,19,17,0,0,51,31,20,50,27,23,1,-7
Enobakhare,435,2,369,2019-05-04T14:00:00Z,True,19,8,0,0,54,31,23,26,21,5,28,26
Enobakhare,435,2,375,2019-05-12T14:00:00Z,False,19,11,0,0,57,34,23,94,50,44,-37,-27
Jimenez,436,3,9,2018-08-11T16:30:00Z,True,19,7,90,6,0,0,0,0,0,0,0,0
Jimenez,436,3,16,2018-08-18T14:00:00Z,False,19,10,90,2,1,1,0,0,0,0,1,0
Jimenez,436,3,29,2018-08-25T11:30:00Z,True,19,12,90,2,1,1,0,6,3,3,-5,-2
Jimenez,436,3,39,2018-09-01T14:00:00Z,False,19,18,86,2,2,2,0,0,0,0,2,0
Jimenez,436,3,49,2018-09-16T12:30:00Z,True,19,3,75,8,5,2,3,1,0,1,4,1
Jimenez,436,3,58,2018-09-22T14:00:00Z,False,19,13,90,5,8,5,3,9,3,6,-1,0
Jimenez,436,3,69,2018-09-29T14:00:00Z,True,19,15,90,5,9,5,4,5,2,3,4,2
Jimenez,436,3,72,2018-10-06T14:00:00Z,False,19,6,75,5,12,8,4,7,1,6,5,3
Jimenez,436,3,89,2018-10-20T14:00:00Z,True,19,17,59,1,15,8,7,13,9,4,2,4
Jimenez,436,3,90,2018-10-27T14:00:00Z,False,19,2,60,2,15,8,7,11,7,4,4,0
Jimenez,436,3,109,2018-11-03T19:45:00Z,True,19,16,90,12,15,8,7,21,6,15,-6,-7
Jimenez,436,3,110,2018-11-11T16:30:00Z,False,19,0,84,6,15,8,7,23,13,10,-8,-6
Jimenez,436,3,129,2018-11-25T16:00:00Z,True,19,9,90,2,16,8,8,7,5,2,9,6
Jimenez,436,3,131,2018-11-30T20:00:00Z,False,19,4,90,5,16,8,8,8,7,1,8,1
Jimenez,436,3,147,2018-12-05T19:45:00Z,True,19,5,81,8,16,8,8,31,18,13,-15,-5
Jimenez,436,3,158,2018-12-09T16:00:00Z,False,19,14,30,1,19,11,8,13,6,7,6,2
Jimenez,436,3,169,2018-12-15T15:00:00Z,True,19,1,88,9,22,11,11,23,14,9,-1,2
Jimenez,436,3,179,2018-12-21T20:00:00Z,True,19,11,90,2,25,14,11,45,22,23,-20,-9
Jimenez,436,3,183,2018-12-26T12:30:00Z,False,19,8,90,2,25,14,11,10,8,2,15,3
Jimenez,436,3,198,2018-12-29T15:00:00Z,False,19,16,90,8,26,14,12,45,18,27,-19,-6
Jimenez,436,3,209,2019-01-02T19:45:00Z,True,19,6,90,2,29,14,15,19,9,10,10,4
Jimenez,436,3,217,2019-01-14T20:00:00Z,False,19,12,45,1,29,14,15,50,30,20,-21,-15
Jimenez,436,3,229,2019-01-19T12:30:00Z,True,19,10,90,5,29,14,15,31,14,17,-2,-3
Jimenez,436,3,235,2019-01-29T19:45:00Z,True,19,18,90,12,32,17,15,31,17,14,1,3
Jimenez,436,3,245,2019-02-02T15:00:00Z,False,19,7,88,9,35,20,15,33,21,12,2,-6
Jimenez,436,3,259,2019-02-11T20:00:00Z,True,19,14,90,2,38,20,18,24,13,11,14,9
Jimenez,436,3,261,2019-02-23T15:00:00Z,False,19,1,87,7,39,21,18,33,24,9,6,-6
Jimenez,436,3,273,2019-02-26T19:45:00Z,False,19,9,78,2,40,21,19,11,5,6,29,14
Jimenez,436,3,289,2019-03-02T15:00:00Z,True,19,4,90,12,40,21,19,25,17,8,15,13
Jimenez,436,3,292,2019-03-10T14:05:00Z,False,19,5,88,8,43,24,19,56,31,25,-13,-12
Jimenez,436,3,312,2019-03-30T15:00:00Z,False,19,3,31,1,44,24,20,30,17,13,14,3
Jimenez,436,3,329,2019-04-02T18:45:00Z,True,19,13,90,11,44,24,20,61,32,29,-17,-5
Jimenez,436,3,337,2019-04-13T14:00:00Z,False,19,15,90,1,47,27,20,33,18,15,14,2
Jimenez,436,3,349,2019-04-20T14:00:00Z,True,19,2,90,2,47,27,20,33,22,11,14,16
Jimenez,436,3,309,2019-04-24T18:45:00Z,True,19,0,81,2,48,28,20,66,44,22,-18,6
Jimenez,436,3,359,2019-04-27T14:00:00Z,False,19,17,86,7,51,31,20,50,27,23,1,-7
Jimenez,436,3,369,2019-05-04T14:00:00Z,True,19,8,90,2,54,31,23,26,21,5,28,26
Jimenez,436,3,375,2019-05-12T14:00:00Z,False,19,11,90,2,57,34,23,94,50,44,-37,-27
Bonatini,437,3,9,2018-08-11T16:30:00Z,True,19,7,19,1,0,0,0,0,0,0,0,0
Bonatini,437,3,16,2018-08-18T14:00:00Z,False,19,10,45,1,1,1,0,0,0,0,1,0
Bonatini,437,3,29,2018-08-25T11:30:00Z,True,19,12,0,0,1,1,0,6,3,3,-5,-2
Bonatini,437,3,39,2018-09-01T14:00:00Z,False,19,18,18,4,2,2,0,0,0,0,2,0
Bonatini,437,3,49,2018-09-16T12:30:00Z,True,19,3,14,1,5,2,3,1,0,1,4,1
Bonatini,437,3,58,2018-09-22T14:00:00Z,False,19,13,0,0,8,5,3,9,3,6,-1,0
Bonatini,437,3,69,2018-09-29T14:00:00Z,True,19,15,1,1,9,5,4,5,2,3,4,2
Bonatini,437,3,72,2018-10-06T14:00:00Z,False,19,6,0,0,12,8,4,7,1,6,5,3
Bonatini,437,3,89,2018-10-20T14:00:00Z,True,19,17,0,0,15,8,7,13,9,4,2,4
Bonatini,437,3,90,2018-10-27T14:00:00Z,False,19,2,5,1,15,8,7,11,7,4,4,0
Bonatini,437,3,109,2018-11-03T19:45:00Z,True,19,16,28,1,15,8,7,21,6,15,-6,-7
Bonatini,437,3,110,2018-11-11T16:30:00Z,False,19,0,0,0,15,8,7,23,13,10,-8,-6
Bonatini,437,3,129,2018-11-25T16:00:00Z,True,19,9,0,0,16,8,8,7,5,2,9,6
Bonatini,437,3,131,2018-11-30T20:00:00Z,False,19,4,0,0,16,8,8,8,7,1,8,1
Bonatini,437,3,147,2018-12-05T19:45:00Z,True,19,5,0,0,16,8,8,31,18,13,-15,-5
Bonatini,437,3,158,2018-12-09T16:00:00Z,False,19,14,0,0,19,11,8,13,6,7,6,2
Bonatini,437,3,169,2018-12-15T15:00:00Z,True,19,1,0,0,22,11,11,23,14,9,-1,2
Bonatini,437,3,179,2018-12-21T20:00:00Z,True,19,11,0,0,25,14,11,45,22,23,-20,-9
Bonatini,437,3,183,2018-12-26T12:30:00Z,False,19,8,0,0,25,14,11,10,8,2,15,3
Bonatini,437,3,198,2018-12-29T15:00:00Z,False,19,16,0,0,26,14,12,45,18,27,-19,-6
Bonatini,437,3,209,2019-01-02T19:45:00Z,True,19,6,0,0,29,14,15,19,9,10,10,4
Bonatini,437,3,217,2019-01-14T20:00:00Z,False,19,12,0,0,29,14,15,50,30,20,-21,-15
Bonatini,437,3,229,2019-01-19T12:30:00Z,True,19,10,0,0,29,14,15,31,14,17,-2,-3
Bonatini,437,3,235,2019-01-29T19:45:00Z,True,19,18,0,0,32,17,15,31,17,14,1,3
Bonatini,437,3,245,2019-02-02T15:00:00Z,False,19,7,0,0,35,20,15,33,21,12,2,-6
Bonatini,437,3,259,2019-02-11T20:00:00Z,True,19,14,0,0,38,20,18,24,13,11,14,9
Bonatini,437,3,261,2019-02-23T15:00:00Z,False,19,1,0,0,39,21,18,33,24,9,6,-6
Bonatini,437,3,273,2019-02-26T19:45:00Z,False,19,9,0,0,40,21,19,11,5,6,29,14
Bonatini,437,3,289,2019-03-02T15:00:00Z,True,19,4,0,0,40,21,19,25,17,8,15,13
Bonatini,437,3,292,2019-03-10T14:05:00Z,False,19,5,0,0,43,24,19,56,31,25,-13,-12
Bonatini,437,3,312,2019-03-30T15:00:00Z,False,19,3,0,0,44,24,20,30,17,13,14,3
Bonatini,437,3,329,2019-04-02T18:45:00Z,True,19,13,0,0,44,24,20,61,32,29,-17,-5
Bonatini,437,3,337,2019-04-13T14:00:00Z,False,19,15,0,0,47,27,20,33,18,15,14,2
Bonatini,437,3,349,2019-04-20T14:00:00Z,True,19,2,0,0,47,27,20,33,22,11,14,16
Bonatini,437,3,309,2019-04-24T18:45:00Z,True,19,0,0,0,48,28,20,66,44,22,-18,6
Bonatini,437,3,359,2019-04-27T14:00:00Z,False,19,17,0,0,51,31,20,50,27,23,1,-7
Bonatini,437,3,369,2019-05-04T14:00:00Z,True,19,8,0,0,54,31,23,26,21,5,28,26
Bonatini,437,3,375,2019-05-12T14:00:00Z,False,19,11,0,0,57,34,23,94,50,44,-37,-27
Steele,438,0,8,2018-08-11T14:00:00Z,False,2,17,0,0,0,0,0,0,0,0,0,0
Steele,438,0,10,2018-08-19T15:00:00Z,True,2,13,0,0,0,0,0,3,3,0,-3,0
Steele,438,0,24,2018-08-25T16:30:00Z,False,2,11,0,0,3,3,0,6,3,3,-3,-3
Steele,438,0,30,2018-09-01T14:00:00Z,True,2,8,0,0,3,3,0,3,3,0,0,3
Steele,438,0,46,2018-09-17T19:00:00Z,False,2,15,0,0,4,4,0,4,1,3,0,-1
Steele,438,0,51,2018-09-22T16:30:00Z,True,2,16,0,0,5,4,1,9,3,6,-4,-2
Steele,438,0,66,2018-09-29T14:00:00Z,False,2,12,0,0,5,4,1,16,9,7,-11,-8
Steele,438,0,70,2018-10-05T19:00:00Z,True,2,18,0,0,5,4,1,7,4,3,-2,1
Steele,438,0,87,2018-10-20T14:00:00Z,False,2,14,0,0,8,7,1,2,0,2,6,1
Steele,438,0,90,2018-10-27T14:00:00Z,True,2,19,0,0,11,7,4,15,8,7,-4,0
Steele,438,0,104,2018-11-03T15:00:00Z,False,2,7,0,0,14,10,4,15,10,5,-1,-6
Steele,438,0,111,2018-11-10T12:30:00Z,False,2,4,0,0,14,10,4,5,4,1,9,0
Steele,438,0,121,2018-11-24T15:00:00Z,True,2,10,0,0,14,10,4,17,8,9,-3,1
Steele,438,0,134,2018-12-01T15:00:00Z,False,2,9,0,0,15,11,4,10,5,5,5,-1
Steele,438,0,141,2018-12-04T19:45:00Z,True,2,6,0,0,18,11,7,12,5,7,6,4
Steele,438,0,152,2018-12-08T15:00:00Z,False,2,3,0,0,21,14,7,9,4,5,12,3
Steele,438,0,160,2018-12-16T13:30:00Z,True,2,5,0,0,21,14,7,34,21,13,-13,1
Steele,438,0,171,2018-12-22T15:00:00Z,False,2,1,0,0,21,14,7,23,14,9,-2,-7
Steele,438,0,180,2018-12-26T17:15:00Z,True,2,0,0,0,21,14,7,37,23,14,-16,0
Steele,438,0,190,2018-12-29T15:00:00Z,True,2,7,0,0,22,15,7,27,18,9,-5,6
Steele,438,0,208,2019-01-02T19:45:00Z,False,2,18,0,0,25,18,7,27,13,14,-2,-6
Steele,438,0,210,2019-01-12T15:00:00Z,True,2,11,0,0,26,18,8,54,28,26,-28,-8
Steele,438,0,225,2019-01-19T15:00:00Z,False,2,13,0,0,26,18,8,41,21,20,-15,-13
Steele,438,0,232,2019-01-29T19:45:00Z,False,2,8,0,0,26,18,8,14,12,2,12,-4
Steele,438,0,240,2019-02-02T15:00:00Z,True,2,17,0,0,26,18,8,33,17,16,-7,2
Steele,438,0,250,2019-02-09T17:30:00Z,True,2,3,0,0,27,19,8,24,14,10,3,9
Steele,438,0,274,2019-02-26T19:45:00Z,False,2,10,0,0,27,19,8,32,14,18,-5,-6
Steele,438,0,281,2019-03-02T15:00:00Z,True,2,9,0,0,27,19,8,14,8,6,13,13
Steele,438,0,293,2019-03-09T12:30:00Z,False,2,6,0,0,30,22,8,33,13,20,-3,-5
Steele,438,0,311,2019-03-30T15:00:00Z,True,2,15,0,0,33,22,11,30,18,12,3,10
Steele,438,0,264,2019-04-03T18:45:00Z,False,2,5,0,0,33,22,11,60,32,28,-27,-21
Steele,438,0,330,2019-04-13T14:00:00Z,True,2,1,0,0,33,22,11,38,26,12,-5,10
Steele,438,0,301,2019-04-16T18:45:00Z,True,2,4,0,0,33,22,11,28,20,8,5,14
Steele,438,0,349,2019-04-20T14:00:00Z,False,2,19,0,0,33,22,11,47,27,20,-14,-16
Steele,438,0,327,2019-04-23T18:45:00Z,False,2,16,0,0,34,22,12,67,34,33,-33,-22
Steele,438,0,350,2019-04-27T16:30:00Z,True,2,14,0,0,34,22,12,41,25,16,-7,6
Steele,438,0,360,2019-05-05T15:30:00Z,False,2,0,0,0,35,23,12,66,44,22,-31,-32
Steele,438,0,370,2019-05-12T14:00:00Z,True,2,12,0,0,36,23,13,95,54,41,-59,-18
Bernardo,439,1,8,2018-08-11T14:00:00Z,False,2,17,90,0,0,0,0,0,0,0,0,0
Bernardo,439,1,10,2018-08-19T15:00:00Z,True,2,13,0,0,0,0,0,3,3,0,-3,0
Bernardo,439,1,24,2018-08-25T16:30:00Z,False,2,11,0,0,3,3,0,6,3,3,-3,-3
Bernardo,439,1,30,2018-09-01T14:00:00Z,True,2,8,0,0,3,3,0,3,3,0,0,3
Bernardo,439,1,46,2018-09-17T19:00:00Z,False,2,15,0,0,4,4,0,4,1,3,0,-1
Bernardo,439,1,51,2018-09-22T16:30:00Z,True,2,16,0,0,5,4,1,9,3,6,-4,-2
Bernardo,439,1,66,2018-09-29T14:00:00Z,False,2,12,0,0,5,4,1,16,9,7,-11,-8
Bernardo,439,1,70,2018-10-05T19:00:00Z,True,2,18,0,0,5,4,1,7,4,3,-2,1
Bernardo,439,1,87,2018-10-20T14:00:00Z,False,2,14,22,1,8,7,1,2,0,2,6,1
Bernardo,439,1,90,2018-10-27T14:00:00Z,True,2,19,0,0,11,7,4,15,8,7,-4,0
Bernardo,439,1,104,2018-11-03T15:00:00Z,False,2,7,0,0,14,10,4,15,10,5,-1,-6
Bernardo,439,1,111,2018-11-10T12:30:00Z,False,2,4,0,0,14,10,4,5,4,1,9,0
Bernardo,439,1,121,2018-11-24T15:00:00Z,True,2,10,90,2,14,10,4,17,8,9,-3,1
Bernardo,439,1,134,2018-12-01T15:00:00Z,False,2,9,90,2,15,11,4,10,5,5,5,-1
Bernardo,439,1,141,2018-12-04T19:45:00Z,True,2,6,90,1,18,11,7,12,5,7,6,4
Bernardo,439,1,152,2018-12-08T15:00:00Z,False,2,3,90,2,21,14,7,9,4,5,12,3
Bernardo,439,1,160,2018-12-16T13:30:00Z,True,2,5,90,4,21,14,7,34,21,13,-13,1
Bernardo,439,1,171,2018-12-22T15:00:00Z,False,2,1,90,1,21,14,7,23,14,9,-2,-7
Bernardo,439,1,180,2018-12-26T17:15:00Z,True,2,0,90,2,21,14,7,37,23,14,-16,0
Bernardo,439,1,190,2018-12-29T15:00:00Z,True,2,7,90,6,22,15,7,27,18,9,-5,6
Bernardo,439,1,208,2019-01-02T19:45:00Z,False,2,18,72,1,25,18,7,27,13,14,-2,-6
Bernardo,439,1,210,2019-01-12T15:00:00Z,True,2,11,0,0,26,18,8,54,28,26,-28,-8
Bernardo,439,1,225,2019-01-19T15:00:00Z,False,2,13,0,0,26,18,8,41,21,20,-15,-13
Bernardo,439,1,232,2019-01-29T19:45:00Z,False,2,8,0,0,26,18,8,14,12,2,12,-4
Bernardo,439,1,240,2019-02-02T15:00:00Z,True,2,17,0,0,26,18,8,33,17,16,-7,2
Bernardo,439,1,250,2019-02-09T17:30:00Z,True,2,3,0,0,27,19,8,24,14,10,3,9
Bernardo,439,1,274,2019-02-26T19:45:00Z,False,2,10,0,0,27,19,8,32,14,18,-5,-6
Bernardo,439,1,281,2019-03-02T15:00:00Z,True,2,9,90,6,27,19,8,14,8,6,13,13
Bernardo,439,1,293,2019-03-09T12:30:00Z,False,2,6,90,1,30,22,8,33,13,20,-3,-5
Bernardo,439,1,311,2019-03-30T15:00:00Z,True,2,15,90,2,33,22,11,30,18,12,3,10
Bernardo,439,1,264,2019-04-03T18:45:00Z,False,2,5,15,1,33,22,11,60,32,28,-27,-21
Bernardo,439,1,330,2019-04-13T14:00:00Z,True,2,1,90,0,33,22,11,38,26,12,-5,10
Bernardo,439,1,301,2019-04-16T18:45:00Z,True,2,4,90,1,33,22,11,28,20,8,5,14
Bernardo,439,1,349,2019-04-20T14:00:00Z,False,2,19,20,1,33,22,11,47,27,20,-14,-16
Bernardo,439,1,327,2019-04-23T18:45:00Z,False,2,16,90,1,34,22,12,67,34,33,-33,-22
Bernardo,439,1,350,2019-04-27T16:30:00Z,True,2,14,90,2,34,22,12,41,25,16,-7,6
Bernardo,439,1,360,2019-05-05T15:30:00Z,False,2,0,90,2,35,23,12,66,44,22,-31,-32
Bernardo,439,1,370,2019-05-12T14:00:00Z,True,2,12,90,0,36,23,13,95,54,41,-59,-18
Ward,440,1,2,2018-08-11T14:00:00Z,False,6,8,0,0,0,0,0,0,0,0,0,0
Ward,440,1,14,2018-08-20T19:00:00Z,True,6,11,11,1,3,0,3,3,3,0,0,0
Ward,440,1,28,2018-08-26T12:30:00Z,False,6,17,90,1,3,0,3,6,3,3,-3,0
Ward,440,1,34,2018-09-01T14:00:00Z,True,6,15,0,0,3,0,3,1,1,0,2,0
Ward,440,1,43,2018-09-15T14:00:00Z,False,6,9,0,0,3,0,3,2,1,1,1,2
Ward,440,1,54,2018-09-22T14:00:00Z,True,6,14,0,0,6,0,6,1,0,1,5,-1
Ward,440,1,61,2018-10-01T19:00:00Z,False,6,1,0,0,7,1,6,10,7,3,-3,-1
Ward,440,1,72,2018-10-06T14:00:00Z,True,6,19,0,0,7,1,6,12,8,4,-5,-3
Ward,440,1,84,2018-10-21T15:00:00Z,False,6,7,0,0,7,1,6,12,7,5,-5,-1
Ward,440,1,92,2018-10-28T13:30:00Z,True,6,0,0,0,7,1,6,21,12,9,-14,-8
Ward,440,1,103,2018-11-04T16:00:00Z,False,6,5,0,0,8,2,6,24,11,13,-16,-5
Ward,440,1,113,2018-11-10T17:30:00Z,True,6,16,0,0,8,2,6,24,6,18,-16,-16
Ward,440,1,125,2018-11-24T15:00:00Z,False,6,13,0,0,8,2,6,20,10,10,-12,-4
Ward,440,1,133,2018-12-01T15:00:00Z,True,6,3,0,0,9,2,7,9,4,5,0,-3
Ward,440,1,141,2018-12-04T19:45:00Z,False,6,2,0,0,12,5,7,18,11,7,-6,-4
Ward,440,1,159,2018-12-08T15:00:00Z,False,6,18,0,0,12,5,7,18,10,8,-6,-3
Ward,440,1,161,2018-12-15T15:00:00Z,True,6,10,0,0,12,5,7,22,11,11,-10,-6
Ward,440,1,176,2018-12-22T15:00:00Z,False,6,12,0,0,15,8,7,44,27,17,-29,-20
Ward,440,1,182,2018-12-26T15:00:00Z,True,6,4,0,0,18,8,10,14,13,1,4,7
Ward,440,1,192,2018-12-30T12:00:00Z,True,6,5,0,0,19,9,10,40,21,19,-21,-10
Ward,440,1,209,2019-01-02T19:45:00Z,False,6,19,0,0,19,9,10,29,14,15,-10,-4
Ward,440,1,214,2019-01-12T15:00:00Z,True,6,17,0,0,22,9,13,29,16,13,-7,-4
Ward,440,1,224,2019-01-19T15:00:00Z,False,6,11,0,0,22,9,13,57,28,29,-35,-15
Ward,440,1,238,2019-01-30T19:45:00Z,False,6,15,0,0,22,9,13,22,11,11,0,2
Ward,440,1,244,2019-02-02T15:00:00Z,True,6,8,0,0,23,9,14,17,15,2,6,7
Ward,440,1,251,2019-02-09T15:00:00Z,True,6,18,0,0,26,12,14,32,18,14,-6,-2
Ward,440,1,266,2019-02-23T17:30:00Z,False,6,10,90,2,27,13,14,32,14,18,-5,0
Ward,440,1,272,2019-02-27T20:00:00Z,True,6,13,90,7,30,13,17,52,26,26,-22,-13
Ward,440,1,282,2019-03-02T15:00:00Z,False,6,3,0,0,30,13,17,30,17,13,0,0
Ward,440,1,293,2019-03-09T12:30:00Z,True,6,2,0,0,33,13,20,30,22,8,3,5
Ward,440,1,314,2019-03-30T15:00:00Z,True,6,9,0,0,33,13,20,14,8,6,19,7
Ward,440,1,306,2019-04-03T18:45:00Z,False,6,16,0,0,36,16,20,61,28,33,-25,-8
Ward,440,1,325,2019-04-06T14:00:00Z,False,6,14,0,0,36,16,20,35,22,13,1,-2
Ward,440,1,332,2019-04-14T13:05:00Z,True,6,12,0,0,39,16,23,80,48,32,-41,-16
Ward,440,1,340,2019-04-21T15:00:00Z,False,6,0,90,0,39,16,23,66,44,22,-27,-21
Ward,440,1,352,2019-04-27T14:00:00Z,True,6,7,0,0,42,16,26,49,31,18,-7,-2
Ward,440,1,362,2019-05-04T16:30:00Z,False,6,4,90,1,43,17,26,31,20,11,12,6
Ward,440,1,372,2019-05-12T14:00:00Z,True,6,1,90,1,46,17,29,45,29,16,1,1
Jach,441,1,2,2018-08-11T14:00:00Z,False,6,8,0,0,0,0,0,0,0,0,0,0
Jach,441,1,14,2018-08-20T19:00:00Z,True,6,11,0,0,3,0,3,3,3,0,0,0
Jach,441,1,28,2018-08-26T12:30:00Z,False,6,17,0,0,3,0,3,6,3,3,-3,0
Jach,441,1,34,2018-09-01T14:00:00Z,True,6,15,0,0,3,0,3,1,1,0,2,0
Jach,441,1,43,2018-09-15T14:00:00Z,False,6,9,0,0,3,0,3,2,1,1,1,2
Jach,441,1,54,2018-09-22T14:00:00Z,True,6,14,0,0,6,0,6,1,0,1,5,-1
Jach,441,1,61,2018-10-01T19:00:00Z,False,6,1,0,0,7,1,6,10,7,3,-3,-1
Jach,441,1,72,2018-10-06T14:00:00Z,True,6,19,0,0,7,1,6,12,8,4,-5,-3
Jach,441,1,84,2018-10-21T15:00:00Z,False,6,7,0,0,7,1,6,12,7,5,-5,-1
Jach,441,1,92,2018-10-28T13:30:00Z,True,6,0,0,0,7,1,6,21,12,9,-14,-8
Jach,441,1,103,2018-11-04T16:00:00Z,False,6,5,0,0,8,2,6,24,11,13,-16,-5
Jach,441,1,113,2018-11-10T17:30:00Z,True,6,16,0,0,8,2,6,24,6,18,-16,-16
Jach,441,1,125,2018-11-24T15:00:00Z,False,6,13,0,0,8,2,6,20,10,10,-12,-4
Jach,441,1,133,2018-12-01T15:00:00Z,True,6,3,0,0,9,2,7,9,4,5,0,-3
Jach,441,1,141,2018-12-04T19:45:00Z,False,6,2,0,0,12,5,7,18,11,7,-6,-4
Jach,441,1,159,2018-12-08T15:00:00Z,False,6,18,0,0,12,5,7,18,10,8,-6,-3
Jach,441,1,161,2018-12-15T15:00:00Z,True,6,10,0,0,12,5,7,22,11,11,-10,-6
Jach,441,1,176,2018-12-22T15:00:00Z,False,6,12,0,0,15,8,7,44,27,17,-29,-20
Jach,441,1,182,2018-12-26T15:00:00Z,True,6,4,0,0,18,8,10,14,13,1,4,7
Jach,441,1,192,2018-12-30T12:00:00Z,True,6,5,0,0,19,9,10,40,21,19,-21,-10
Jach,441,1,209,2019-01-02T19:45:00Z,False,6,19,0,0,19,9,10,29,14,15,-10,-4
Jach,441,1,214,2019-01-12T15:00:00Z,True,6,17,0,0,22,9,13,29,16,13,-7,-4
Jach,441,1,224,2019-01-19T15:00:00Z,False,6,11,0,0,22,9,13,57,28,29,-35,-15
Jach,441,1,238,2019-01-30T19:45:00Z,False,6,15,0,0,22,9,13,22,11,11,0,2
Jach,441,1,244,2019-02-02T15:00:00Z,True,6,8,0,0,23,9,14,17,15,2,6,7
Jach,441,1,251,2019-02-09T15:00:00Z,True,6,18,0,0,26,12,14,32,18,14,-6,-2
Jach,441,1,266,2019-02-23T17:30:00Z,False,6,10,0,0,27,13,14,32,14,18,-5,0
Jach,441,1,272,2019-02-27T20:00:00Z,True,6,13,0,0,30,13,17,52,26,26,-22,-13
Jach,441,1,282,2019-03-02T15:00:00Z,False,6,3,0,0,30,13,17,30,17,13,0,0
Jach,441,1,293,2019-03-09T12:30:00Z,True,6,2,0,0,33,13,20,30,22,8,3,5
Jach,441,1,314,2019-03-30T15:00:00Z,True,6,9,0,0,33,13,20,14,8,6,19,7
Jach,441,1,306,2019-04-03T18:45:00Z,False,6,16,0,0,36,16,20,61,28,33,-25,-8
Jach,441,1,325,2019-04-06T14:00:00Z,False,6,14,0,0,36,16,20,35,22,13,1,-2
Jach,441,1,332,2019-04-14T13:05:00Z,True,6,12,0,0,39,16,23,80,48,32,-41,-16
Jach,441,1,340,2019-04-21T15:00:00Z,False,6,0,0,0,39,16,23,66,44,22,-27,-21
Jach,441,1,352,2019-04-27T14:00:00Z,True,6,7,0,0,42,16,26,49,31,18,-7,-2
Jach,441,1,362,2019-05-04T16:30:00Z,False,6,4,0,0,43,17,26,31,20,11,12,6
Jach,441,1,372,2019-05-12T14:00:00Z,True,6,1,0,0,46,17,29,45,29,16,1,1
Souare,442,1,2,2018-08-11T14:00:00Z,False,6,8,1,1,0,0,0,0,0,0,0,0
Souare,442,1,14,2018-08-20T19:00:00Z,True,6,11,0,0,3,0,3,3,3,0,0,0
Souare,442,1,28,2018-08-26T12:30:00Z,False,6,17,0,0,3,0,3,6,3,3,-3,0
Souare,442,1,34,2018-09-01T14:00:00Z,True,6,15,0,0,3,0,3,1,1,0,2,0
Souare,442,1,43,2018-09-15T14:00:00Z,False,6,9,0,0,3,0,3,2,1,1,1,2
Souare,442,1,54,2018-09-22T14:00:00Z,True,6,14,0,0,6,0,6,1,0,1,5,-1
Souare,442,1,61,2018-10-01T19:00:00Z,False,6,1,0,0,7,1,6,10,7,3,-3,-1
Souare,442,1,72,2018-10-06T14:00:00Z,True,6,19,0,0,7,1,6,12,8,4,-5,-3
Souare,442,1,84,2018-10-21T15:00:00Z,False,6,7,0,0,7,1,6,12,7,5,-5,-1
Souare,442,1,92,2018-10-28T13:30:00Z,True,6,0,0,0,7,1,6,21,12,9,-14,-8
Souare,442,1,103,2018-11-04T16:00:00Z,False,6,5,0,0,8,2,6,24,11,13,-16,-5
Souare,442,1,113,2018-11-10T17:30:00Z,True,6,16,0,0,8,2,6,24,6,18,-16,-16
Souare,442,1,125,2018-11-24T15:00:00Z,False,6,13,0,0,8,2,6,20,10,10,-12,-4
Souare,442,1,133,2018-12-01T15:00:00Z,True,6,3,0,0,9,2,7,9,4,5,0,-3
Souare,442,1,141,2018-12-04T19:45:00Z,False,6,2,0,0,12,5,7,18,11,7,-6,-4
Souare,442,1,159,2018-12-08T15:00:00Z,False,6,18,0,0,12,5,7,18,10,8,-6,-3
Souare,442,1,161,2018-12-15T15:00:00Z,True,6,10,0,0,12,5,7,22,11,11,-10,-6
Souare,442,1,176,2018-12-22T15:00:00Z,False,6,12,0,0,15,8,7,44,27,17,-29,-20
Souare,442,1,182,2018-12-26T15:00:00Z,True,6,4,0,0,18,8,10,14,13,1,4,7
Souare,442,1,192,2018-12-30T12:00:00Z,True,6,5,0,0,19,9,10,40,21,19,-21,-10
Souare,442,1,209,2019-01-02T19:45:00Z,False,6,19,0,0,19,9,10,29,14,15,-10,-4
Souare,442,1,214,2019-01-12T15:00:00Z,True,6,17,0,0,22,9,13,29,16,13,-7,-4
Souare,442,1,224,2019-01-19T15:00:00Z,False,6,11,0,0,22,9,13,57,28,29,-35,-15
Souare,442,1,238,2019-01-30T19:45:00Z,False,6,15,0,0,22,9,13,22,11,11,0,2
Souare,442,1,244,2019-02-02T15:00:00Z,True,6,8,0,0,23,9,14,17,15,2,6,7
Souare,442,1,251,2019-02-09T15:00:00Z,True,6,18,0,0,26,12,14,32,18,14,-6,-2
Souare,442,1,266,2019-02-23T17:30:00Z,False,6,10,0,0,27,13,14,32,14,18,-5,0
Souare,442,1,272,2019-02-27T20:00:00Z,True,6,13,0,0,30,13,17,52,26,26,-22,-13
Souare,442,1,282,2019-03-02T15:00:00Z,False,6,3,0,0,30,13,17,30,17,13,0,0
Souare,442,1,293,2019-03-09T12:30:00Z,True,6,2,0,0,33,13,20,30,22,8,3,5
Souare,442,1,314,2019-03-30T15:00:00Z,True,6,9,0,0,33,13,20,14,8,6,19,7
Souare,442,1,306,2019-04-03T18:45:00Z,False,6,16,0,0,36,16,20,61,28,33,-25,-8
Souare,442,1,325,2019-04-06T14:00:00Z,False,6,14,0,0,36,16,20,35,22,13,1,-2
Souare,442,1,332,2019-04-14T13:05:00Z,True,6,12,0,0,39,16,23,80,48,32,-41,-16
Souare,442,1,340,2019-04-21T15:00:00Z,False,6,0,0,0,39,16,23,66,44,22,-27,-21
Souare,442,1,352,2019-04-27T14:00:00Z,True,6,7,0,0,42,16,26,49,31,18,-7,-2
Souare,442,1,362,2019-05-04T16:30:00Z,False,6,4,0,0,43,17,26,31,20,11,12,6
Souare,442,1,372,2019-05-12T14:00:00Z,True,6,1,0,0,46,17,29,45,29,16,1,1
Wickham,443,3,2,2018-08-11T14:00:00Z,False,6,8,0,0,0,0,0,0,0,0,0,0
Wickham,443,3,14,2018-08-20T19:00:00Z,True,6,11,0,0,3,0,3,3,3,0,0,0
Wickham,443,3,28,2018-08-26T12:30:00Z,False,6,17,0,0,3,0,3,6,3,3,-3,0
Wickham,443,3,34,2018-09-01T14:00:00Z,True,6,15,0,0,3,0,3,1,1,0,2,0
Wickham,443,3,43,2018-09-15T14:00:00Z,False,6,9,0,0,3,0,3,2,1,1,1,2
Wickham,443,3,54,2018-09-22T14:00:00Z,True,6,14,0,0,6,0,6,1,0,1,5,-1
Wickham,443,3,61,2018-10-01T19:00:00Z,False,6,1,0,0,7,1,6,10,7,3,-3,-1
Wickham,443,3,72,2018-10-06T14:00:00Z,True,6,19,0,0,7,1,6,12,8,4,-5,-3
Wickham,443,3,84,2018-10-21T15:00:00Z,False,6,7,1,1,7,1,6,12,7,5,-5,-1
Wickham,443,3,92,2018-10-28T13:30:00Z,True,6,0,0,0,7,1,6,21,12,9,-14,-8
Wickham,443,3,103,2018-11-04T16:00:00Z,False,6,5,0,0,8,2,6,24,11,13,-16,-5
Wickham,443,3,113,2018-11-10T17:30:00Z,True,6,16,0,0,8,2,6,24,6,18,-16,-16
Wickham,443,3,125,2018-11-24T15:00:00Z,False,6,13,0,0,8,2,6,20,10,10,-12,-4
Wickham,443,3,133,2018-12-01T15:00:00Z,True,6,3,0,0,9,2,7,9,4,5,0,-3
Wickham,443,3,141,2018-12-04T19:45:00Z,False,6,2,0,0,12,5,7,18,11,7,-6,-4
Wickham,443,3,159,2018-12-08T15:00:00Z,False,6,18,0,0,12,5,7,18,10,8,-6,-3
Wickham,443,3,161,2018-12-15T15:00:00Z,True,6,10,0,0,12,5,7,22,11,11,-10,-6
Wickham,443,3,176,2018-12-22T15:00:00Z,False,6,12,0,0,15,8,7,44,27,17,-29,-20
Wickham,443,3,182,2018-12-26T15:00:00Z,True,6,4,27,1,18,8,10,14,13,1,4,7
Wickham,443,3,192,2018-12-30T12:00:00Z,True,6,5,21,1,19,9,10,40,21,19,-21,-10
Wickham,443,3,209,2019-01-02T19:45:00Z,False,6,19,2,1,19,9,10,29,14,15,-10,-4
Wickham,443,3,214,2019-01-12T15:00:00Z,True,6,17,0,0,22,9,13,29,16,13,-7,-4
Wickham,443,3,224,2019-01-19T15:00:00Z,False,6,11,9,4,22,9,13,57,28,29,-35,-15
Wickham,443,3,238,2019-01-30T19:45:00Z,False,6,15,0,0,22,9,13,22,11,11,0,2
Wickham,443,3,244,2019-02-02T15:00:00Z,True,6,8,0,0,23,9,14,17,15,2,6,7
Wickham,443,3,251,2019-02-09T15:00:00Z,True,6,18,0,0,26,12,14,32,18,14,-6,-2
Wickham,443,3,266,2019-02-23T17:30:00Z,False,6,10,0,0,27,13,14,32,14,18,-5,0
Wickham,443,3,272,2019-02-27T20:00:00Z,True,6,13,0,0,30,13,17,52,26,26,-22,-13
Wickham,443,3,282,2019-03-02T15:00:00Z,False,6,3,0,0,30,13,17,30,17,13,0,0
Wickham,443,3,293,2019-03-09T12:30:00Z,True,6,2,0,0,33,13,20,30,22,8,3,5
Wickham,443,3,314,2019-03-30T15:00:00Z,True,6,9,0,0,33,13,20,14,8,6,19,7
Wickham,443,3,306,2019-04-03T18:45:00Z,False,6,16,0,0,36,16,20,61,28,33,-25,-8
Wickham,443,3,325,2019-04-06T14:00:00Z,False,6,14,0,0,36,16,20,35,22,13,1,-2
Wickham,443,3,332,2019-04-14T13:05:00Z,True,6,12,0,0,39,16,23,80,48,32,-41,-16
Wickham,443,3,340,2019-04-21T15:00:00Z,False,6,0,0,0,39,16,23,66,44,22,-27,-21
Wickham,443,3,352,2019-04-27T14:00:00Z,True,6,7,0,0,42,16,26,49,31,18,-7,-2
Wickham,443,3,362,2019-05-04T16:30:00Z,False,6,4,0,0,43,17,26,31,20,11,12,6
Wickham,443,3,372,2019-05-12T14:00:00Z,True,6,1,1,1,46,17,29,45,29,16,1,1
Foster,444,0,8,2018-08-11T14:00:00Z,True,17,2,90,6,0,0,0,0,0,0,0,0
Foster,444,0,11,2018-08-19T12:30:00Z,False,17,3,90,2,3,3,0,1,0,1,2,0
Foster,444,0,28,2018-08-26T12:30:00Z,True,17,6,90,2,6,3,3,3,0,3,3,0
Foster,444,0,38,2018-09-02T15:00:00Z,True,17,16,90,2,9,6,3,9,3,6,0,0
Foster,444,0,48,2018-09-15T16:30:00Z,True,17,13,90,2,12,9,3,6,3,3,6,6
Foster,444,0,55,2018-09-22T11:30:00Z,False,17,8,90,2,12,9,3,4,3,1,8,0
Foster,444,0,60,2018-09-29T14:00:00Z,False,17,0,90,1,13,9,4,12,6,6,1,-2
Foster,444,0,79,2018-10-06T14:00:00Z,True,17,1,90,1,13,9,4,13,10,3,0,6
Foster,444,0,89,2018-10-20T14:00:00Z,False,17,19,90,6,13,9,4,15,8,7,-2,-4
Foster,444,0,99,2018-10-27T14:00:00Z,True,17,9,90,9,16,9,7,3,1,2,13,7
Foster,444,0,107,2018-11-03T15:00:00Z,False,17,14,90,2,19,12,7,3,0,3,16,7
Foster,444,0,119,2018-11-10T15:00:00Z,False,17,15,90,3,19,12,7,7,3,4,12,4
Foster,444,0,127,2018-11-24T15:00:00Z,True,17,11,90,2,20,12,8,30,16,14,-10,-2
Foster,444,0,135,2018-12-01T15:00:00Z,False,17,10,90,1,20,12,8,18,8,10,2,0
Foster,444,0,145,2018-12-04T20:00:00Z,True,17,12,90,2,20,12,8,38,24,14,-18,-2
Foster,444,0,155,2018-12-10T20:00:00Z,False,17,7,90,9,20,12,8,23,17,6,-3,-9
Foster,444,0,168,2018-12-15T15:00:00Z,True,17,4,90,1,21,12,9,14,13,1,7,11
Foster,444,0,178,2018-12-22T15:00:00Z,False,17,18,90,11,24,15,9,24,13,11,0,-4
Foster,444,0,189,2018-12-26T19:30:00Z,True,17,5,90,0,27,15,12,37,21,16,-10,-1
Foster,444,0,199,2018-12-29T15:00:00Z,True,17,14,90,2,27,15,12,17,7,10,10,5
Foster,444,0,201,2019-01-02T19:45:00Z,False,17,1,90,4,28,16,12,26,17,9,2,-5
Foster,444,0,214,2019-01-12T15:00:00Z,False,17,6,90,4,29,16,13,22,9,13,7,4
Foster,444,0,228,2019-01-19T15:00:00Z,True,17,3,90,8,32,16,16,21,13,8,11,8
Foster,444,0,239,2019-01-30T20:00:00Z,False,17,16,90,2,33,17,16,51,18,33,-18,-2
Foster,444,0,240,2019-02-02T15:00:00Z,False,17,2,90,8,33,17,16,26,18,8,7,-2
Foster,444,0,258,2019-02-09T15:00:00Z,True,17,7,90,10,34,17,17,33,21,12,1,5
Foster,444,0,263,2019-02-22T19:45:00Z,False,17,4,90,3,37,20,17,25,17,8,12,0
Foster,444,0,276,2019-02-27T20:00:00Z,False,17,11,90,1,40,20,20,66,35,31,-26,-15
Foster,444,0,287,2019-03-03T12:00:00Z,True,17,10,90,2,40,20,20,35,17,18,5,2
Foster,444,0,297,2019-03-09T17:30:00Z,False,17,12,90,2,43,23,20,71,42,29,-28,-22
Foster,444,0,318,2019-03-30T15:00:00Z,False,17,13,90,2,43,23,20,58,29,29,-15,-9
Foster,444,0,328,2019-04-02T18:45:00Z,True,17,8,90,4,43,23,20,17,15,2,26,21
Foster,444,0,339,2019-04-15T19:00:00Z,True,17,0,90,3,46,26,20,63,44,19,-17,7
Foster,444,0,345,2019-04-20T14:00:00Z,False,17,9,90,2,46,26,20,14,8,6,32,12
Foster,444,0,307,2019-04-23T18:45:00Z,True,17,15,90,3,49,26,23,36,21,15,13,11
Foster,444,0,359,2019-04-27T14:00:00Z,True,17,19,90,1,50,27,23,51,31,20,-1,7
Foster,444,0,363,2019-05-05T13:00:00Z,False,17,5,90,3,50,27,23,68,39,29,-18,-16
Foster,444,0,379,2019-05-12T14:00:00Z,True,17,18,90,1,50,27,23,49,31,18,1,9
Sema,445,2,8,2018-08-11T14:00:00Z,True,17,2,9,1,0,0,0,0,0,0,0,0
Sema,445,2,11,2018-08-19T12:30:00Z,False,17,3,22,1,3,3,0,1,0,1,2,0
Sema,445,2,28,2018-08-26T12:30:00Z,True,17,6,17,1,6,3,3,3,0,3,3,0
Sema,445,2,38,2018-09-02T15:00:00Z,True,17,16,0,0,9,6,3,9,3,6,0,0
Sema,445,2,48,2018-09-15T16:30:00Z,True,17,13,0,0,12,9,3,6,3,3,6,6
Sema,445,2,55,2018-09-22T11:30:00Z,False,17,8,1,1,12,9,3,4,3,1,8,0
Sema,445,2,60,2018-09-29T14:00:00Z,False,17,0,0,0,13,9,4,12,6,6,1,-2
Sema,445,2,79,2018-10-06T14:00:00Z,True,17,1,0,0,13,9,4,13,10,3,0,6
Sema,445,2,89,2018-10-20T14:00:00Z,False,17,19,0,0,13,9,4,15,8,7,-2,-4
Sema,445,2,99,2018-10-27T14:00:00Z,True,17,9,25,1,16,9,7,3,1,2,13,7
Sema,445,2,107,2018-11-03T15:00:00Z,False,17,14,0,0,19,12,7,3,0,3,16,7
Sema,445,2,119,2018-11-10T15:00:00Z,False,17,15,0,0,19,12,7,7,3,4,12,4
Sema,445,2,127,2018-11-24T15:00:00Z,True,17,11,0,0,20,12,8,30,16,14,-10,-2
Sema,445,2,135,2018-12-01T15:00:00Z,False,17,10,0,0,20,12,8,18,8,10,2,0
Sema,445,2,145,2018-12-04T20:00:00Z,True,17,12,0,0,20,12,8,38,24,14,-18,-2
Sema,445,2,155,2018-12-10T20:00:00Z,False,17,7,59,1,20,12,8,23,17,6,-3,-9
Sema,445,2,168,2018-12-15T15:00:00Z,True,17,4,76,6,21,12,9,14,13,1,7,11
Sema,445,2,178,2018-12-22T15:00:00Z,False,17,18,74,3,24,15,9,24,13,11,0,-4
Sema,445,2,189,2018-12-26T19:30:00Z,True,17,5,66,2,27,15,12,37,21,16,-10,-1
Sema,445,2,199,2018-12-29T15:00:00Z,True,17,14,0,0,27,15,12,17,7,10,10,5
Sema,445,2,201,2019-01-02T19:45:00Z,False,17,1,70,11,28,16,12,26,17,9,2,-5
Sema,445,2,214,2019-01-12T15:00:00Z,False,17,6,48,0,29,16,13,22,9,13,7,4
Sema,445,2,228,2019-01-19T15:00:00Z,True,17,3,55,1,32,16,16,21,13,8,11,8
Sema,445,2,239,2019-01-30T20:00:00Z,False,17,16,0,0,33,17,16,51,18,33,-18,-2
Sema,445,2,240,2019-02-02T15:00:00Z,False,17,2,80,3,33,17,16,26,18,8,7,-2
Sema,445,2,258,2019-02-09T15:00:00Z,True,17,7,45,1,34,17,17,33,21,12,1,5
Sema,445,2,263,2019-02-22T19:45:00Z,False,17,4,0,0,37,20,17,25,17,8,12,0
Sema,445,2,276,2019-02-27T20:00:00Z,False,17,11,6,1,40,20,20,66,35,31,-26,-15
Sema,445,2,287,2019-03-03T12:00:00Z,True,17,10,0,0,40,20,20,35,17,18,5,2
Sema,445,2,297,2019-03-09T17:30:00Z,False,17,12,0,0,43,23,20,71,42,29,-28,-22
Sema,445,2,318,2019-03-30T15:00:00Z,False,17,13,0,0,43,23,20,58,29,29,-15,-9
Sema,445,2,328,2019-04-02T18:45:00Z,True,17,8,0,0,43,23,20,17,15,2,26,21
Sema,445,2,339,2019-04-15T19:00:00Z,True,17,0,4,1,46,26,20,63,44,19,-17,7
Sema,445,2,345,2019-04-20T14:00:00Z,False,17,9,90,2,46,26,20,14,8,6,32,12
Sema,445,2,307,2019-04-23T18:45:00Z,True,17,15,0,0,49,26,23,36,21,15,13,11
Sema,445,2,359,2019-04-27T14:00:00Z,True,17,19,0,0,50,27,23,51,31,20,-1,7
Sema,445,2,363,2019-05-05T13:00:00Z,False,17,5,0,0,50,27,23,68,39,29,-18,-16
Sema,445,2,379,2019-05-12T14:00:00Z,True,17,18,0,0,50,27,23,49,31,18,1,9
Wilshere,446,2,4,2018-08-12T12:30:00Z,False,18,11,90,2,0,0,0,0,0,0,0,0
Wilshere,446,2,19,2018-08-18T14:00:00Z,True,18,1,90,1,0,0,0,3,3,0,-3,0
Wilshere,446,2,20,2018-08-25T14:00:00Z,False,18,0,90,1,0,0,0,0,0,0,0,0
Wilshere,446,2,39,2018-09-01T14:00:00Z,True,18,19,63,3,0,0,0,2,2,0,-2,0
Wilshere,446,2,42,2018-09-16T15:00:00Z,False,18,7,0,0,0,0,0,6,4,2,-6,-4
Wilshere,446,2,59,2018-09-23T12:30:00Z,True,18,5,0,0,3,0,3,15,9,6,-12,-6
Wilshere,446,2,68,2018-09-29T11:30:00Z,True,18,13,0,0,4,1,3,10,4,6,-6,-5
Wilshere,446,2,70,2018-10-05T19:00:00Z,False,18,2,0,0,7,4,3,5,4,1,2,-1
Wilshere,446,2,88,2018-10-20T14:00:00Z,True,18,16,0,0,7,4,3,18,6,12,-11,-8
Wilshere,446,2,94,2018-10-27T16:30:00Z,False,18,10,0,0,7,4,3,12,6,6,-5,-3
Wilshere,446,2,108,2018-11-03T15:00:00Z,True,18,3,0,0,8,4,4,8,4,4,0,0
Wilshere,446,2,114,2018-11-10T15:00:00Z,False,18,9,0,0,11,7,4,6,4,2,5,0
Wilshere,446,2,128,2018-11-24T15:00:00Z,True,18,12,0,0,12,7,5,32,21,11,-20,-4
Wilshere,446,2,138,2018-12-01T15:00:00Z,False,18,14,5,4,12,7,5,12,6,6,0,-1
Wilshere,446,2,146,2018-12-04T19:45:00Z,True,18,4,0,0,15,7,8,11,10,1,4,6
Wilshere,446,2,159,2018-12-08T15:00:00Z,True,18,6,0,0,18,10,8,12,5,7,6,3
Wilshere,446,2,162,2018-12-15T17:30:00Z,False,18,8,0,0,21,13,8,9,8,1,12,0
Wilshere,446,2,178,2018-12-22T15:00:00Z,True,18,17,0,0,24,13,11,24,15,9,0,4
Wilshere,446,2,187,2018-12-27T19:45:00Z,False,18,15,0,0,24,13,11,15,8,7,9,3
Wilshere,446,2,191,2018-12-30T14:15:00Z,False,18,3,0,0,27,13,14,12,7,5,15,7
Wilshere,446,2,208,2019-01-02T19:45:00Z,True,18,2,0,0,27,13,14,25,18,7,2,6
Wilshere,446,2,219,2019-01-12T12:30:00Z,True,18,0,0,0,28,14,14,41,26,15,-13,-1
Wilshere,446,2,221,2019-01-19T15:00:00Z,False,18,1,0,0,31,17,14,27,18,9,4,-4
Wilshere,446,2,235,2019-01-29T19:45:00Z,False,18,19,0,0,31,17,14,32,17,15,-1,-3
Wilshere,446,2,249,2019-02-04T20:00:00Z,True,18,11,0,0,31,17,14,61,32,29,-30,-12
Wilshere,446,2,251,2019-02-09T15:00:00Z,False,18,6,0,0,32,18,14,26,12,14,6,2
Wilshere,446,2,269,2019-02-22T19:45:00Z,True,18,8,0,0,33,18,15,17,15,2,16,16
Wilshere,446,2,277,2019-02-27T20:00:00Z,False,18,12,0,0,36,21,15,65,39,26,-29,-24
Wilshere,446,2,288,2019-03-02T17:30:00Z,True,18,14,0,0,36,21,15,31,19,12,5,9
Wilshere,446,2,291,2019-03-09T15:00:00Z,False,18,4,0,0,39,24,15,25,17,8,14,-2
Wilshere,446,2,308,2019-03-16T15:00:00Z,True,18,9,0,0,39,24,15,14,8,6,25,18
Wilshere,446,2,319,2019-03-30T17:30:00Z,True,18,7,0,0,42,27,15,40,25,15,2,12
Wilshere,446,2,321,2019-04-08T19:00:00Z,False,18,5,0,0,42,27,15,63,35,28,-21,-20
Wilshere,446,2,336,2019-04-13T16:30:00Z,False,18,13,0,0,42,27,15,61,32,29,-19,-17
Wilshere,446,2,348,2019-04-20T14:00:00Z,True,18,10,5,1,42,27,15,47,23,24,-5,3
Wilshere,446,2,358,2019-04-27T11:30:00Z,False,18,16,0,0,43,28,15,70,37,33,-27,-22
Wilshere,446,2,368,2019-05-04T14:00:00Z,True,18,15,22,4,46,28,18,38,22,16,8,12
Wilshere,446,2,379,2019-05-12T14:00:00Z,False,18,17,23,1,49,31,18,50,27,23,-1,-9
Gibbs-White,447,2,9,2018-08-11T16:30:00Z,True,19,7,5,1,0,0,0,0,0,0,0,0
Gibbs-White,447,2,16,2018-08-18T14:00:00Z,False,19,10,21,0,1,1,0,0,0,0,1,0
Gibbs-White,447,2,29,2018-08-25T11:30:00Z,True,19,12,0,0,1,1,0,6,3,3,-5,-2
Gibbs-White,447,2,39,2018-09-01T14:00:00Z,False,19,18,0,0,2,2,0,0,0,0,2,0
Gibbs-White,447,2,49,2018-09-16T12:30:00Z,True,19,3,2,1,5,2,3,1,0,1,4,1
Gibbs-White,447,2,58,2018-09-22T14:00:00Z,False,19,13,3,1,8,5,3,9,3,6,-1,0
Gibbs-White,447,2,69,2018-09-29T14:00:00Z,True,19,15,0,0,9,5,4,5,2,3,4,2
Gibbs-White,447,2,72,2018-10-06T14:00:00Z,False,19,6,0,0,12,8,4,7,1,6,5,3
Gibbs-White,447,2,89,2018-10-20T14:00:00Z,True,19,17,0,0,15,8,7,13,9,4,2,4
Gibbs-White,447,2,90,2018-10-27T14:00:00Z,False,19,2,0,0,15,8,7,11,7,4,4,0
Gibbs-White,447,2,109,2018-11-03T19:45:00Z,True,19,16,28,1,15,8,7,21,6,15,-6,-7
Gibbs-White,447,2,110,2018-11-11T16:30:00Z,False,19,0,5,1,15,8,7,23,13,10,-8,-6
Gibbs-White,447,2,129,2018-11-25T16:00:00Z,True,19,9,45,1,16,8,8,7,5,2,9,6
Gibbs-White,447,2,131,2018-11-30T20:00:00Z,False,19,4,17,1,16,8,8,8,7,1,8,1
Gibbs-White,447,2,147,2018-12-05T19:45:00Z,True,19,5,71,5,16,8,8,31,18,13,-15,-5
Gibbs-White,447,2,158,2018-12-09T16:00:00Z,False,19,14,30,1,19,11,8,13,6,7,6,2
Gibbs-White,447,2,169,2018-12-15T15:00:00Z,True,19,1,74,3,22,11,11,23,14,9,-1,2
Gibbs-White,447,2,179,2018-12-21T20:00:00Z,True,19,11,27,1,25,14,11,45,22,23,-20,-9
Gibbs-White,447,2,183,2018-12-26T12:30:00Z,False,19,8,62,3,25,14,11,10,8,2,15,3
Gibbs-White,447,2,198,2018-12-29T15:00:00Z,False,19,16,5,1,26,14,12,45,18,27,-19,-6
Gibbs-White,447,2,209,2019-01-02T19:45:00Z,True,19,6,26,1,29,14,15,19,9,10,10,4
Gibbs-White,447,2,217,2019-01-14T20:00:00Z,False,19,12,18,1,29,14,15,50,30,20,-21,-15
Gibbs-White,447,2,229,2019-01-19T12:30:00Z,True,19,10,9,1,29,14,15,31,14,17,-2,-3
Gibbs-White,447,2,235,2019-01-29T19:45:00Z,True,19,18,1,1,32,17,15,31,17,14,1,3
Gibbs-White,447,2,245,2019-02-02T15:00:00Z,False,19,7,0,0,35,20,15,33,21,12,2,-6
Gibbs-White,447,2,259,2019-02-11T20:00:00Z,True,19,14,0,0,38,20,18,24,13,11,14,9
Gibbs-White,447,2,261,2019-02-23T15:00:00Z,False,19,1,0,0,39,21,18,33,24,9,6,-6
Gibbs-White,447,2,273,2019-02-26T19:45:00Z,False,19,9,24,1,40,21,19,11,5,6,29,14
Gibbs-White,447,2,289,2019-03-02T15:00:00Z,True,19,4,63,3,40,21,19,25,17,8,15,13
Gibbs-White,447,2,292,2019-03-10T14:05:00Z,False,19,5,8,1,43,24,19,56,31,25,-13,-12
Gibbs-White,447,2,312,2019-03-30T15:00:00Z,False,19,3,0,0,44,24,20,30,17,13,14,3
Gibbs-White,447,2,329,2019-04-02T18:45:00Z,True,19,13,0,0,44,24,20,61,32,29,-17,-5
Gibbs-White,447,2,337,2019-04-13T14:00:00Z,False,19,15,21,1,47,27,20,33,18,15,14,2
Gibbs-White,447,2,349,2019-04-20T14:00:00Z,True,19,2,72,3,47,27,20,33,22,11,14,16
Gibbs-White,447,2,309,2019-04-24T18:45:00Z,True,19,0,1,1,48,28,20,66,44,22,-18,6
Gibbs-White,447,2,359,2019-04-27T14:00:00Z,False,19,17,1,1,51,31,20,50,27,23,1,-7
Gibbs-White,447,2,369,2019-05-04T14:00:00Z,True,19,8,0,0,54,31,23,26,21,5,28,26
Gibbs-White,447,2,375,2019-05-12T14:00:00Z,False,19,11,6,1,57,34,23,94,50,44,-37,-27
Mir,448,3,9,2018-08-11T16:30:00Z,True,19,7,0,0,0,0,0,0,0,0,0,0
Mir,448,3,16,2018-08-18T14:00:00Z,False,19,10,0,0,1,1,0,0,0,0,1,0
Mir,448,3,29,2018-08-25T11:30:00Z,True,19,12,0,0,1,1,0,6,3,3,-5,-2
Mir,448,3,39,2018-09-01T14:00:00Z,False,19,18,0,0,2,2,0,0,0,0,2,0
Mir,448,3,49,2018-09-16T12:30:00Z,True,19,3,0,0,5,2,3,1,0,1,4,1
Mir,448,3,58,2018-09-22T14:00:00Z,False,19,13,0,0,8,5,3,9,3,6,-1,0
Mir,448,3,69,2018-09-29T14:00:00Z,True,19,15,0,0,9,5,4,5,2,3,4,2
Mir,448,3,72,2018-10-06T14:00:00Z,False,19,6,0,0,12,8,4,7,1,6,5,3
Mir,448,3,89,2018-10-20T14:00:00Z,True,19,17,0,0,15,8,7,13,9,4,2,4
Mir,448,3,90,2018-10-27T14:00:00Z,False,19,2,0,0,15,8,7,11,7,4,4,0
Mir,448,3,109,2018-11-03T19:45:00Z,True,19,16,0,0,15,8,7,21,6,15,-6,-7
Mir,448,3,110,2018-11-11T16:30:00Z,False,19,0,0,0,15,8,7,23,13,10,-8,-6
Mir,448,3,129,2018-11-25T16:00:00Z,True,19,9,0,0,16,8,8,7,5,2,9,6
Mir,448,3,131,2018-11-30T20:00:00Z,False,19,4,0,0,16,8,8,8,7,1,8,1
Mir,448,3,147,2018-12-05T19:45:00Z,True,19,5,0,0,16,8,8,31,18,13,-15,-5
Mir,448,3,158,2018-12-09T16:00:00Z,False,19,14,0,0,19,11,8,13,6,7,6,2
Mir,448,3,169,2018-12-15T15:00:00Z,True,19,1,0,0,22,11,11,23,14,9,-1,2
Mir,448,3,179,2018-12-21T20:00:00Z,True,19,11,0,0,25,14,11,45,22,23,-20,-9
Mir,448,3,183,2018-12-26T12:30:00Z,False,19,8,0,0,25,14,11,10,8,2,15,3
Mir,448,3,198,2018-12-29T15:00:00Z,False,19,16,0,0,26,14,12,45,18,27,-19,-6
Mir,448,3,209,2019-01-02T19:45:00Z,True,19,6,0,0,29,14,15,19,9,10,10,4
Mir,448,3,217,2019-01-14T20:00:00Z,False,19,12,0,0,29,14,15,50,30,20,-21,-15
Mir,448,3,229,2019-01-19T12:30:00Z,True,19,10,0,0,29,14,15,31,14,17,-2,-3
Mir,448,3,235,2019-01-29T19:45:00Z,True,19,18,0,0,32,17,15,31,17,14,1,3
Mir,448,3,245,2019-02-02T15:00:00Z,False,19,7,0,0,35,20,15,33,21,12,2,-6
Mir,448,3,259,2019-02-11T20:00:00Z,True,19,14,0,0,38,20,18,24,13,11,14,9
Mir,448,3,261,2019-02-23T15:00:00Z,False,19,1,0,0,39,21,18,33,24,9,6,-6
Mir,448,3,273,2019-02-26T19:45:00Z,False,19,9,0,0,40,21,19,11,5,6,29,14
Mir,448,3,289,2019-03-02T15:00:00Z,True,19,4,0,0,40,21,19,25,17,8,15,13
Mir,448,3,292,2019-03-10T14:05:00Z,False,19,5,0,0,43,24,19,56,31,25,-13,-12
Mir,448,3,312,2019-03-30T15:00:00Z,False,19,3,0,0,44,24,20,30,17,13,14,3
Mir,448,3,329,2019-04-02T18:45:00Z,True,19,13,0,0,44,24,20,61,32,29,-17,-5
Mir,448,3,337,2019-04-13T14:00:00Z,False,19,15,0,0,47,27,20,33,18,15,14,2
Mir,448,3,349,2019-04-20T14:00:00Z,True,19,2,0,0,47,27,20,33,22,11,14,16
Mir,448,3,309,2019-04-24T18:45:00Z,True,19,0,0,0,48,28,20,66,44,22,-18,6
Mir,448,3,359,2019-04-27T14:00:00Z,False,19,17,0,0,51,31,20,50,27,23,1,-7
Mir,448,3,369,2019-05-04T14:00:00Z,True,19,8,0,0,54,31,23,26,21,5,28,26
Mir,448,3,375,2019-05-12T14:00:00Z,False,19,11,0,0,57,34,23,94,50,44,-37,-27
Torreira,449,2,0,2018-08-12T15:00:00Z,True,0,12,20,1,0,0,0,0,0,0,0,0
Torreira,449,2,13,2018-08-18T16:30:00Z,False,0,5,45,1,0,0,0,3,0,3,-3,0
Torreira,449,2,20,2018-08-25T14:00:00Z,True,0,18,34,1,0,0,0,0,0,0,0,0
Torreira,449,2,32,2018-09-02T12:30:00Z,False,0,4,20,4,3,3,0,2,1,1,1,-1
Torreira,449,2,45,2018-09-15T14:00:00Z,False,0,14,45,1,6,3,3,1,0,1,5,3
Torreira,449,2,50,2018-09-23T15:00:00Z,True,0,7,90,2,9,3,6,6,4,2,3,1
Torreira,449,2,60,2018-09-29T14:00:00Z,True,0,17,90,2,12,6,6,13,9,4,-1,2
Torreira,449,2,73,2018-10-07T11:00:00Z,False,0,8,90,2,15,9,6,5,4,1,10,2
Torreira,449,2,80,2018-10-22T19:00:00Z,True,0,10,90,2,18,9,9,12,6,6,6,3
Torreira,449,2,92,2018-10-28T13:30:00Z,False,0,6,90,6,21,12,9,7,1,6,14,8
Torreira,449,2,100,2018-11-03T17:30:00Z,True,0,11,90,2,22,12,10,26,13,13,-4,-1
Torreira,449,2,110,2018-11-11T16:30:00Z,True,0,19,90,2,23,13,10,15,8,7,8,6
Torreira,449,2,120,2018-11-25T13:30:00Z,False,0,1,78,2,24,14,10,20,11,9,4,-1
Torreira,449,2,130,2018-12-02T14:05:00Z,True,0,16,90,6,27,14,13,30,9,21,-3,-7
Torreira,449,2,144,2018-12-05T20:00:00Z,False,0,13,90,6,30,17,13,22,11,11,8,2
Torreira,449,2,150,2018-12-08T15:00:00Z,True,0,9,90,11,31,17,14,10,5,5,21,12
Torreira,449,2,166,2018-12-16T13:30:00Z,False,0,15,90,2,34,20,14,9,5,4,25,9
Torreira,449,2,170,2018-12-22T12:30:00Z,True,0,3,31,1,34,20,14,12,7,5,22,15
Torreira,449,2,180,2018-12-26T17:15:00Z,False,0,2,90,2,37,23,14,21,14,7,16,0
Torreira,449,2,195,2018-12-29T17:30:00Z,False,0,11,90,2,38,23,15,51,25,26,-13,-10
Torreira,449,2,200,2019-01-01T15:00:00Z,True,0,8,45,1,38,23,15,14,12,2,24,21
Torreira,449,2,219,2019-01-12T12:30:00Z,False,0,18,31,1,41,26,15,28,14,14,13,1
Torreira,449,2,220,2019-01-19T17:30:00Z,True,0,5,90,3,41,26,15,47,25,22,-6,4
Torreira,449,2,230,2019-01-29T19:45:00Z,True,0,4,90,2,44,29,15,19,14,5,25,24
Torreira,449,2,247,2019-02-03T16:30:00Z,False,0,12,90,1,47,32,15,56,33,23,-9,-18
Torreira,449,2,253,2019-02-09T15:00:00Z,False,0,9,58,1,47,32,15,11,5,6,36,10
Torreira,449,2,260,2019-02-24T14:05:00Z,True,0,15,90,3,50,32,18,24,12,12,26,20
Torreira,449,2,270,2019-02-27T19:45:00Z,True,0,1,90,4,53,35,18,34,25,9,19,26
Torreira,449,2,286,2019-03-02T12:30:00Z,False,0,16,45,-2,56,38,18,60,27,33,-4,-9
Torreira,449,2,290,2019-03-10T16:30:00Z,True,0,13,0,0,57,38,19,58,29,29,-1,9
Torreira,449,2,310,2019-04-01T19:00:00Z,True,0,14,0,0,60,41,19,35,22,13,25,28
Torreira,449,2,322,2019-04-07T13:05:00Z,False,0,7,0,0,63,44,19,43,25,18,20,-6
Torreira,449,2,339,2019-04-15T19:00:00Z,False,0,17,45,1,63,44,19,46,26,20,17,-7
Torreira,449,2,340,2019-04-21T15:00:00Z,True,0,6,22,1,66,44,22,39,16,23,27,21
Torreira,449,2,309,2019-04-24T18:45:00Z,False,0,19,58,0,66,44,22,48,28,20,18,-6
Torreira,449,2,354,2019-04-28T11:00:00Z,False,0,10,90,2,66,44,22,48,23,25,18,-1
Torreira,449,2,360,2019-05-05T15:30:00Z,True,0,2,90,2,66,44,22,35,23,12,31,32
Torreira,449,2,371,2019-05-12T14:00:00Z,False,0,3,0,0,67,45,22,40,23,17,27,-1
Guendouzi,450,2,0,2018-08-12T15:00:00Z,True,0,12,90,2,0,0,0,0,0,0,0,0
Guendouzi,450,2,13,2018-08-18T16:30:00Z,False,0,5,90,2,0,0,0,3,0,3,-3,0
Guendouzi,450,2,20,2018-08-25T14:00:00Z,True,0,18,55,1,0,0,0,0,0,0,0,0
Guendouzi,450,2,32,2018-09-02T12:30:00Z,False,0,4,69,1,3,3,0,2,1,1,1,-1
Guendouzi,450,2,45,2018-09-15T14:00:00Z,False,0,14,45,1,6,3,3,1,0,1,5,3
Guendouzi,450,2,50,2018-09-23T15:00:00Z,True,0,7,0,0,9,3,6,6,4,2,3,1
Guendouzi,450,2,60,2018-09-29T14:00:00Z,True,0,17,0,0,12,6,6,13,9,4,-1,2
Guendouzi,450,2,73,2018-10-07T11:00:00Z,False,0,8,10,1,15,9,6,5,4,1,10,2
Guendouzi,450,2,80,2018-10-22T19:00:00Z,True,0,10,29,1,18,9,9,12,6,6,6,3
Guendouzi,450,2,92,2018-10-28T13:30:00Z,False,0,6,90,1,21,12,9,7,1,6,14,8
Guendouzi,450,2,100,2018-11-03T17:30:00Z,True,0,11,0,0,22,12,10,26,13,13,-4,-1
Guendouzi,450,2,110,2018-11-11T16:30:00Z,True,0,19,45,1,23,13,10,15,8,7,8,6
Guendouzi,450,2,120,2018-11-25T13:30:00Z,False,0,1,11,1,24,14,10,20,11,9,4,-1
Guendouzi,450,2,130,2018-12-02T14:05:00Z,True,0,16,19,1,27,14,13,30,9,21,-3,-7
Guendouzi,450,2,144,2018-12-05T20:00:00Z,False,0,13,90,2,30,17,13,22,11,11,8,2
Guendouzi,450,2,150,2018-12-08T15:00:00Z,True,0,9,90,2,31,17,14,10,5,5,21,12
Guendouzi,450,2,166,2018-12-16T13:30:00Z,False,0,15,90,2,34,20,14,9,5,4,25,9
Guendouzi,450,2,170,2018-12-22T12:30:00Z,True,0,3,90,1,34,20,14,12,7,5,22,15
Guendouzi,450,2,180,2018-12-26T17:15:00Z,False,0,2,90,2,37,23,14,21,14,7,16,0
Guendouzi,450,2,195,2018-12-29T17:30:00Z,False,0,11,10,1,38,23,15,51,25,26,-13,-10
Guendouzi,450,2,200,2019-01-01T15:00:00Z,True,0,8,90,2,38,23,15,14,12,2,24,21
Guendouzi,450,2,219,2019-01-12T12:30:00Z,False,0,18,90,2,41,26,15,28,14,14,13,1
Guendouzi,450,2,220,2019-01-19T17:30:00Z,True,0,5,90,3,41,26,15,47,25,22,-6,4
Guendouzi,450,2,230,2019-01-29T19:45:00Z,True,0,4,90,1,44,29,15,19,14,5,25,24
Guendouzi,450,2,247,2019-02-03T16:30:00Z,False,0,12,90,2,47,32,15,56,33,23,-9,-18
Guendouzi,450,2,253,2019-02-09T15:00:00Z,False,0,9,90,2,47,32,15,11,5,6,36,10
Guendouzi,450,2,260,2019-02-24T14:05:00Z,True,0,15,0,0,50,32,18,24,12,12,26,20
Guendouzi,450,2,270,2019-02-27T19:45:00Z,True,0,1,90,2,53,35,18,34,25,9,19,26
Guendouzi,450,2,286,2019-03-02T12:30:00Z,False,0,16,45,1,56,38,18,60,27,33,-4,-9
Guendouzi,450,2,290,2019-03-10T16:30:00Z,True,0,13,0,0,57,38,19,58,29,29,-1,9
Guendouzi,450,2,310,2019-04-01T19:00:00Z,True,0,14,90,3,60,41,19,35,22,13,25,28
Guendouzi,450,2,322,2019-04-07T13:05:00Z,False,0,7,90,1,63,44,19,43,25,18,20,-6
Guendouzi,450,2,339,2019-04-15T19:00:00Z,False,0,17,31,1,63,44,19,46,26,20,17,-7
Guendouzi,450,2,340,2019-04-21T15:00:00Z,True,0,6,90,1,66,44,22,39,16,23,27,21
Guendouzi,450,2,309,2019-04-24T18:45:00Z,False,0,19,31,1,66,44,22,48,28,20,18,-6
Guendouzi,450,2,354,2019-04-28T11:00:00Z,False,0,10,17,1,66,44,22,48,23,25,18,-1
Guendouzi,450,2,360,2019-05-05T15:30:00Z,True,0,2,13,0,66,44,22,35,23,12,31,32
Guendouzi,450,2,371,2019-05-12T14:00:00Z,False,0,3,90,1,67,45,22,40,23,17,27,-1
Gunn,451,0,7,2018-08-12T12:30:00Z,True,15,3,0,0,0,0,0,0,0,0,0,0
Gunn,451,0,15,2018-08-18T14:00:00Z,False,15,7,0,0,1,1,0,1,0,1,0,0
Gunn,451,0,27,2018-08-25T14:00:00Z,True,15,10,0,0,1,1,0,3,3,0,-2,1
Gunn,451,0,34,2018-09-01T14:00:00Z,False,15,6,0,0,1,1,0,3,0,3,-2,0
Gunn,451,0,46,2018-09-17T19:00:00Z,True,15,2,0,0,4,1,3,4,4,0,0,1
Gunn,451,0,57,2018-09-22T14:00:00Z,False,15,11,0,0,5,2,3,15,6,9,-10,-3
Gunn,451,0,69,2018-09-29T14:00:00Z,False,15,19,0,0,5,2,3,9,5,4,-4,-2
Gunn,451,0,77,2018-10-07T13:15:00Z,True,15,5,0,0,5,2,3,17,10,7,-12,-5
Gunn,451,0,81,2018-10-20T14:00:00Z,False,15,1,0,0,5,2,3,16,10,6,-11,-7
Gunn,451,0,97,2018-10-27T14:00:00Z,True,15,14,0,0,6,2,4,2,0,2,4,0
Gunn,451,0,106,2018-11-04T15:00:00Z,False,15,12,0,0,7,3,4,26,15,11,-19,-11
Gunn,451,0,119,2018-11-10T15:00:00Z,True,15,17,0,0,7,3,4,19,12,7,-12,-4
Gunn,451,0,124,2018-11-24T15:00:00Z,False,15,8,0,0,8,4,4,5,4,1,3,0
Gunn,451,0,139,2018-12-01T17:30:00Z,True,15,13,0,0,8,4,4,21,11,10,-13,-6
Gunn,451,0,149,2018-12-05T20:00:00Z,False,15,16,0,0,9,5,4,30,9,21,-21,-5
Gunn,451,0,153,2018-12-08T15:00:00Z,False,15,4,0,0,9,5,4,11,10,1,-2,-6
Gunn,451,0,166,2018-12-16T13:30:00Z,True,15,0,0,0,9,5,4,34,20,14,-25,-9
Gunn,451,0,175,2018-12-22T15:00:00Z,False,15,9,0,0,12,8,4,10,5,5,2,-1
Gunn,451,0,187,2018-12-27T19:45:00Z,True,15,18,0,0,15,8,7,24,13,11,-9,-3
Gunn,451,0,197,2018-12-30T14:15:00Z,True,15,12,0,0,15,8,7,44,27,17,-29,-9
Gunn,451,0,203,2019-01-02T19:45:00Z,False,15,5,90,11,15,8,7,43,21,22,-28,-14
Gunn,451,0,216,2019-01-12T15:00:00Z,False,15,10,0,0,16,8,8,31,14,17,-15,-6
Gunn,451,0,227,2019-01-19T15:00:00Z,True,15,7,0,0,19,8,11,30,21,9,-11,-1
Gunn,451,0,238,2019-01-30T19:45:00Z,True,15,6,0,0,22,11,11,22,9,13,0,-2
Gunn,451,0,241,2019-02-02T15:00:00Z,False,15,3,0,0,23,12,11,23,13,10,0,-2
Gunn,451,0,256,2019-02-09T15:00:00Z,True,15,4,0,0,24,12,12,22,17,5,2,7
Gunn,451,0,260,2019-02-24T14:05:00Z,False,15,0,90,2,24,12,12,50,32,18,-26,-20
Gunn,451,0,279,2019-02-27T19:45:00Z,True,15,8,90,7,24,12,12,17,15,2,7,10
Gunn,451,0,285,2019-03-02T15:00:00Z,False,15,13,90,8,27,15,12,55,26,29,-28,-14
Gunn,451,0,299,2019-03-09T15:00:00Z,True,15,16,90,3,27,15,12,61,28,33,-34,-18
Gunn,451,0,311,2019-03-30T15:00:00Z,False,15,2,90,6,30,18,12,33,22,11,-3,-10
Gunn,451,0,326,2019-04-05T19:00:00Z,True,15,11,90,1,33,18,15,79,44,35,-46,-17
Gunn,451,0,337,2019-04-13T14:00:00Z,True,15,19,90,2,33,18,15,47,27,20,-14,-2
Gunn,451,0,347,2019-04-20T16:30:00Z,False,15,14,90,1,36,21,15,38,22,16,-2,-7
Gunn,451,0,307,2019-04-23T18:45:00Z,False,15,17,90,3,36,21,15,49,26,23,-13,-11
Gunn,451,0,357,2019-04-27T14:00:00Z,True,15,1,90,1,37,21,16,41,26,15,-4,6
Gunn,451,0,368,2019-05-04T14:00:00Z,False,15,18,0,0,38,22,16,46,28,18,-8,-12
Gunn,451,0,377,2019-05-12T14:00:00Z,True,15,9,90,2,38,22,16,15,9,6,23,16
Yarmolenko,452,2,4,2018-08-12T12:30:00Z,False,18,11,23,1,0,0,0,0,0,0,0,0
Yarmolenko,452,2,19,2018-08-18T14:00:00Z,True,18,1,23,0,0,0,0,3,3,0,-3,0
Yarmolenko,452,2,20,2018-08-25T14:00:00Z,False,18,0,15,1,0,0,0,0,0,0,0,0
Yarmolenko,452,2,39,2018-09-01T14:00:00Z,True,18,19,45,1,0,0,0,2,2,0,-2,0
Yarmolenko,452,2,42,2018-09-16T15:00:00Z,False,18,7,81,13,0,0,0,6,4,2,-6,-4
Yarmolenko,452,2,59,2018-09-23T12:30:00Z,True,18,5,90,3,3,0,3,15,9,6,-12,-6
Yarmolenko,452,2,68,2018-09-29T11:30:00Z,True,18,13,71,5,4,1,3,10,4,6,-6,-5
Yarmolenko,452,2,70,2018-10-05T19:00:00Z,False,18,2,69,2,7,4,3,5,4,1,2,-1
Yarmolenko,452,2,88,2018-10-20T14:00:00Z,True,18,16,39,1,7,4,3,18,6,12,-11,-8
Yarmolenko,452,2,94,2018-10-27T16:30:00Z,False,18,10,0,0,7,4,3,12,6,6,-5,-3
Yarmolenko,452,2,108,2018-11-03T15:00:00Z,True,18,3,0,0,8,4,4,8,4,4,0,0
Yarmolenko,452,2,114,2018-11-10T15:00:00Z,False,18,9,0,0,11,7,4,6,4,2,5,0
Yarmolenko,452,2,128,2018-11-24T15:00:00Z,True,18,12,0,0,12,7,5,32,21,11,-20,-4
Yarmolenko,452,2,138,2018-12-01T15:00:00Z,False,18,14,0,0,12,7,5,12,6,6,0,-1
Yarmolenko,452,2,146,2018-12-04T19:45:00Z,True,18,4,0,0,15,7,8,11,10,1,4,6
Yarmolenko,452,2,159,2018-12-08T15:00:00Z,True,18,6,0,0,18,10,8,12,5,7,6,3
Yarmolenko,452,2,162,2018-12-15T17:30:00Z,False,18,8,0,0,21,13,8,9,8,1,12,0
Yarmolenko,452,2,178,2018-12-22T15:00:00Z,True,18,17,0,0,24,13,11,24,15,9,0,4
Yarmolenko,452,2,187,2018-12-27T19:45:00Z,False,18,15,0,0,24,13,11,15,8,7,9,3
Yarmolenko,452,2,191,2018-12-30T14:15:00Z,False,18,3,0,0,27,13,14,12,7,5,15,7
Yarmolenko,452,2,208,2019-01-02T19:45:00Z,True,18,2,0,0,27,13,14,25,18,7,2,6
Yarmolenko,452,2,219,2019-01-12T12:30:00Z,True,18,0,0,0,28,14,14,41,26,15,-13,-1
Yarmolenko,452,2,221,2019-01-19T15:00:00Z,False,18,1,0,0,31,17,14,27,18,9,4,-4
Yarmolenko,452,2,235,2019-01-29T19:45:00Z,False,18,19,0,0,31,17,14,32,17,15,-1,-3
Yarmolenko,452,2,249,2019-02-04T20:00:00Z,True,18,11,0,0,31,17,14,61,32,29,-30,-12
Yarmolenko,452,2,251,2019-02-09T15:00:00Z,False,18,6,0,0,32,18,14,26,12,14,6,2
Yarmolenko,452,2,269,2019-02-22T19:45:00Z,True,18,8,0,0,33,18,15,17,15,2,16,16
Yarmolenko,452,2,277,2019-02-27T20:00:00Z,False,18,12,0,0,36,21,15,65,39,26,-29,-24
Yarmolenko,452,2,288,2019-03-02T17:30:00Z,True,18,14,0,0,36,21,15,31,19,12,5,9
Yarmolenko,452,2,291,2019-03-09T15:00:00Z,False,18,4,0,0,39,24,15,25,17,8,14,-2
Yarmolenko,452,2,308,2019-03-16T15:00:00Z,True,18,9,0,0,39,24,15,14,8,6,25,18
Yarmolenko,452,2,319,2019-03-30T17:30:00Z,True,18,7,0,0,42,27,15,40,25,15,2,12
Yarmolenko,452,2,321,2019-04-08T19:00:00Z,False,18,5,0,0,42,27,15,63,35,28,-21,-20
Yarmolenko,452,2,336,2019-04-13T16:30:00Z,False,18,13,0,0,42,27,15,61,32,29,-19,-17
Yarmolenko,452,2,348,2019-04-20T14:00:00Z,True,18,10,0,0,42,27,15,47,23,24,-5,3
Yarmolenko,452,2,358,2019-04-27T11:30:00Z,False,18,16,0,0,43,28,15,70,37,33,-27,-22
Yarmolenko,452,2,368,2019-05-04T14:00:00Z,True,18,15,0,0,46,28,18,38,22,16,8,12
Yarmolenko,452,2,379,2019-05-12T14:00:00Z,False,18,17,0,0,49,31,18,50,27,23,-1,-9
Patricio,453,0,9,2018-08-11T16:30:00Z,True,19,7,90,2,0,0,0,0,0,0,0,0
Patricio,453,0,16,2018-08-18T14:00:00Z,False,19,10,90,1,1,1,0,0,0,0,1,0
Patricio,453,0,29,2018-08-25T11:30:00Z,True,19,12,90,3,1,1,0,6,3,3,-5,-2
Patricio,453,0,39,2018-09-01T14:00:00Z,False,19,18,90,7,2,2,0,0,0,0,2,0
Patricio,453,0,49,2018-09-16T12:30:00Z,True,19,3,90,6,5,2,3,1,0,1,4,1
Patricio,453,0,58,2018-09-22T14:00:00Z,False,19,13,90,3,8,5,3,9,3,6,-1,0
Patricio,453,0,69,2018-09-29T14:00:00Z,True,19,15,90,10,9,5,4,5,2,3,4,2
Patricio,453,0,72,2018-10-06T14:00:00Z,False,19,6,90,9,12,8,4,7,1,6,5,3
Patricio,453,0,89,2018-10-20T14:00:00Z,True,19,17,90,1,15,8,7,13,9,4,2,4
Patricio,453,0,90,2018-10-27T14:00:00Z,False,19,2,90,2,15,8,7,11,7,4,4,0
Patricio,453,0,109,2018-11-03T19:45:00Z,True,19,16,90,2,15,8,7,21,6,15,-6,-7
Patricio,453,0,110,2018-11-11T16:30:00Z,False,19,0,90,2,15,8,7,23,13,10,-8,-6
Patricio,453,0,129,2018-11-25T16:00:00Z,True,19,9,90,2,16,8,8,7,5,2,9,6
Patricio,453,0,131,2018-11-30T20:00:00Z,False,19,4,90,1,16,8,8,8,7,1,8,1
Patricio,453,0,147,2018-12-05T19:45:00Z,True,19,5,90,2,16,8,8,31,18,13,-15,-5
Patricio,453,0,158,2018-12-09T16:00:00Z,False,19,14,90,3,19,11,8,13,6,7,6,2
Patricio,453,0,169,2018-12-15T15:00:00Z,True,19,1,90,7,22,11,11,23,14,9,-1,2
Patricio,453,0,179,2018-12-21T20:00:00Z,True,19,11,90,2,25,14,11,45,22,23,-20,-9
Patricio,453,0,183,2018-12-26T12:30:00Z,False,19,8,90,3,25,14,11,10,8,2,15,3
Patricio,453,0,198,2018-12-29T15:00:00Z,False,19,16,90,2,26,14,12,45,18,27,-19,-6
Patricio,453,0,209,2019-01-02T19:45:00Z,True,19,6,90,1,29,14,15,19,9,10,10,4
Patricio,453,0,217,2019-01-14T20:00:00Z,False,19,12,90,3,29,14,15,50,30,20,-21,-15
Patricio,453,0,229,2019-01-19T12:30:00Z,True,19,10,90,2,29,14,15,31,14,17,-2,-3
Patricio,453,0,235,2019-01-29T19:45:00Z,True,19,18,90,6,32,17,15,31,17,14,1,3
Patricio,453,0,245,2019-02-02T15:00:00Z,False,19,7,90,3,35,20,15,33,21,12,2,-6
Patricio,453,0,259,2019-02-11T20:00:00Z,True,19,14,90,2,38,20,18,24,13,11,14,9
Patricio,453,0,261,2019-02-23T15:00:00Z,False,19,1,90,2,39,21,18,33,24,9,6,-6
Patricio,453,0,273,2019-02-26T19:45:00Z,False,19,9,90,2,40,21,19,11,5,6,29,14
Patricio,453,0,289,2019-03-02T15:00:00Z,True,19,4,0,0,40,21,19,25,17,8,15,13
Patricio,453,0,292,2019-03-10T14:05:00Z,False,19,5,90,3,43,24,19,56,31,25,-13,-12
Patricio,453,0,312,2019-03-30T15:00:00Z,False,19,3,90,1,44,24,20,30,17,13,14,3
Patricio,453,0,329,2019-04-02T18:45:00Z,True,19,13,90,3,44,24,20,61,32,29,-17,-5
Patricio,453,0,337,2019-04-13T14:00:00Z,False,19,15,90,2,47,27,20,33,18,15,14,2
Patricio,453,0,349,2019-04-20T14:00:00Z,True,19,2,90,6,47,27,20,33,22,11,14,16
Patricio,453,0,309,2019-04-24T18:45:00Z,True,19,0,90,2,48,28,20,66,44,22,-18,6
Patricio,453,0,359,2019-04-27T14:00:00Z,False,19,17,90,2,51,31,20,50,27,23,1,-7
Patricio,453,0,369,2019-05-04T14:00:00Z,True,19,8,90,6,54,31,23,26,21,5,28,26
Patricio,453,0,375,2019-05-12T14:00:00Z,False,19,11,90,2,57,34,23,94,50,44,-37,-27
Le Marchand,454,1,2,2018-08-11T14:00:00Z,True,8,6,90,1,0,0,0,0,0,0,0,0
Le Marchand,454,1,18,2018-08-18T14:00:00Z,False,8,16,90,2,0,0,0,3,0,3,-3,0
Le Marchand,454,1,22,2018-08-26T15:00:00Z,True,8,3,90,1,0,0,0,1,0,1,-1,-1
Le Marchand,454,1,30,2018-09-01T14:00:00Z,False,8,2,90,0,3,3,0,3,3,0,0,-3
Le Marchand,454,1,44,2018-09-15T14:00:00Z,False,8,12,0,0,4,3,1,10,6,4,-6,-5
Le Marchand,454,1,55,2018-09-22T11:30:00Z,True,8,17,0,0,4,3,1,12,9,3,-8,0
Le Marchand,454,1,64,2018-09-29T14:00:00Z,False,8,7,0,0,5,4,1,6,4,2,-1,-3
Le Marchand,454,1,73,2018-10-07T11:00:00Z,True,8,0,90,0,5,4,1,15,9,6,-10,-2
Le Marchand,454,1,82,2018-10-20T14:00:00Z,False,8,4,90,0,5,4,1,2,1,1,3,0
Le Marchand,454,1,93,2018-10-27T14:00:00Z,True,8,1,59,1,5,4,1,17,11,6,-12,-2
Le Marchand,454,1,105,2018-11-05T20:00:00Z,False,8,9,90,2,5,4,1,3,1,2,2,0
Le Marchand,454,1,116,2018-11-11T12:00:00Z,False,8,11,90,1,5,4,1,27,13,14,-22,-12
Le Marchand,454,1,124,2018-11-24T15:00:00Z,True,8,15,90,4,5,4,1,8,4,4,-3,0
Le Marchand,454,1,132,2018-12-02T12:00:00Z,False,8,5,90,1,8,7,1,28,15,13,-20,-14
Le Marchand,454,1,143,2018-12-05T19:45:00Z,True,8,10,76,2,8,7,1,21,11,10,-13,-3
Le Marchand,454,1,157,2018-12-08T15:00:00Z,False,8,13,0,0,9,8,1,23,12,11,-14,-11
Le Marchand,454,1,162,2018-12-15T17:30:00Z,True,8,18,0,0,9,8,1,21,13,8,-12,0
Le Marchand,454,1,177,2018-12-22T15:00:00Z,False,8,14,0,0,9,8,1,16,6,10,-7,-5
Le Marchand,454,1,183,2018-12-26T12:30:00Z,True,8,19,0,0,10,8,2,25,14,11,-15,-3
Le Marchand,454,1,193,2018-12-29T15:00:00Z,True,8,9,45,1,11,9,2,10,5,5,1,4
Le Marchand,454,1,200,2019-01-01T15:00:00Z,False,8,0,90,0,14,12,2,38,23,15,-24,-21
Le Marchand,454,1,211,2019-01-12T15:00:00Z,False,8,3,90,1,14,12,2,18,10,8,-4,-8
Le Marchand,454,1,222,2019-01-20T16:00:00Z,True,8,16,90,1,14,12,2,48,18,30,-34,-18
Le Marchand,454,1,232,2019-01-29T19:45:00Z,True,8,2,90,1,14,12,2,26,18,8,-12,4
Le Marchand,454,1,244,2019-02-02T15:00:00Z,False,8,6,90,0,17,15,2,23,9,14,-6,-7
Le Marchand,454,1,252,2019-02-09T12:30:00Z,True,8,13,90,1,17,15,2,48,25,23,-31,-8
Le Marchand,454,1,269,2019-02-22T19:45:00Z,False,8,18,0,0,17,15,2,33,18,15,-16,-16
Le Marchand,454,1,279,2019-02-27T19:45:00Z,False,8,15,0,0,17,15,2,24,12,12,-7,-10
Le Marchand,454,1,284,2019-03-03T14:05:00Z,True,8,5,0,0,17,15,2,53,31,22,-36,-7
Le Marchand,454,1,295,2019-03-09T15:00:00Z,False,8,10,0,0,17,15,2,35,17,18,-18,-15
Le Marchand,454,1,304,2019-03-17T14:15:00Z,True,8,11,0,0,17,15,2,73,41,32,-56,-17
Le Marchand,454,1,315,2019-03-30T12:30:00Z,True,8,12,90,0,17,15,2,74,45,29,-57,-14
Le Marchand,454,1,328,2019-04-02T18:45:00Z,False,8,17,90,0,17,15,2,43,23,20,-26,-21
Le Marchand,454,1,333,2019-04-13T14:00:00Z,True,8,7,90,5,17,15,2,46,28,18,-29,-3
Le Marchand,454,1,341,2019-04-20T14:00:00Z,False,8,1,90,6,20,18,2,41,26,15,-21,-24
Le Marchand,454,1,353,2019-04-27T14:00:00Z,True,8,4,90,6,23,18,5,31,20,11,-8,7
Le Marchand,454,1,369,2019-05-04T14:00:00Z,False,8,19,90,1,26,21,5,54,31,23,-28,-26
Le Marchand,454,1,373,2019-05-12T14:00:00Z,True,8,14,90,0,26,21,5,42,25,17,-16,4
Seri,455,2,2,2018-08-11T14:00:00Z,True,8,6,81,2,0,0,0,0,0,0,0,0
Seri,455,2,18,2018-08-18T14:00:00Z,False,8,16,90,2,0,0,0,3,0,3,-3,0
Seri,455,2,22,2018-08-26T15:00:00Z,True,8,3,90,9,0,0,0,1,0,1,-1,-1
Seri,455,2,30,2018-09-01T14:00:00Z,False,8,2,90,7,3,3,0,3,3,0,0,-3
Seri,455,2,44,2018-09-15T14:00:00Z,False,8,12,55,1,4,3,1,10,6,4,-6,-5
Seri,455,2,55,2018-09-22T11:30:00Z,True,8,17,90,4,4,3,1,12,9,3,-8,0
Seri,455,2,64,2018-09-29T14:00:00Z,False,8,7,83,2,5,4,1,6,4,2,-1,-3
Seri,455,2,73,2018-10-07T11:00:00Z,True,8,0,90,2,5,4,1,15,9,6,-10,-2
Seri,455,2,82,2018-10-20T14:00:00Z,False,8,4,57,4,5,4,1,2,1,1,3,0
Seri,455,2,93,2018-10-27T14:00:00Z,True,8,1,79,2,5,4,1,17,11,6,-12,-2
Seri,455,2,105,2018-11-05T20:00:00Z,False,8,9,90,2,5,4,1,3,1,2,2,0
Seri,455,2,116,2018-11-11T12:00:00Z,False,8,11,27,1,5,4,1,27,13,14,-22,-12
Seri,455,2,124,2018-11-24T15:00:00Z,True,8,15,67,2,5,4,1,8,4,4,-3,0
Seri,455,2,132,2018-12-02T12:00:00Z,False,8,5,90,2,8,7,1,28,15,13,-20,-14
Seri,455,2,143,2018-12-05T19:45:00Z,True,8,10,90,2,8,7,1,21,11,10,-13,-3
Seri,455,2,157,2018-12-08T15:00:00Z,False,8,13,90,1,9,8,1,23,12,11,-14,-11
Seri,455,2,162,2018-12-15T17:30:00Z,True,8,18,60,1,9,8,1,21,13,8,-12,0
Seri,455,2,177,2018-12-22T15:00:00Z,False,8,14,90,2,9,8,1,16,6,10,-7,-5
Seri,455,2,183,2018-12-26T12:30:00Z,True,8,19,81,3,10,8,2,25,14,11,-15,-3
Seri,455,2,193,2018-12-29T15:00:00Z,True,8,9,45,0,11,9,2,10,5,5,1,4
Seri,455,2,200,2019-01-01T15:00:00Z,False,8,0,29,1,14,12,2,38,23,15,-24,-21
Seri,455,2,211,2019-01-12T15:00:00Z,False,8,3,90,2,14,12,2,18,10,8,-4,-8
Seri,455,2,222,2019-01-20T16:00:00Z,True,8,16,80,4,14,12,2,48,18,30,-34,-18
Seri,455,2,232,2019-01-29T19:45:00Z,True,8,2,90,1,14,12,2,26,18,8,-12,4
Seri,455,2,244,2019-02-02T15:00:00Z,False,8,6,90,2,17,15,2,23,9,14,-6,-7
Seri,455,2,252,2019-02-09T12:30:00Z,True,8,13,90,2,17,15,2,48,25,23,-31,-8
Seri,455,2,269,2019-02-22T19:45:00Z,False,8,18,45,1,17,15,2,33,18,15,-16,-16
Seri,455,2,279,2019-02-27T19:45:00Z,False,8,15,0,0,17,15,2,24,12,12,-7,-10
Seri,455,2,284,2019-03-03T14:05:00Z,True,8,5,0,0,17,15,2,53,31,22,-36,-7
Seri,455,2,295,2019-03-09T15:00:00Z,False,8,10,23,1,17,15,2,35,17,18,-18,-15
Seri,455,2,304,2019-03-17T14:15:00Z,True,8,11,64,2,17,15,2,73,41,32,-56,-17
Seri,455,2,315,2019-03-30T12:30:00Z,True,8,12,0,0,17,15,2,74,45,29,-57,-14
Seri,455,2,328,2019-04-02T18:45:00Z,False,8,17,18,1,17,15,2,43,23,20,-26,-21
Seri,455,2,333,2019-04-13T14:00:00Z,True,8,7,7,1,17,15,2,46,28,18,-29,-3
Seri,455,2,341,2019-04-20T14:00:00Z,False,8,1,78,3,20,18,2,41,26,15,-21,-24
Seri,455,2,353,2019-04-27T14:00:00Z,True,8,4,0,0,23,18,5,31,20,11,-8,7
Seri,455,2,369,2019-05-04T14:00:00Z,False,8,19,0,0,26,21,5,54,31,23,-28,-26
Seri,455,2,373,2019-05-12T14:00:00Z,True,8,14,0,0,26,21,5,42,25,17,-16,4
Ward,456,0,5,2018-08-10T19:00:00Z,False,10,13,0,0,0,0,0,0,0,0,0,0
Ward,456,0,16,2018-08-18T14:00:00Z,True,10,19,0,0,0,0,0,1,1,0,-1,0
Ward,456,0,27,2018-08-25T14:00:00Z,False,10,15,0,0,3,3,0,1,1,0,2,-1
Ward,456,0,36,2018-09-01T11:30:00Z,True,10,11,0,0,6,3,3,9,6,3,-3,0
Ward,456,0,40,2018-09-15T14:00:00Z,False,10,1,0,0,6,3,3,7,4,3,-1,-1
Ward,456,0,56,2018-09-22T14:00:00Z,True,10,9,0,0,6,3,3,2,1,1,4,2
Ward,456,0,67,2018-09-29T14:00:00Z,False,10,14,0,0,9,6,3,2,0,2,7,3
Ward,456,0,74,2018-10-06T14:00:00Z,True,10,7,0,0,12,6,6,9,7,2,3,4
Ward,456,0,80,2018-10-22T19:00:00Z,False,10,0,0,0,12,6,6,18,9,9,-6,-3
Ward,456,0,94,2018-10-27T16:30:00Z,True,10,18,0,0,12,6,6,7,4,3,5,3
Ward,456,0,102,2018-11-03T15:00:00Z,False,10,4,0,0,13,7,6,5,4,1,8,2
Ward,456,0,115,2018-11-10T15:00:00Z,True,10,3,0,0,16,7,9,8,4,4,8,3
Ward,456,0,121,2018-11-24T15:00:00Z,False,10,2,0,0,17,8,9,14,10,4,3,-1
Ward,456,0,135,2018-12-01T15:00:00Z,True,10,17,0,0,18,8,10,20,12,8,-2,0
Ward,456,0,143,2018-12-05T19:45:00Z,False,10,8,0,0,21,11,10,8,7,1,13,3
Ward,456,0,156,2018-12-08T19:45:00Z,True,10,16,0,0,22,11,11,33,12,21,-11,-10
Ward,456,0,161,2018-12-15T15:00:00Z,False,10,6,0,0,22,11,11,12,5,7,10,6
Ward,456,0,173,2018-12-22T15:00:00Z,False,10,5,0,0,22,11,11,37,21,16,-15,-10
Ward,456,0,184,2018-12-26T15:00:00Z,True,10,12,0,0,25,11,14,44,27,17,-19,-6
Ward,456,0,194,2018-12-29T15:00:00Z,True,10,4,0,0,28,14,14,15,13,2,13,12
Ward,456,0,204,2019-01-01T12:30:00Z,False,10,7,0,0,28,14,14,27,18,9,1,-4
Ward,456,0,216,2019-01-12T15:00:00Z,True,10,15,0,0,31,14,17,16,8,8,15,6
Ward,456,0,229,2019-01-19T12:30:00Z,False,10,19,0,0,31,14,17,29,14,15,2,3
Ward,456,0,236,2019-01-30T20:00:00Z,False,10,11,0,0,31,14,17,60,31,29,-29,-14
Ward,456,0,246,2019-02-03T14:05:00Z,True,10,13,0,0,32,14,18,45,25,20,-13,-6
Ward,456,0,257,2019-02-10T13:30:00Z,False,10,16,0,0,32,14,18,57,24,33,-25,-6
Ward,456,0,266,2019-02-23T17:30:00Z,True,10,6,0,0,32,14,18,27,13,14,5,0
Ward,456,0,274,2019-02-26T19:45:00Z,True,10,2,0,0,32,14,18,27,19,8,5,6
Ward,456,0,287,2019-03-03T12:00:00Z,False,10,17,0,0,35,17,18,40,20,20,-5,-2
Ward,456,0,295,2019-03-09T15:00:00Z,True,10,8,0,0,35,17,18,17,15,2,18,15
Ward,456,0,302,2019-03-16T15:00:00Z,False,10,3,0,0,38,20,18,30,17,13,8,1
Ward,456,0,316,2019-03-30T15:00:00Z,True,10,1,0,0,41,20,21,38,26,12,3,8
Ward,456,0,323,2019-04-06T14:00:00Z,False,10,9,0,0,44,23,21,14,8,6,30,13
Ward,456,0,334,2019-04-12T19:00:00Z,True,10,14,0,0,47,23,24,35,22,13,12,10
Ward,456,0,348,2019-04-20T14:00:00Z,False,10,18,0,0,47,23,24,42,27,15,5,-3
Ward,456,0,354,2019-04-28T11:00:00Z,True,10,0,0,0,48,23,25,66,44,22,-18,1
Ward,456,0,366,2019-05-06T19:00:00Z,False,10,12,0,0,51,26,25,92,51,41,-41,-26
Ward,456,0,374,2019-05-12T14:00:00Z,True,10,5,0,0,51,26,25,71,42,29,-20,-3
Kenedy,457,2,6,2018-08-11T11:30:00Z,True,14,16,90,2,0,0,0,0,0,0,0,0
Kenedy,457,2,12,2018-08-18T11:30:00Z,False,14,4,90,1,0,0,0,0,0,0,0,0
Kenedy,457,2,26,2018-08-26T15:00:00Z,True,14,5,0,0,1,0,1,6,3,3,-5,-3
Kenedy,457,2,37,2018-09-01T16:30:00Z,False,14,12,53,1,1,0,1,7,3,4,-6,-2
Kenedy,457,2,45,2018-09-15T14:00:00Z,True,14,0,21,1,1,0,1,6,3,3,-5,-3
Kenedy,457,2,54,2018-09-22T14:00:00Z,False,14,6,90,3,1,0,1,6,0,6,-5,1
Kenedy,457,2,67,2018-09-29T14:00:00Z,True,14,10,90,2,2,0,2,9,6,3,-7,-3
Kenedy,457,2,76,2018-10-06T16:30:00Z,False,14,13,67,8,2,0,2,10,4,6,-8,-2
Kenedy,457,2,87,2018-10-20T14:00:00Z,True,14,2,90,2,2,0,2,8,7,1,-6,-1
Kenedy,457,2,97,2018-10-27T14:00:00Z,False,14,15,90,3,2,0,2,6,2,4,-4,0
Kenedy,457,2,107,2018-11-03T15:00:00Z,True,14,17,90,3,3,0,3,19,12,7,-16,-7
Kenedy,457,2,118,2018-11-10T15:00:00Z,True,14,1,77,6,6,3,3,20,11,9,-14,-6
Kenedy,457,2,122,2018-11-26T20:30:00Z,False,14,3,89,2,9,6,3,9,4,5,0,-1
Kenedy,457,2,138,2018-12-01T15:00:00Z,True,14,18,69,2,12,6,6,12,7,5,0,1
Kenedy,457,2,148,2018-12-05T19:45:00Z,False,14,7,0,0,12,6,6,22,16,6,-10,-10
Kenedy,457,2,158,2018-12-09T16:00:00Z,True,14,19,1,1,13,6,7,19,11,8,-6,-2
Kenedy,457,2,163,2018-12-15T15:00:00Z,False,14,9,88,3,13,6,7,10,5,5,3,2
Kenedy,457,2,177,2018-12-22T15:00:00Z,True,14,8,18,0,16,6,10,9,8,1,7,5
Kenedy,457,2,185,2018-12-26T15:00:00Z,False,14,11,72,2,17,7,10,48,22,26,-31,-12
Kenedy,457,2,199,2018-12-29T15:00:00Z,False,14,17,0,0,17,7,10,27,15,12,-10,-5
Kenedy,457,2,207,2019-01-02T20:00:00Z,True,14,13,21,1,18,7,11,35,21,14,-17,-7
Kenedy,457,2,213,2019-01-12T17:30:00Z,False,14,5,0,0,18,7,11,44,22,22,-26,-11
Kenedy,457,2,226,2019-01-19T15:00:00Z,True,14,4,0,0,18,7,11,19,14,5,-1,2
Kenedy,457,2,237,2019-01-29T20:00:00Z,True,14,12,3,1,21,10,11,56,33,23,-35,-13
Kenedy,457,2,248,2019-02-02T12:30:00Z,False,14,16,8,1,24,13,11,54,21,33,-30,-10
Kenedy,457,2,259,2019-02-11T20:00:00Z,False,14,19,0,0,24,13,11,38,20,18,-14,-9
Kenedy,457,2,268,2019-02-23T15:00:00Z,True,14,9,22,1,25,13,12,11,5,6,14,7
Kenedy,457,2,278,2019-02-26T20:00:00Z,True,14,3,0,0,28,16,12,30,17,13,-2,3
Kenedy,457,2,288,2019-03-02T17:30:00Z,False,14,18,0,0,31,19,12,36,21,15,-5,-9
Kenedy,457,2,298,2019-03-09T15:00:00Z,True,14,7,17,1,31,19,12,37,22,15,-6,4
Kenedy,457,2,300,2019-03-16T15:00:00Z,False,14,1,0,0,34,22,12,37,25,12,-3,-13
Kenedy,457,2,310,2019-04-01T19:00:00Z,False,14,0,15,1,35,22,13,60,41,19,-25,-28
Kenedy,457,2,325,2019-04-06T14:00:00Z,True,14,6,0,0,35,22,13,36,16,20,-1,2
Kenedy,457,2,334,2019-04-12T19:00:00Z,False,14,10,0,0,35,22,13,47,23,24,-12,-10
Kenedy,457,2,347,2019-04-20T16:30:00Z,True,14,15,0,0,38,22,16,36,21,15,2,7
Kenedy,457,2,350,2019-04-27T16:30:00Z,False,14,2,57,1,41,25,16,34,22,12,7,-6
Kenedy,457,2,367,2019-05-04T18:45:00Z,True,14,11,0,0,42,25,17,91,50,41,-49,-16
Kenedy,457,2,373,2019-05-12T14:00:00Z,False,14,8,9,1,42,25,17,26,21,5,16,-4
Jorginho,458,2,3,2018-08-11T14:00:00Z,False,5,9,90,9,0,0,0,0,0,0,0,0
Jorginho,458,2,13,2018-08-18T16:30:00Z,True,5,0,90,2,3,0,3,0,0,0,3,0
Jorginho,458,2,26,2018-08-26T15:00:00Z,False,5,14,90,2,6,3,3,1,0,1,5,3
Jorginho,458,2,33,2018-09-01T14:00:00Z,True,5,1,90,3,9,3,6,7,4,3,2,0
Jorginho,458,2,41,2018-09-15T14:00:00Z,True,5,4,90,2,12,6,6,2,1,1,10,5
Jorginho,458,2,59,2018-09-23T12:30:00Z,False,5,18,90,3,15,9,6,3,0,3,12,6
Jorginho,458,2,63,2018-09-29T16:30:00Z,True,5,11,90,2,16,9,7,18,9,9,-2,0
Jorginho,458,2,77,2018-10-07T13:15:00Z,False,5,15,90,3,17,10,7,5,2,3,12,5
Jorginho,458,2,83,2018-10-20T11:30:00Z,True,5,13,90,2,20,10,10,13,7,6,7,4
Jorginho,458,2,91,2018-10-28T13:30:00Z,False,5,3,77,3,21,11,10,8,4,4,13,6
Jorginho,458,2,103,2018-11-04T16:00:00Z,True,5,6,79,2,24,11,13,8,2,6,16,5
Jorginho,458,2,112,2018-11-11T14:15:00Z,True,5,7,63,2,27,14,13,18,13,5,9,9
Jorginho,458,2,126,2018-11-24T17:30:00Z,False,5,16,90,1,28,15,13,27,6,21,1,7
Jorginho,458,2,132,2018-12-02T12:00:00Z,True,5,8,90,3,28,15,13,8,7,1,20,14
Jorginho,458,2,147,2018-12-05T19:45:00Z,False,5,19,0,0,31,18,13,16,8,8,15,5
Jorginho,458,2,154,2018-12-08T17:30:00Z,True,5,12,90,2,31,18,13,41,24,17,-10,1
Jorginho,458,2,160,2018-12-16T13:30:00Z,False,5,2,90,2,34,21,13,21,14,7,13,-1
Jorginho,458,2,173,2018-12-22T15:00:00Z,True,5,10,74,2,37,21,16,22,11,11,15,10
Jorginho,458,2,189,2018-12-26T19:30:00Z,False,5,17,90,2,37,21,16,27,15,12,10,1
Jorginho,458,2,192,2018-12-30T12:00:00Z,False,5,6,90,3,40,21,19,19,9,10,21,10
Jorginho,458,2,203,2019-01-02T19:45:00Z,True,5,15,90,3,43,21,22,15,8,7,28,14
Jorginho,458,2,213,2019-01-12T17:30:00Z,True,5,14,90,1,44,22,22,18,7,11,26,11
Jorginho,458,2,220,2019-01-19T17:30:00Z,False,5,0,90,2,47,25,22,41,26,15,6,-4
Jorginho,458,2,231,2019-01-30T19:45:00Z,False,5,1,90,2,47,25,22,30,21,9,17,1
Jorginho,458,2,243,2019-02-02T15:00:00Z,True,5,9,69,3,47,25,22,11,5,6,36,19
Jorginho,458,2,255,2019-02-10T16:00:00Z,False,5,12,90,1,50,28,22,62,36,26,-12,-14
Jorginho,458,2,275,2019-02-27T20:00:00Z,True,5,16,90,3,50,28,22,60,27,33,-10,-5
Jorginho,458,2,284,2019-03-03T14:05:00Z,False,5,8,67,9,53,31,22,17,15,2,36,7
Jorginho,458,2,292,2019-03-10T14:05:00Z,True,5,19,71,2,56,31,25,43,24,19,13,12
Jorginho,458,2,303,2019-03-17T16:30:00Z,False,5,7,73,2,57,32,25,37,22,15,20,3
Jorginho,458,2,313,2019-03-31T13:05:00Z,False,5,4,63,1,57,32,25,28,20,8,29,5
Jorginho,458,2,264,2019-04-03T18:45:00Z,True,5,2,90,3,60,32,28,33,22,11,27,21
Jorginho,458,2,321,2019-04-08T19:00:00Z,True,5,18,90,3,63,35,28,42,27,15,21,20
Jorginho,458,2,335,2019-04-14T15:30:00Z,False,5,11,90,2,66,38,28,82,44,38,-16,-16
Jorginho,458,2,343,2019-04-22T19:00:00Z,True,5,3,90,2,66,38,28,39,23,16,27,22
Jorginho,458,2,356,2019-04-28T15:30:00Z,False,5,13,90,2,67,39,28,64,35,29,3,-7
Jorginho,458,2,363,2019-05-05T13:00:00Z,True,5,17,90,3,68,39,29,50,27,23,18,16
Jorginho,458,2,374,2019-05-12T14:00:00Z,False,5,10,90,2,71,42,29,51,26,25,20,3
Christie,459,1,2,2018-08-11T14:00:00Z,True,8,6,90,1,0,0,0,0,0,0,0,0
Christie,459,1,18,2018-08-18T14:00:00Z,False,8,16,5,1,0,0,0,3,0,3,-3,0
Christie,459,1,22,2018-08-26T15:00:00Z,True,8,3,0,0,0,0,0,1,0,1,-1,-1
Christie,459,1,30,2018-09-01T14:00:00Z,False,8,2,0,0,3,3,0,3,3,0,0,-3
Christie,459,1,44,2018-09-15T14:00:00Z,False,8,12,90,1,4,3,1,10,6,4,-6,-5
Christie,459,1,55,2018-09-22T11:30:00Z,True,8,17,0,0,4,3,1,12,9,3,-8,0
Christie,459,1,64,2018-09-29T14:00:00Z,False,8,7,82,0,5,4,1,6,4,2,-1,-3
Christie,459,1,73,2018-10-07T11:00:00Z,True,8,0,90,0,5,4,1,15,9,6,-10,-2
Christie,459,1,82,2018-10-20T14:00:00Z,False,8,4,0,0,5,4,1,2,1,1,3,0
Christie,459,1,93,2018-10-27T14:00:00Z,True,8,1,0,0,5,4,1,17,11,6,-12,-2
Christie,459,1,105,2018-11-05T20:00:00Z,False,8,9,45,1,5,4,1,3,1,2,2,0
Christie,459,1,116,2018-11-11T12:00:00Z,False,8,11,90,1,5,4,1,27,13,14,-22,-12
Christie,459,1,124,2018-11-24T15:00:00Z,True,8,15,90,1,5,4,1,8,4,4,-3,0
Christie,459,1,132,2018-12-02T12:00:00Z,False,8,5,90,1,8,7,1,28,15,13,-20,-14
Christie,459,1,143,2018-12-05T19:45:00Z,True,8,10,83,2,8,7,1,21,11,10,-13,-3
Christie,459,1,157,2018-12-08T15:00:00Z,False,8,13,0,0,9,8,1,23,12,11,-14,-11
Christie,459,1,162,2018-12-15T17:30:00Z,True,8,18,45,1,9,8,1,21,13,8,-12,0
Christie,459,1,177,2018-12-22T15:00:00Z,False,8,14,90,6,9,8,1,16,6,10,-7,-5
Christie,459,1,183,2018-12-26T12:30:00Z,True,8,19,90,1,10,8,2,25,14,11,-15,-3
Christie,459,1,193,2018-12-29T15:00:00Z,True,8,9,90,5,11,9,2,10,5,5,1,4
Christie,459,1,200,2019-01-01T15:00:00Z,False,8,0,55,0,14,12,2,38,23,15,-24,-21
Christie,459,1,211,2019-01-12T15:00:00Z,False,8,3,90,0,14,12,2,18,10,8,-4,-8
Christie,459,1,222,2019-01-20T16:00:00Z,True,8,16,90,1,14,12,2,48,18,30,-34,-18
Christie,459,1,232,2019-01-29T19:45:00Z,True,8,2,90,1,14,12,2,26,18,8,-12,4
Christie,459,1,244,2019-02-02T15:00:00Z,False,8,6,61,2,17,15,2,23,9,14,-6,-7
Christie,459,1,252,2019-02-09T12:30:00Z,True,8,13,37,1,17,15,2,48,25,23,-31,-8
Christie,459,1,269,2019-02-22T19:45:00Z,False,8,18,0,0,17,15,2,33,18,15,-16,-16
Christie,459,1,279,2019-02-27T19:45:00Z,False,8,15,0,0,17,15,2,24,12,12,-7,-10
Christie,459,1,284,2019-03-03T14:05:00Z,True,8,5,0,0,17,15,2,53,31,22,-36,-7
Christie,459,1,295,2019-03-09T15:00:00Z,False,8,10,0,0,17,15,2,35,17,18,-18,-15
Christie,459,1,304,2019-03-17T14:15:00Z,True,8,11,17,1,17,15,2,73,41,32,-56,-17
Christie,459,1,315,2019-03-30T12:30:00Z,True,8,12,90,0,17,15,2,74,45,29,-57,-14
Christie,459,1,328,2019-04-02T18:45:00Z,False,8,17,90,-1,17,15,2,43,23,20,-26,-21
Christie,459,1,333,2019-04-13T14:00:00Z,True,8,7,24,1,17,15,2,46,28,18,-29,-3
Christie,459,1,341,2019-04-20T14:00:00Z,False,8,1,11,1,20,18,2,41,26,15,-21,-24
Christie,459,1,353,2019-04-27T14:00:00Z,True,8,4,62,11,23,18,5,31,20,11,-8,7
Christie,459,1,369,2019-05-04T14:00:00Z,False,8,19,90,1,26,21,5,54,31,23,-28,-26
Christie,459,1,373,2019-05-12T14:00:00Z,True,8,14,64,1,26,21,5,42,25,17,-16,4
Durm,460,1,3,2018-08-11T14:00:00Z,True,9,5,0,0,0,0,0,0,0,0,0,0
Durm,460,1,17,2018-08-19T12:30:00Z,False,9,12,0,0,0,0,0,3,0,3,-3,0
Durm,460,1,23,2018-08-25T14:00:00Z,True,9,4,0,0,0,0,0,1,1,0,-1,0
Durm,460,1,35,2018-09-01T14:00:00Z,False,9,7,14,1,1,1,0,5,3,2,-4,-3
Durm,460,1,43,2018-09-15T14:00:00Z,True,9,6,0,0,2,1,1,3,0,3,-1,-2
Durm,460,1,56,2018-09-22T14:00:00Z,False,9,10,90,1,2,1,1,6,3,3,-4,-2
Durm,460,1,65,2018-09-29T14:00:00Z,True,9,16,90,1,2,1,1,12,3,9,-10,-8
Durm,460,1,71,2018-10-06T14:00:00Z,False,9,3,90,2,2,1,1,7,3,4,-5,-2
Durm,460,1,85,2018-10-20T16:30:00Z,True,9,11,90,2,3,1,2,20,10,10,-17,-9
Durm,460,1,99,2018-10-27T14:00:00Z,False,9,17,90,1,3,1,2,16,9,7,-13,-7
Durm,460,1,105,2018-11-05T20:00:00Z,True,9,8,0,0,3,1,2,5,4,1,-2,0
Durm,460,1,114,2018-11-10T15:00:00Z,True,9,18,45,1,6,4,2,11,7,4,-5,0
Durm,460,1,129,2018-11-25T16:00:00Z,False,9,19,90,11,7,5,2,16,8,8,-9,-6
Durm,460,1,134,2018-12-01T15:00:00Z,True,9,2,90,1,10,5,5,15,11,4,-5,1
Durm,460,1,140,2018-12-04T19:45:00Z,False,9,1,90,1,10,5,5,20,11,9,-10,-6
Durm,460,1,150,2018-12-08T15:00:00Z,False,9,0,20,1,10,5,5,31,17,14,-21,-12
Durm,460,1,163,2018-12-15T15:00:00Z,True,9,14,30,1,10,5,5,13,6,7,-3,-2
Durm,460,1,175,2018-12-22T15:00:00Z,True,9,15,45,1,10,5,5,12,8,4,-2,1
Durm,460,1,186,2018-12-26T15:00:00Z,False,9,13,90,1,10,5,5,29,15,14,-19,-10
Durm,460,1,193,2018-12-29T15:00:00Z,False,9,8,90,2,10,5,5,11,9,2,-1,-4
Durm,460,1,205,2019-01-02T19:45:00Z,True,9,3,38,1,10,5,5,15,10,5,-5,0
Durm,460,1,212,2019-01-12T15:00:00Z,False,9,4,90,6,10,5,5,18,13,5,-8,-8
Durm,460,1,223,2019-01-20T13:30:00Z,True,9,12,0,0,11,5,6,53,33,20,-42,-15
Durm,460,1,233,2019-01-29T19:45:00Z,True,9,7,0,0,11,5,6,30,21,9,-19,-4
Durm,460,1,243,2019-02-02T15:00:00Z,False,9,5,0,0,11,5,6,47,25,22,-36,-19
Durm,460,1,253,2019-02-09T15:00:00Z,True,9,0,34,1,11,5,6,47,32,15,-36,-10
Durm,460,1,268,2019-02-23T15:00:00Z,False,9,14,0,0,11,5,6,25,13,12,-14,-7
Durm,460,1,273,2019-02-26T19:45:00Z,True,9,19,90,6,11,5,6,40,21,19,-29,-14
Durm,460,1,281,2019-03-02T15:00:00Z,False,9,2,90,2,14,8,6,27,19,8,-13,-13
Durm,460,1,294,2019-03-09T15:00:00Z,True,9,1,90,1,14,8,6,34,25,9,-20,-1
Durm,460,1,308,2019-03-16T15:00:00Z,False,9,18,90,0,14,8,6,39,24,15,-25,-18
Durm,460,1,314,2019-03-30T15:00:00Z,False,9,6,90,1,14,8,6,33,13,20,-19,-7
Durm,460,1,323,2019-04-06T14:00:00Z,True,9,10,90,0,14,8,6,44,23,21,-30,-13
Durm,460,1,338,2019-04-13T11:30:00Z,False,9,16,68,1,14,8,6,64,31,33,-50,-25
Durm,460,1,345,2019-04-20T14:00:00Z,True,9,17,90,1,14,8,6,46,26,20,-32,-12
Durm,460,1,355,2019-04-26T19:00:00Z,False,9,11,90,0,14,8,6,88,47,41,-74,-41
Durm,460,1,365,2019-05-05T13:00:00Z,True,9,13,45,1,14,8,6,65,36,29,-51,-21
Durm,460,1,377,2019-05-12T14:00:00Z,False,9,15,0,0,15,9,6,38,22,16,-23,-16
Shaqiri,461,2,4,2018-08-12T12:30:00Z,True,11,18,8,1,0,0,0,0,0,0,0,0
Shaqiri,461,2,14,2018-08-20T19:00:00Z,False,11,6,0,0,3,3,0,3,0,3,0,0
Shaqiri,461,2,24,2018-08-25T16:30:00Z,True,11,2,0,0,6,3,3,3,3,0,3,3
Shaqiri,461,2,36,2018-09-01T11:30:00Z,False,11,10,19,1,9,6,3,6,3,3,3,0
Shaqiri,461,2,47,2018-09-15T11:30:00Z,False,11,16,0,0,12,6,6,9,3,6,3,3
Shaqiri,461,2,57,2018-09-22T14:00:00Z,True,11,15,45,7,15,6,9,5,2,3,10,3
Shaqiri,461,2,63,2018-09-29T16:30:00Z,False,11,5,24,4,18,9,9,16,9,7,2,0
Shaqiri,461,2,75,2018-10-07T15:30:00Z,True,11,12,0,0,19,9,10,19,12,7,0,2
Shaqiri,461,2,85,2018-10-20T16:30:00Z,False,11,9,90,6,20,10,10,3,1,2,17,9
Shaqiri,461,2,95,2018-10-27T14:00:00Z,True,11,4,29,6,23,10,13,5,4,1,18,9
Shaqiri,461,2,100,2018-11-03T17:30:00Z,False,11,0,10,1,26,13,13,22,12,10,4,1
Shaqiri,461,2,116,2018-11-11T12:00:00Z,True,11,8,80,8,27,13,14,5,4,1,22,12
Shaqiri,461,2,127,2018-11-24T15:00:00Z,False,11,17,73,3,30,16,14,20,12,8,10,2
Shaqiri,461,2,136,2018-12-02T16:15:00Z,True,11,7,70,2,33,16,17,22,16,6,11,10
Shaqiri,461,2,142,2018-12-05T19:45:00Z,False,11,3,90,8,36,19,17,9,4,5,27,13
Shaqiri,461,2,151,2018-12-08T12:30:00Z,False,11,1,64,3,39,19,20,23,14,9,16,6
Shaqiri,461,2,164,2018-12-16T16:00:00Z,True,11,13,20,14,42,19,23,26,15,11,16,8
Shaqiri,461,2,179,2018-12-21T20:00:00Z,False,11,19,0,0,45,22,23,25,14,11,20,9
Shaqiri,461,2,185,2018-12-26T15:00:00Z,True,11,14,90,8,48,22,26,17,7,10,31,12
Shaqiri,461,2,195,2018-12-29T17:30:00Z,True,11,0,90,2,51,25,26,38,23,15,13,10
Shaqiri,461,2,206,2019-01-03T20:00:00Z,False,11,12,13,1,54,28,26,47,27,20,7,-1
Shaqiri,461,2,210,2019-01-12T15:00:00Z,False,11,2,71,3,54,28,26,26,18,8,28,8
Shaqiri,461,2,224,2019-01-19T15:00:00Z,True,11,6,19,1,57,28,29,22,9,13,35,15
Shaqiri,461,2,236,2019-01-30T20:00:00Z,True,11,10,66,2,60,31,29,31,14,17,29,14
Shaqiri,461,2,249,2019-02-04T20:00:00Z,False,11,18,21,1,61,32,29,31,17,14,30,12
Shaqiri,461,2,254,2019-02-09T15:00:00Z,True,11,1,0,0,62,32,30,33,24,9,29,23
Shaqiri,461,2,267,2019-02-24T14:05:00Z,False,11,13,18,0,65,35,30,51,25,26,14,5
Shaqiri,461,2,276,2019-02-27T20:00:00Z,True,11,17,0,0,66,35,31,40,20,20,26,15
Shaqiri,461,2,283,2019-03-03T16:15:00Z,False,11,7,0,0,69,38,31,36,21,15,33,10
Shaqiri,461,2,296,2019-03-10T12:00:00Z,True,11,3,0,0,70,38,32,30,17,13,40,25
Shaqiri,461,2,304,2019-03-17T14:15:00Z,False,11,8,0,0,73,41,32,17,15,2,56,17
Shaqiri,461,2,317,2019-03-31T15:30:00Z,True,11,16,0,0,76,41,35,61,28,33,15,8
Shaqiri,461,2,326,2019-04-05T19:00:00Z,False,11,15,0,0,79,44,35,33,18,15,46,17
Shaqiri,461,2,335,2019-04-14T15:30:00Z,True,11,5,1,1,82,44,38,66,38,28,16,16
Shaqiri,461,2,342,2019-04-21T15:00:00Z,False,11,4,0,0,85,47,38,31,20,11,54,18
Shaqiri,461,2,355,2019-04-26T19:00:00Z,True,11,9,17,1,88,47,41,14,8,6,74,41
Shaqiri,461,2,367,2019-05-04T18:45:00Z,False,11,14,24,4,91,50,41,42,25,17,49,16
Shaqiri,461,2,375,2019-05-12T14:00:00Z,True,11,19,0,0,94,50,44,57,34,23,37,27
Vestergaard,462,1,7,2018-08-12T12:30:00Z,True,15,3,90,6,0,0,0,0,0,0,0,0
Vestergaard,462,1,15,2018-08-18T14:00:00Z,False,15,7,0,0,1,1,0,1,0,1,0,0
Vestergaard,462,1,27,2018-08-25T14:00:00Z,True,15,10,90,1,1,1,0,3,3,0,-2,1
Vestergaard,462,1,34,2018-09-01T14:00:00Z,False,15,6,90,5,1,1,0,3,0,3,-2,0
Vestergaard,462,1,46,2018-09-17T19:00:00Z,True,15,2,90,1,4,1,3,4,4,0,0,1
Vestergaard,462,1,57,2018-09-22T14:00:00Z,False,15,11,90,1,5,2,3,15,6,9,-10,-3
Vestergaard,462,1,69,2018-09-29T14:00:00Z,False,15,19,90,1,5,2,3,9,5,4,-4,-2
Vestergaard,462,1,77,2018-10-07T13:15:00Z,True,15,5,0,0,5,2,3,17,10,7,-12,-5
Vestergaard,462,1,81,2018-10-20T14:00:00Z,False,15,1,0,0,5,2,3,16,10,6,-11,-7
Vestergaard,462,1,97,2018-10-27T14:00:00Z,True,15,14,0,0,6,2,4,2,0,2,4,0
Vestergaard,462,1,106,2018-11-04T15:00:00Z,False,15,12,0,0,7,3,4,26,15,11,-19,-11
Vestergaard,462,1,119,2018-11-10T15:00:00Z,True,15,17,0,0,7,3,4,19,12,7,-12,-4
Vestergaard,462,1,124,2018-11-24T15:00:00Z,False,15,8,0,0,8,4,4,5,4,1,3,0
Vestergaard,462,1,139,2018-12-01T17:30:00Z,True,15,13,90,0,8,4,4,21,11,10,-13,-6
Vestergaard,462,1,149,2018-12-05T20:00:00Z,False,15,16,0,0,9,5,4,30,9,21,-21,-5
Vestergaard,462,1,153,2018-12-08T15:00:00Z,False,15,4,90,2,9,5,4,11,10,1,-2,-6
Vestergaard,462,1,166,2018-12-16T13:30:00Z,True,15,0,90,1,9,5,4,34,20,14,-25,-9
Vestergaard,462,1,175,2018-12-22T15:00:00Z,False,15,9,90,2,12,8,4,10,5,5,2,-1
Vestergaard,462,1,187,2018-12-27T19:45:00Z,True,15,18,90,1,15,8,7,24,13,11,-9,-3
Vestergaard,462,1,197,2018-12-30T14:15:00Z,True,15,12,0,0,15,8,7,44,27,17,-29,-9
Vestergaard,462,1,203,2019-01-02T19:45:00Z,False,15,5,90,6,15,8,7,43,21,22,-28,-14
Vestergaard,462,1,216,2019-01-12T15:00:00Z,False,15,10,90,2,16,8,8,31,14,17,-15,-6
Vestergaard,462,1,227,2019-01-19T15:00:00Z,True,15,7,90,2,19,8,11,30,21,9,-11,-1
Vestergaard,462,1,238,2019-01-30T19:45:00Z,True,15,6,74,2,22,11,11,22,9,13,0,-2
Vestergaard,462,1,241,2019-02-02T15:00:00Z,False,15,3,90,2,23,12,11,23,13,10,0,-2
Vestergaard,462,1,256,2019-02-09T15:00:00Z,True,15,4,71,2,24,12,12,22,17,5,2,7
Vestergaard,462,1,260,2019-02-24T14:05:00Z,False,15,0,90,1,24,12,12,50,32,18,-26,-20
Vestergaard,462,1,279,2019-02-27T19:45:00Z,True,15,8,90,6,24,12,12,17,15,2,7,10
Vestergaard,462,1,285,2019-03-02T15:00:00Z,False,15,13,90,1,27,15,12,55,26,29,-28,-14
Vestergaard,462,1,299,2019-03-09T15:00:00Z,True,15,16,90,2,27,15,12,61,28,33,-34,-18
Vestergaard,462,1,311,2019-03-30T15:00:00Z,False,15,2,0,0,30,18,12,33,22,11,-3,-10
Vestergaard,462,1,326,2019-04-05T19:00:00Z,True,15,11,82,1,33,18,15,79,44,35,-46,-17
Vestergaard,462,1,337,2019-04-13T14:00:00Z,True,15,19,90,2,33,18,15,47,27,20,-14,-2
Vestergaard,462,1,347,2019-04-20T16:30:00Z,False,15,14,0,0,36,21,15,38,22,16,-2,-7
Vestergaard,462,1,307,2019-04-23T18:45:00Z,False,15,17,0,0,36,21,15,49,26,23,-13,-11
Vestergaard,462,1,357,2019-04-27T14:00:00Z,True,15,1,0,0,37,21,16,41,26,15,-4,6
Vestergaard,462,1,368,2019-05-04T14:00:00Z,False,15,18,0,0,38,22,16,46,28,18,-8,-12
Vestergaard,462,1,377,2019-05-12T14:00:00Z,True,15,9,0,0,38,22,16,15,9,6,23,16
Balbuena,463,1,4,2018-08-12T12:30:00Z,False,18,11,90,-1,0,0,0,0,0,0,0,0
Balbuena,463,1,19,2018-08-18T14:00:00Z,True,18,1,90,1,0,0,0,3,3,0,-3,0
Balbuena,463,1,20,2018-08-25T14:00:00Z,False,18,0,90,1,0,0,0,0,0,0,0,0
Balbuena,463,1,39,2018-09-01T14:00:00Z,True,18,19,90,2,0,0,0,2,2,0,-2,0
Balbuena,463,1,42,2018-09-16T15:00:00Z,False,18,7,90,2,0,0,0,6,4,2,-6,-4
Balbuena,463,1,59,2018-09-23T12:30:00Z,True,18,5,90,8,3,0,3,15,9,6,-12,-6
Balbuena,463,1,68,2018-09-29T11:30:00Z,True,18,13,90,2,4,1,3,10,4,6,-6,-5
Balbuena,463,1,70,2018-10-05T19:00:00Z,False,18,2,90,2,7,4,3,5,4,1,2,-1
Balbuena,463,1,88,2018-10-20T14:00:00Z,True,18,16,90,2,7,4,3,18,6,12,-11,-8
Balbuena,463,1,94,2018-10-27T16:30:00Z,False,18,10,90,9,7,4,3,12,6,6,-5,-3
Balbuena,463,1,108,2018-11-03T15:00:00Z,True,18,3,90,1,8,4,4,8,4,4,0,0
Balbuena,463,1,114,2018-11-10T15:00:00Z,False,18,9,90,2,11,7,4,6,4,2,5,0
Balbuena,463,1,128,2018-11-24T15:00:00Z,True,18,12,90,0,12,7,5,32,21,11,-20,-4
Balbuena,463,1,138,2018-12-01T15:00:00Z,False,18,14,90,6,12,7,5,12,6,6,0,-1
Balbuena,463,1,146,2018-12-04T19:45:00Z,True,18,4,0,0,15,7,8,11,10,1,4,6
Balbuena,463,1,159,2018-12-08T15:00:00Z,True,18,6,90,1,18,10,8,12,5,7,6,3
Balbuena,463,1,162,2018-12-15T17:30:00Z,False,18,8,90,6,21,13,8,9,8,1,12,0
Balbuena,463,1,178,2018-12-22T15:00:00Z,True,18,17,33,0,24,13,11,24,15,9,0,4
Balbuena,463,1,187,2018-12-27T19:45:00Z,False,18,15,0,0,24,13,11,15,8,7,9,3
Balbuena,463,1,191,2018-12-30T14:15:00Z,False,18,3,0,0,27,13,14,12,7,5,15,7
Balbuena,463,1,208,2019-01-02T19:45:00Z,True,18,2,0,0,27,13,14,25,18,7,2,6
Balbuena,463,1,219,2019-01-12T12:30:00Z,True,18,0,0,0,28,14,14,41,26,15,-13,-1
Balbuena,463,1,221,2019-01-19T15:00:00Z,False,18,1,0,0,31,17,14,27,18,9,4,-4
Balbuena,463,1,235,2019-01-29T19:45:00Z,False,18,19,0,0,31,17,14,32,17,15,-1,-3
Balbuena,463,1,249,2019-02-04T20:00:00Z,True,18,11,0,0,31,17,14,61,32,29,-30,-12
Balbuena,463,1,251,2019-02-09T15:00:00Z,False,18,6,0,0,32,18,14,26,12,14,6,2
Balbuena,463,1,269,2019-02-22T19:45:00Z,True,18,8,0,0,33,18,15,17,15,2,16,16
Balbuena,463,1,277,2019-02-27T20:00:00Z,False,18,12,0,0,36,21,15,65,39,26,-29,-24
Balbuena,463,1,288,2019-03-02T17:30:00Z,True,18,14,0,0,36,21,15,31,19,12,5,9
Balbuena,463,1,291,2019-03-09T15:00:00Z,False,18,4,0,0,39,24,15,25,17,8,14,-2
Balbuena,463,1,308,2019-03-16T15:00:00Z,True,18,9,0,0,39,24,15,14,8,6,25,18
Balbuena,463,1,319,2019-03-30T17:30:00Z,True,18,7,0,0,42,27,15,40,25,15,2,12
Balbuena,463,1,321,2019-04-08T19:00:00Z,False,18,5,90,1,42,27,15,63,35,28,-21,-20
Balbuena,463,1,336,2019-04-13T16:30:00Z,False,18,13,90,1,42,27,15,61,32,29,-19,-17
Balbuena,463,1,348,2019-04-20T14:00:00Z,True,18,10,90,1,42,27,15,47,23,24,-5,3
Balbuena,463,1,358,2019-04-27T11:30:00Z,False,18,16,90,6,43,28,15,70,37,33,-27,-22
Balbuena,463,1,368,2019-05-04T14:00:00Z,True,18,15,90,6,46,28,18,38,22,16,8,12
Balbuena,463,1,379,2019-05-12T14:00:00Z,False,18,17,90,2,49,31,18,50,27,23,-1,-9
Felipe Anderson,464,2,4,2018-08-12T12:30:00Z,False,18,11,61,2,0,0,0,0,0,0,0,0
Felipe Anderson,464,2,19,2018-08-18T14:00:00Z,True,18,1,90,1,0,0,0,3,3,0,-3,0
Felipe Anderson,464,2,20,2018-08-25T14:00:00Z,False,18,0,90,5,0,0,0,0,0,0,0,0
Felipe Anderson,464,2,39,2018-09-01T14:00:00Z,True,18,19,90,2,0,0,0,2,2,0,-2,0
Felipe Anderson,464,2,42,2018-09-16T15:00:00Z,False,18,7,90,2,0,0,0,6,4,2,-6,-4
Felipe Anderson,464,2,59,2018-09-23T12:30:00Z,True,18,5,73,2,3,0,3,15,9,6,-12,-6
Felipe Anderson,464,2,68,2018-09-29T11:30:00Z,True,18,13,90,10,4,1,3,10,4,6,-6,-5
Felipe Anderson,464,2,70,2018-10-05T19:00:00Z,False,18,2,90,2,7,4,3,5,4,1,2,-1
Felipe Anderson,464,2,88,2018-10-20T14:00:00Z,True,18,16,56,1,7,4,3,18,6,12,-11,-8
Felipe Anderson,464,2,94,2018-10-27T16:30:00Z,False,18,10,80,3,7,4,3,12,6,6,-5,-3
Felipe Anderson,464,2,108,2018-11-03T15:00:00Z,True,18,3,90,13,8,4,4,8,4,4,0,0
Felipe Anderson,464,2,114,2018-11-10T15:00:00Z,False,18,9,90,9,11,7,4,6,4,2,5,0
Felipe Anderson,464,2,128,2018-11-24T15:00:00Z,True,18,12,67,2,12,7,5,32,21,11,-20,-4
Felipe Anderson,464,2,138,2018-12-01T15:00:00Z,False,18,14,90,10,12,7,5,12,6,6,0,-1
Felipe Anderson,464,2,146,2018-12-04T19:45:00Z,True,18,4,90,2,15,7,8,11,10,1,4,6
Felipe Anderson,464,2,159,2018-12-08T15:00:00Z,True,18,6,83,12,18,10,8,12,5,7,6,3
Felipe Anderson,464,2,162,2018-12-15T17:30:00Z,False,18,8,90,6,21,13,8,9,8,1,12,0
Felipe Anderson,464,2,178,2018-12-22T15:00:00Z,True,18,17,90,2,24,13,11,24,15,9,0,4
Felipe Anderson,464,2,187,2018-12-27T19:45:00Z,False,18,15,90,15,24,13,11,15,8,7,9,3
Felipe Anderson,464,2,191,2018-12-30T14:15:00Z,False,18,3,90,2,27,13,14,12,7,5,15,7
Felipe Anderson,464,2,208,2019-01-02T19:45:00Z,True,18,2,90,2,27,13,14,25,18,7,2,6
Felipe Anderson,464,2,219,2019-01-12T12:30:00Z,True,18,0,90,3,28,14,14,41,26,15,-13,-1
Felipe Anderson,464,2,221,2019-01-19T15:00:00Z,False,18,1,90,2,31,17,14,27,18,9,4,-4
Felipe Anderson,464,2,235,2019-01-29T19:45:00Z,False,18,19,90,2,31,17,14,32,17,15,-1,-3
Felipe Anderson,464,2,249,2019-02-04T20:00:00Z,True,18,11,90,8,31,17,14,61,32,29,-30,-12
Felipe Anderson,464,2,251,2019-02-09T15:00:00Z,False,18,6,90,2,32,18,14,26,12,14,6,2
Felipe Anderson,464,2,269,2019-02-22T19:45:00Z,True,18,8,75,2,33,18,15,17,15,2,16,16
Felipe Anderson,464,2,277,2019-02-27T20:00:00Z,False,18,12,75,2,36,21,15,65,39,26,-29,-24
Felipe Anderson,464,2,288,2019-03-02T17:30:00Z,True,18,14,90,3,36,21,15,31,19,12,5,9
Felipe Anderson,464,2,291,2019-03-09T15:00:00Z,False,18,4,45,1,39,24,15,25,17,8,14,-2
Felipe Anderson,464,2,308,2019-03-16T15:00:00Z,True,18,9,90,5,39,24,15,14,8,6,25,18
Felipe Anderson,464,2,319,2019-03-30T17:30:00Z,True,18,7,0,0,42,27,15,40,25,15,2,12
Felipe Anderson,464,2,321,2019-04-08T19:00:00Z,False,18,5,90,2,42,27,15,63,35,28,-21,-20
Felipe Anderson,464,2,336,2019-04-13T16:30:00Z,False,18,13,90,8,42,27,15,61,32,29,-19,-17
Felipe Anderson,464,2,348,2019-04-20T14:00:00Z,True,18,10,90,2,42,27,15,47,23,24,-5,3
Felipe Anderson,464,2,358,2019-04-27T11:30:00Z,False,18,16,90,3,43,28,15,70,37,33,-27,-22
Felipe Anderson,464,2,368,2019-05-04T14:00:00Z,True,18,15,0,0,46,28,18,38,22,16,8,12
Felipe Anderson,464,2,379,2019-05-12T14:00:00Z,False,18,17,90,5,49,31,18,50,27,23,-1,-9
Bissouma,465,2,8,2018-08-11T14:00:00Z,False,2,17,30,1,0,0,0,0,0,0,0,0
Bissouma,465,2,10,2018-08-19T15:00:00Z,True,2,13,0,0,0,0,0,3,3,0,-3,0
Bissouma,465,2,24,2018-08-25T16:30:00Z,False,2,11,79,2,3,3,0,6,3,3,-3,-3
Bissouma,465,2,30,2018-09-01T14:00:00Z,True,2,8,30,1,3,3,0,3,3,0,0,3
Bissouma,465,2,46,2018-09-17T19:00:00Z,False,2,15,75,2,4,4,0,4,1,3,0,-1
Bissouma,465,2,51,2018-09-22T16:30:00Z,True,2,16,78,1,5,4,1,9,3,6,-4,-2
Bissouma,465,2,66,2018-09-29T14:00:00Z,False,2,12,90,2,5,4,1,16,9,7,-11,-8
Bissouma,465,2,70,2018-10-05T19:00:00Z,True,2,18,10,1,5,4,1,7,4,3,-2,1
Bissouma,465,2,87,2018-10-20T14:00:00Z,False,2,14,10,1,8,7,1,2,0,2,6,1
Bissouma,465,2,90,2018-10-27T14:00:00Z,True,2,19,19,1,11,7,4,15,8,7,-4,0
Bissouma,465,2,104,2018-11-03T15:00:00Z,False,2,7,20,1,14,10,4,15,10,5,-1,-6
Bissouma,465,2,111,2018-11-10T12:30:00Z,False,2,4,51,0,14,10,4,5,4,1,9,0
Bissouma,465,2,121,2018-11-24T15:00:00Z,True,2,10,0,0,14,10,4,17,8,9,-3,1
Bissouma,465,2,134,2018-12-01T15:00:00Z,False,2,9,90,2,15,11,4,10,5,5,5,-1
Bissouma,465,2,141,2018-12-04T19:45:00Z,True,2,6,90,1,18,11,7,12,5,7,6,4
Bissouma,465,2,152,2018-12-08T15:00:00Z,False,2,3,90,2,21,14,7,9,4,5,12,3
Bissouma,465,2,160,2018-12-16T13:30:00Z,True,2,5,9,1,21,14,7,34,21,13,-13,1
Bissouma,465,2,171,2018-12-22T15:00:00Z,False,2,1,90,2,21,14,7,23,14,9,-2,-7
Bissouma,465,2,180,2018-12-26T17:15:00Z,True,2,0,0,0,21,14,7,37,23,14,-16,0
Bissouma,465,2,190,2018-12-29T15:00:00Z,True,2,7,0,0,22,15,7,27,18,9,-5,6
Bissouma,465,2,208,2019-01-02T19:45:00Z,False,2,18,0,0,25,18,7,27,13,14,-2,-6
Bissouma,465,2,210,2019-01-12T15:00:00Z,True,2,11,0,0,26,18,8,54,28,26,-28,-8
Bissouma,465,2,225,2019-01-19T15:00:00Z,False,2,13,0,0,26,18,8,41,21,20,-15,-13
Bissouma,465,2,232,2019-01-29T19:45:00Z,False,2,8,0,0,26,18,8,14,12,2,12,-4
Bissouma,465,2,240,2019-02-02T15:00:00Z,True,2,17,90,3,26,18,8,33,17,16,-7,2
Bissouma,465,2,250,2019-02-09T17:30:00Z,True,2,3,24,1,27,19,8,24,14,10,3,9
Bissouma,465,2,274,2019-02-26T19:45:00Z,False,2,10,39,1,27,19,8,32,14,18,-5,-6
Bissouma,465,2,281,2019-03-02T15:00:00Z,True,2,9,84,3,27,19,8,14,8,6,13,13
Bissouma,465,2,293,2019-03-09T12:30:00Z,False,2,6,90,2,30,22,8,33,13,20,-3,-5
Bissouma,465,2,311,2019-03-30T15:00:00Z,True,2,15,90,2,33,22,11,30,18,12,3,10
Bissouma,465,2,264,2019-04-03T18:45:00Z,False,2,5,90,2,33,22,11,60,32,28,-27,-21
Bissouma,465,2,330,2019-04-13T14:00:00Z,True,2,1,90,1,33,22,11,38,26,12,-5,10
Bissouma,465,2,301,2019-04-16T18:45:00Z,True,2,4,0,0,33,22,11,28,20,8,5,14
Bissouma,465,2,349,2019-04-20T14:00:00Z,False,2,19,0,0,33,22,11,47,27,20,-14,-16
Bissouma,465,2,327,2019-04-23T18:45:00Z,False,2,16,85,3,34,22,12,67,34,33,-33,-22
Bissouma,465,2,350,2019-04-27T16:30:00Z,True,2,14,41,0,34,22,12,41,25,16,-7,6
Bissouma,465,2,360,2019-05-05T15:30:00Z,False,2,0,90,2,35,23,12,66,44,22,-31,-32
Bissouma,465,2,370,2019-05-12T14:00:00Z,True,2,12,90,2,36,23,13,95,54,41,-59,-18
Cunningham,466,1,1,2018-08-11T14:00:00Z,False,4,1,0,0,0,0,0,0,0,0,0,0
Cunningham,466,1,12,2018-08-18T11:30:00Z,True,4,14,0,0,0,0,0,0,0,0,0,0
Cunningham,466,1,23,2018-08-25T14:00:00Z,False,4,9,0,0,1,1,0,0,0,0,1,0
Cunningham,466,1,32,2018-09-02T12:30:00Z,True,4,0,0,0,2,1,1,3,3,0,-1,1
Cunningham,466,1,41,2018-09-15T14:00:00Z,False,4,5,0,0,2,1,1,12,6,6,-10,-5
Cunningham,466,1,53,2018-09-22T14:00:00Z,True,4,12,90,0,2,1,1,13,9,4,-11,-3
Cunningham,466,1,62,2018-09-30T15:00:00Z,True,4,3,90,0,2,1,1,4,3,1,-2,0
Cunningham,466,1,78,2018-10-06T14:00:00Z,False,4,16,0,0,2,1,1,15,3,12,-13,-2
Cunningham,466,1,82,2018-10-20T14:00:00Z,True,4,8,0,0,2,1,1,5,4,1,-3,0
Cunningham,466,1,95,2018-10-27T14:00:00Z,False,4,11,0,0,5,4,1,23,10,13,-18,-9
Cunningham,466,1,102,2018-11-03T15:00:00Z,True,4,10,0,0,5,4,1,13,7,6,-8,-2
Cunningham,466,1,111,2018-11-10T12:30:00Z,True,4,2,90,1,5,4,1,14,10,4,-9,0
Cunningham,466,1,123,2018-11-24T15:00:00Z,False,4,7,90,2,8,7,1,19,13,6,-11,-12
Cunningham,466,1,131,2018-11-30T20:00:00Z,True,4,19,0,0,8,7,1,16,8,8,-8,-1
Cunningham,466,1,146,2018-12-04T19:45:00Z,False,4,18,0,0,11,10,1,15,7,8,-4,-6
Cunningham,466,1,153,2018-12-08T15:00:00Z,True,4,15,0,0,11,10,1,9,5,4,2,6
Cunningham,466,1,168,2018-12-15T15:00:00Z,False,4,17,0,0,14,13,1,21,12,9,-7,-11
Cunningham,466,1,172,2018-12-22T17:30:00Z,True,4,13,90,-1,14,13,1,26,15,11,-12,2
Cunningham,466,1,182,2018-12-26T15:00:00Z,False,4,6,0,0,14,13,1,18,8,10,-4,-7
Cunningham,466,1,194,2018-12-29T15:00:00Z,False,4,10,90,6,15,13,2,28,14,14,-13,-12
Cunningham,466,1,202,2019-01-01T17:30:00Z,True,4,16,90,1,18,13,5,45,18,27,-27,-14
Cunningham,466,1,212,2019-01-12T15:00:00Z,True,4,9,0,0,18,13,5,10,5,5,8,8
Cunningham,466,1,226,2019-01-19T15:00:00Z,False,4,14,0,0,19,14,5,18,7,11,1,-2
Cunningham,466,1,230,2019-01-29T19:45:00Z,False,4,0,0,0,19,14,5,44,29,15,-25,-24
Cunningham,466,1,242,2019-02-02T17:30:00Z,True,4,1,0,0,19,14,5,33,24,9,-14,5
Cunningham,466,1,256,2019-02-09T15:00:00Z,False,4,15,0,0,22,17,5,24,12,12,-2,-7
Cunningham,466,1,263,2019-02-22T19:45:00Z,True,4,17,0,0,25,17,8,37,20,17,-12,0
Cunningham,466,1,271,2019-02-26T19:45:00Z,True,4,7,0,0,25,17,8,33,21,12,-8,5
Cunningham,466,1,289,2019-03-02T15:00:00Z,False,4,19,0,0,25,17,8,40,21,19,-15,-13
Cunningham,466,1,291,2019-03-09T15:00:00Z,True,4,18,0,0,25,17,8,39,24,15,-14,2
Cunningham,466,1,313,2019-03-31T13:05:00Z,True,4,5,0,0,28,20,8,57,32,25,-29,-5
Cunningham,466,1,324,2019-04-03T18:45:00Z,False,4,12,0,0,28,20,8,77,45,32,-49,-37
Cunningham,466,1,331,2019-04-13T14:00:00Z,False,4,3,0,0,28,20,8,36,20,16,-8,-12
Cunningham,466,1,301,2019-04-16T18:45:00Z,False,4,2,0,0,28,20,8,33,22,11,-5,-14
Cunningham,466,1,342,2019-04-21T15:00:00Z,True,4,11,0,0,31,20,11,85,47,38,-54,-18
Cunningham,466,1,353,2019-04-27T14:00:00Z,False,4,8,0,0,31,20,11,23,18,5,8,-7
Cunningham,466,1,362,2019-05-04T16:30:00Z,True,4,6,0,0,31,20,11,43,17,26,-12,-6
Cunningham,466,1,376,2019-05-12T14:00:00Z,False,4,13,0,0,31,20,11,66,36,30,-35,-25
Alisson,467,0,4,2018-08-12T12:30:00Z,True,11,18,90,7,0,0,0,0,0,0,0,0
Alisson,467,0,14,2018-08-20T19:00:00Z,False,11,6,90,6,3,3,0,3,0,3,0,0
Alisson,467,0,24,2018-08-25T16:30:00Z,True,11,2,90,6,6,3,3,3,3,0,3,3
Alisson,467,0,36,2018-09-01T11:30:00Z,False,11,10,90,3,9,6,3,6,3,3,3,0
Alisson,467,0,47,2018-09-15T11:30:00Z,False,11,16,90,2,12,6,6,9,3,6,3,3
Alisson,467,0,57,2018-09-22T14:00:00Z,True,11,15,90,6,15,6,9,5,2,3,10,3
Alisson,467,0,63,2018-09-29T16:30:00Z,False,11,5,90,3,18,9,9,16,9,7,2,0
Alisson,467,0,75,2018-10-07T15:30:00Z,True,11,12,90,6,19,9,10,19,12,7,0,2
Alisson,467,0,85,2018-10-20T16:30:00Z,False,11,9,90,6,20,10,10,3,1,2,17,9
Alisson,467,0,95,2018-10-27T14:00:00Z,True,11,4,90,2,23,10,13,5,4,1,18,9
Alisson,467,0,100,2018-11-03T17:30:00Z,False,11,0,90,3,26,13,13,22,12,10,4,1
Alisson,467,0,116,2018-11-11T12:00:00Z,True,11,8,90,7,27,13,14,5,4,1,22,12
Alisson,467,0,127,2018-11-24T15:00:00Z,False,11,17,90,6,30,16,14,20,12,8,10,2
Alisson,467,0,136,2018-12-02T16:15:00Z,True,11,7,90,9,33,16,17,22,16,6,11,10
Alisson,467,0,142,2018-12-05T19:45:00Z,False,11,3,90,3,36,19,17,9,4,5,27,13
Alisson,467,0,151,2018-12-08T12:30:00Z,False,11,1,90,6,39,19,20,23,14,9,16,6
Alisson,467,0,164,2018-12-16T16:00:00Z,True,11,13,90,2,42,19,23,26,15,11,16,8
Alisson,467,0,179,2018-12-21T20:00:00Z,False,11,19,90,9,45,22,23,25,14,11,20,9
Alisson,467,0,185,2018-12-26T15:00:00Z,True,11,14,90,6,48,22,26,17,7,10,31,12
Alisson,467,0,195,2018-12-29T17:30:00Z,True,11,0,90,2,51,25,26,38,23,15,13,10
Alisson,467,0,206,2019-01-03T20:00:00Z,False,11,12,90,1,54,28,26,47,27,20,7,-1
Alisson,467,0,210,2019-01-12T15:00:00Z,False,11,2,90,6,54,28,26,26,18,8,28,8
Alisson,467,0,224,2019-01-19T15:00:00Z,True,11,6,90,1,57,28,29,22,9,13,35,15
Alisson,467,0,236,2019-01-30T20:00:00Z,True,11,10,90,2,60,31,29,31,14,17,29,14
Alisson,467,0,249,2019-02-04T20:00:00Z,False,11,18,90,2,61,32,29,31,17,14,30,12
Alisson,467,0,254,2019-02-09T15:00:00Z,True,11,1,90,6,62,32,30,33,24,9,29,23
Alisson,467,0,267,2019-02-24T14:05:00Z,False,11,13,90,10,65,35,30,51,25,26,14,5
Alisson,467,0,276,2019-02-27T20:00:00Z,True,11,17,90,7,66,35,31,40,20,20,26,15
Alisson,467,0,283,2019-03-03T16:15:00Z,False,11,7,90,8,69,38,31,36,21,15,33,10
Alisson,467,0,296,2019-03-10T12:00:00Z,True,11,3,90,0,70,38,32,30,17,13,40,25
Alisson,467,0,304,2019-03-17T14:15:00Z,False,11,8,90,2,73,41,32,17,15,2,56,17
Alisson,467,0,317,2019-03-31T15:30:00Z,True,11,16,90,2,76,41,35,61,28,33,15,8
Alisson,467,0,326,2019-04-05T19:00:00Z,False,11,15,90,2,79,44,35,33,18,15,46,17
Alisson,467,0,335,2019-04-14T15:30:00Z,True,11,5,90,7,82,44,38,66,38,28,16,16
Alisson,467,0,342,2019-04-21T15:00:00Z,False,11,4,90,6,85,47,38,31,20,11,54,18
Alisson,467,0,355,2019-04-26T19:00:00Z,True,11,9,90,6,88,47,41,14,8,6,74,41
Alisson,467,0,367,2019-05-04T18:45:00Z,False,11,14,90,2,91,50,41,42,25,17,49,16
Alisson,467,0,375,2019-05-12T14:00:00Z,True,11,19,90,6,94,50,44,57,34,23,37,27
Mirallas,468,2,9,2018-08-11T16:30:00Z,False,7,19,0,0,0,0,0,0,0,0,0,0
Mirallas,468,2,15,2018-08-18T14:00:00Z,True,7,15,0,0,1,0,1,1,1,0,0,0
Mirallas,468,2,21,2018-08-25T14:00:00Z,False,7,1,0,0,4,3,1,6,3,3,-2,-2
Mirallas,468,2,35,2018-09-01T14:00:00Z,True,7,9,0,0,5,3,2,1,1,0,4,3
Mirallas,468,2,42,2018-09-16T15:00:00Z,True,7,18,0,0,6,4,2,0,0,0,6,4
Mirallas,468,2,50,2018-09-23T15:00:00Z,False,7,0,0,0,6,4,2,9,3,6,-3,-1
Mirallas,468,2,64,2018-09-29T14:00:00Z,True,7,8,0,0,6,4,2,5,4,1,1,3
Mirallas,468,2,74,2018-10-06T14:00:00Z,False,7,10,0,0,9,7,2,12,6,6,-3,-4
Mirallas,468,2,84,2018-10-21T15:00:00Z,True,7,6,0,0,12,7,5,7,1,6,5,1
Mirallas,468,2,96,2018-10-28T16:00:00Z,False,7,13,0,0,15,10,5,14,7,7,1,-2
Mirallas,468,2,104,2018-11-03T15:00:00Z,True,7,2,0,0,15,10,5,14,10,4,1,6
Mirallas,468,2,112,2018-11-11T14:15:00Z,False,7,5,0,0,18,13,5,27,14,13,-9,-9
Mirallas,468,2,123,2018-11-24T15:00:00Z,True,7,4,0,0,19,13,6,8,7,1,11,12
Mirallas,468,2,136,2018-12-02T16:15:00Z,False,7,11,0,0,22,16,6,33,16,17,-11,-10
Mirallas,468,2,148,2018-12-05T19:45:00Z,True,7,14,0,0,22,16,6,12,6,6,10,10
Mirallas,468,2,155,2018-12-10T20:00:00Z,True,7,17,0,0,23,17,6,20,12,8,3,9
Mirallas,468,2,165,2018-12-15T12:30:00Z,False,7,12,0,0,24,18,6,41,24,17,-17,-18
Mirallas,468,2,174,2018-12-23T16:00:00Z,True,7,16,0,0,24,18,6,39,15,24,-15,-6
Mirallas,468,2,181,2018-12-26T15:00:00Z,False,7,3,0,0,24,18,6,12,7,5,12,-1
Mirallas,468,2,190,2018-12-29T15:00:00Z,False,7,2,0,0,27,18,9,22,15,7,5,-6
Mirallas,468,2,204,2019-01-01T12:30:00Z,True,7,10,0,0,27,18,9,28,14,14,-1,4
Mirallas,468,2,215,2019-01-13T14:15:00Z,True,7,1,0,0,27,18,9,27,18,9,0,9
Mirallas,468,2,227,2019-01-19T15:00:00Z,False,7,15,0,0,30,21,9,19,8,11,11,1
Mirallas,468,2,233,2019-01-29T19:45:00Z,False,7,9,0,0,30,21,9,11,5,6,19,4
Mirallas,468,2,245,2019-02-02T15:00:00Z,True,7,19,0,0,33,21,12,35,20,15,-2,6
Mirallas,468,2,265,2019-02-06T19:45:00Z,True,7,12,0,0,33,21,12,59,36,23,-26,-2
Mirallas,468,2,258,2019-02-09T15:00:00Z,False,7,17,0,0,33,21,12,34,17,17,-1,-5
Mirallas,468,2,271,2019-02-26T19:45:00Z,False,7,4,0,0,33,21,12,25,17,8,8,-5
Mirallas,468,2,283,2019-03-03T16:15:00Z,True,7,11,0,0,36,21,15,69,38,31,-33,-10
Mirallas,468,2,298,2019-03-09T15:00:00Z,False,7,14,0,0,37,22,15,31,19,12,6,-4
Mirallas,468,2,303,2019-03-17T16:30:00Z,True,7,5,0,0,37,22,15,57,32,25,-20,-3
Mirallas,468,2,319,2019-03-30T17:30:00Z,False,7,18,0,0,40,25,15,42,27,15,-2,-12
Mirallas,468,2,322,2019-04-07T13:05:00Z,True,7,0,0,0,43,25,18,63,44,19,-20,6
Mirallas,468,2,333,2019-04-13T14:00:00Z,False,7,8,0,0,46,28,18,17,15,2,29,3
Mirallas,468,2,344,2019-04-21T12:30:00Z,True,7,13,0,0,46,28,18,64,35,29,-18,-1
Mirallas,468,2,352,2019-04-27T14:00:00Z,False,7,6,0,0,49,31,18,42,16,26,7,2
Mirallas,468,2,364,2019-05-03T19:00:00Z,True,7,3,0,0,50,31,19,40,23,17,10,14
Mirallas,468,2,378,2019-05-12T14:00:00Z,False,7,16,0,0,53,34,19,70,37,33,-17,-18
Sandro,469,3,9,2018-08-11T16:30:00Z,False,7,19,0,0,0,0,0,0,0,0,0,0
Sandro,469,3,15,2018-08-18T14:00:00Z,True,7,15,0,0,1,0,1,1,1,0,0,0
Sandro,469,3,21,2018-08-25T14:00:00Z,False,7,1,0,0,4,3,1,6,3,3,-2,-2
Sandro,469,3,35,2018-09-01T14:00:00Z,True,7,9,0,0,5,3,2,1,1,0,4,3
Sandro,469,3,42,2018-09-16T15:00:00Z,True,7,18,0,0,6,4,2,0,0,0,6,4
Sandro,469,3,50,2018-09-23T15:00:00Z,False,7,0,0,0,6,4,2,9,3,6,-3,-1
Sandro,469,3,64,2018-09-29T14:00:00Z,True,7,8,0,0,6,4,2,5,4,1,1,3
Sandro,469,3,74,2018-10-06T14:00:00Z,False,7,10,0,0,9,7,2,12,6,6,-3,-4
Sandro,469,3,84,2018-10-21T15:00:00Z,True,7,6,0,0,12,7,5,7,1,6,5,1
Sandro,469,3,96,2018-10-28T16:00:00Z,False,7,13,0,0,15,10,5,14,7,7,1,-2
Sandro,469,3,104,2018-11-03T15:00:00Z,True,7,2,0,0,15,10,5,14,10,4,1,6
Sandro,469,3,112,2018-11-11T14:15:00Z,False,7,5,0,0,18,13,5,27,14,13,-9,-9
Sandro,469,3,123,2018-11-24T15:00:00Z,True,7,4,0,0,19,13,6,8,7,1,11,12
Sandro,469,3,136,2018-12-02T16:15:00Z,False,7,11,0,0,22,16,6,33,16,17,-11,-10
Sandro,469,3,148,2018-12-05T19:45:00Z,True,7,14,0,0,22,16,6,12,6,6,10,10
Sandro,469,3,155,2018-12-10T20:00:00Z,True,7,17,0,0,23,17,6,20,12,8,3,9
Sandro,469,3,165,2018-12-15T12:30:00Z,False,7,12,0,0,24,18,6,41,24,17,-17,-18
Sandro,469,3,174,2018-12-23T16:00:00Z,True,7,16,0,0,24,18,6,39,15,24,-15,-6
Sandro,469,3,181,2018-12-26T15:00:00Z,False,7,3,0,0,24,18,6,12,7,5,12,-1
Sandro,469,3,190,2018-12-29T15:00:00Z,False,7,2,0,0,27,18,9,22,15,7,5,-6
Sandro,469,3,204,2019-01-01T12:30:00Z,True,7,10,0,0,27,18,9,28,14,14,-1,4
Sandro,469,3,215,2019-01-13T14:15:00Z,True,7,1,0,0,27,18,9,27,18,9,0,9
Sandro,469,3,227,2019-01-19T15:00:00Z,False,7,15,0,0,30,21,9,19,8,11,11,1
Sandro,469,3,233,2019-01-29T19:45:00Z,False,7,9,0,0,30,21,9,11,5,6,19,4
Sandro,469,3,245,2019-02-02T15:00:00Z,True,7,19,0,0,33,21,12,35,20,15,-2,6
Sandro,469,3,265,2019-02-06T19:45:00Z,True,7,12,0,0,33,21,12,59,36,23,-26,-2
Sandro,469,3,258,2019-02-09T15:00:00Z,False,7,17,0,0,33,21,12,34,17,17,-1,-5
Sandro,469,3,271,2019-02-26T19:45:00Z,False,7,4,0,0,33,21,12,25,17,8,8,-5
Sandro,469,3,283,2019-03-03T16:15:00Z,True,7,11,0,0,36,21,15,69,38,31,-33,-10
Sandro,469,3,298,2019-03-09T15:00:00Z,False,7,14,0,0,37,22,15,31,19,12,6,-4
Sandro,469,3,303,2019-03-17T16:30:00Z,True,7,5,0,0,37,22,15,57,32,25,-20,-3
Sandro,469,3,319,2019-03-30T17:30:00Z,False,7,18,0,0,40,25,15,42,27,15,-2,-12
Sandro,469,3,322,2019-04-07T13:05:00Z,True,7,0,0,0,43,25,18,63,44,19,-20,6
Sandro,469,3,333,2019-04-13T14:00:00Z,False,7,8,0,0,46,28,18,17,15,2,29,3
Sandro,469,3,344,2019-04-21T12:30:00Z,True,7,13,0,0,46,28,18,64,35,29,-18,-1
Sandro,469,3,352,2019-04-27T14:00:00Z,False,7,6,0,0,49,31,18,42,16,26,7,2
Sandro,469,3,364,2019-05-03T19:00:00Z,True,7,3,0,0,50,31,19,40,23,17,10,14
Sandro,469,3,378,2019-05-12T14:00:00Z,False,7,16,0,0,53,34,19,70,37,33,-17,-18
Diakhaby,470,2,3,2018-08-11T14:00:00Z,True,9,5,19,1,0,0,0,0,0,0,0,0
Diakhaby,470,2,17,2018-08-19T12:30:00Z,False,9,12,29,1,0,0,0,3,0,3,-3,0
Diakhaby,470,2,23,2018-08-25T14:00:00Z,True,9,4,67,3,0,0,0,1,1,0,-1,0
Diakhaby,470,2,35,2018-09-01T14:00:00Z,False,9,7,59,1,1,1,0,5,3,2,-4,-3
Diakhaby,470,2,43,2018-09-15T14:00:00Z,True,9,6,22,1,2,1,1,3,0,3,-1,-2
Diakhaby,470,2,56,2018-09-22T14:00:00Z,False,9,10,33,1,2,1,1,6,3,3,-4,-2
Diakhaby,470,2,65,2018-09-29T14:00:00Z,True,9,16,0,0,2,1,1,12,3,9,-10,-8
Diakhaby,470,2,71,2018-10-06T14:00:00Z,False,9,3,0,0,2,1,1,7,3,4,-5,-2
Diakhaby,470,2,85,2018-10-20T16:30:00Z,True,9,11,1,1,3,1,2,20,10,10,-17,-9
Diakhaby,470,2,99,2018-10-27T14:00:00Z,False,9,17,0,0,3,1,2,16,9,7,-13,-7
Diakhaby,470,2,105,2018-11-05T20:00:00Z,True,9,8,0,0,3,1,2,5,4,1,-2,0
Diakhaby,470,2,114,2018-11-10T15:00:00Z,True,9,18,0,0,6,4,2,11,7,4,-5,0
Diakhaby,470,2,129,2018-11-25T16:00:00Z,False,9,19,0,0,7,5,2,16,8,8,-9,-6
Diakhaby,470,2,134,2018-12-01T15:00:00Z,True,9,2,0,0,10,5,5,15,11,4,-5,1
Diakhaby,470,2,140,2018-12-04T19:45:00Z,False,9,1,0,0,10,5,5,20,11,9,-10,-6
Diakhaby,470,2,150,2018-12-08T15:00:00Z,False,9,0,0,0,10,5,5,31,17,14,-21,-12
Diakhaby,470,2,163,2018-12-15T15:00:00Z,True,9,14,0,0,10,5,5,13,6,7,-3,-2
Diakhaby,470,2,175,2018-12-22T15:00:00Z,True,9,15,0,0,10,5,5,12,8,4,-2,1
Diakhaby,470,2,186,2018-12-26T15:00:00Z,False,9,13,0,0,10,5,5,29,15,14,-19,-10
Diakhaby,470,2,193,2018-12-29T15:00:00Z,False,9,8,0,0,10,5,5,11,9,2,-1,-4
Diakhaby,470,2,205,2019-01-02T19:45:00Z,True,9,3,0,0,10,5,5,15,10,5,-5,0
Diakhaby,470,2,212,2019-01-12T15:00:00Z,False,9,4,0,0,10,5,5,18,13,5,-8,-8
Diakhaby,470,2,223,2019-01-20T13:30:00Z,True,9,12,58,1,11,5,6,53,33,20,-42,-15
Diakhaby,470,2,233,2019-01-29T19:45:00Z,True,9,7,86,2,11,5,6,30,21,9,-19,-4
Diakhaby,470,2,243,2019-02-02T15:00:00Z,False,9,5,83,2,11,5,6,47,25,22,-36,-19
Diakhaby,470,2,253,2019-02-09T15:00:00Z,True,9,0,90,4,11,5,6,47,32,15,-36,-10
Diakhaby,470,2,268,2019-02-23T15:00:00Z,False,9,14,0,0,11,5,6,25,13,12,-14,-7
Diakhaby,470,2,273,2019-02-26T19:45:00Z,True,9,19,0,0,11,5,6,40,21,19,-29,-14
Diakhaby,470,2,281,2019-03-02T15:00:00Z,False,9,2,0,0,14,8,6,27,19,8,-13,-13
Diakhaby,470,2,294,2019-03-09T15:00:00Z,True,9,1,0,0,14,8,6,34,25,9,-20,-1
Diakhaby,470,2,308,2019-03-16T15:00:00Z,False,9,18,0,0,14,8,6,39,24,15,-25,-18
Diakhaby,470,2,314,2019-03-30T15:00:00Z,False,9,6,0,0,14,8,6,33,13,20,-19,-7
Diakhaby,470,2,323,2019-04-06T14:00:00Z,True,9,10,0,0,14,8,6,44,23,21,-30,-13
Diakhaby,470,2,338,2019-04-13T11:30:00Z,False,9,16,0,0,14,8,6,64,31,33,-50,-25
Diakhaby,470,2,345,2019-04-20T14:00:00Z,True,9,17,0,0,14,8,6,46,26,20,-32,-12
Diakhaby,470,2,355,2019-04-26T19:00:00Z,False,9,11,0,0,14,8,6,88,47,41,-74,-41
Diakhaby,470,2,365,2019-05-05T13:00:00Z,True,9,13,1,1,14,8,6,65,36,29,-51,-21
Diakhaby,470,2,377,2019-05-12T14:00:00Z,False,9,15,0,0,15,9,6,38,22,16,-23,-16
Sturridge,471,3,4,2018-08-12T12:30:00Z,True,11,18,3,5,0,0,0,0,0,0,0,0
Sturridge,471,3,14,2018-08-20T19:00:00Z,False,11,6,1,1,3,3,0,3,0,3,0,0
Sturridge,471,3,24,2018-08-25T16:30:00Z,True,11,2,10,1,6,3,3,3,3,0,3,3
Sturridge,471,3,36,2018-09-01T11:30:00Z,False,11,10,0,0,9,6,3,6,3,3,3,0
Sturridge,471,3,47,2018-09-15T11:30:00Z,False,11,16,7,1,12,6,6,9,3,6,3,3
Sturridge,471,3,57,2018-09-22T14:00:00Z,True,11,15,0,0,15,6,9,5,2,3,10,3
Sturridge,471,3,63,2018-09-29T16:30:00Z,False,11,5,4,7,18,9,9,16,9,7,2,0
Sturridge,471,3,75,2018-10-07T15:30:00Z,True,11,12,18,1,19,9,10,19,12,7,0,2
Sturridge,471,3,85,2018-10-20T16:30:00Z,False,11,9,90,1,20,10,10,3,1,2,17,9
Sturridge,471,3,95,2018-10-27T14:00:00Z,True,11,4,0,0,23,10,13,5,4,1,18,9
Sturridge,471,3,100,2018-11-03T17:30:00Z,False,11,0,0,0,26,13,13,22,12,10,4,1
Sturridge,471,3,116,2018-11-11T12:00:00Z,True,11,8,0,0,27,13,14,5,4,1,22,12
Sturridge,471,3,127,2018-11-24T15:00:00Z,False,11,17,0,0,30,16,14,20,12,8,10,2
Sturridge,471,3,136,2018-12-02T16:15:00Z,True,11,7,15,1,33,16,17,22,16,6,11,10
Sturridge,471,3,142,2018-12-05T19:45:00Z,False,11,3,90,2,36,19,17,9,4,5,27,13
Sturridge,471,3,151,2018-12-08T12:30:00Z,False,11,1,0,0,39,19,20,23,14,9,16,6
Sturridge,471,3,164,2018-12-16T16:00:00Z,True,11,13,0,0,42,19,23,26,15,11,16,8
Sturridge,471,3,179,2018-12-21T20:00:00Z,False,11,19,0,0,45,22,23,25,14,11,20,9
Sturridge,471,3,185,2018-12-26T15:00:00Z,True,11,14,21,1,48,22,26,17,7,10,31,12
Sturridge,471,3,195,2018-12-29T17:30:00Z,True,11,0,0,0,51,25,26,38,23,15,13,10
Sturridge,471,3,206,2019-01-03T20:00:00Z,False,11,12,4,1,54,28,26,47,27,20,7,-1
Sturridge,471,3,210,2019-01-12T15:00:00Z,False,11,2,0,0,54,28,26,26,18,8,28,8
Sturridge,471,3,224,2019-01-19T15:00:00Z,True,11,6,0,0,57,28,29,22,9,13,35,15
Sturridge,471,3,236,2019-01-30T20:00:00Z,True,11,10,8,1,60,31,29,31,14,17,29,14
Sturridge,471,3,249,2019-02-04T20:00:00Z,False,11,18,0,0,61,32,29,31,17,14,30,12
Sturridge,471,3,254,2019-02-09T15:00:00Z,True,11,1,1,1,62,32,30,33,24,9,29,23
Sturridge,471,3,267,2019-02-24T14:05:00Z,False,11,13,59,1,65,35,30,51,25,26,14,5
Sturridge,471,3,276,2019-02-27T20:00:00Z,True,11,17,0,0,66,35,31,40,20,20,26,15
Sturridge,471,3,283,2019-03-03T16:15:00Z,False,11,7,0,0,69,38,31,36,21,15,33,10
Sturridge,471,3,296,2019-03-10T12:00:00Z,True,11,3,4,4,70,38,32,30,17,13,40,25
Sturridge,471,3,304,2019-03-17T14:15:00Z,False,11,8,1,1,73,41,32,17,15,2,56,17
Sturridge,471,3,317,2019-03-31T15:30:00Z,True,11,16,0,0,76,41,35,61,28,33,15,8
Sturridge,471,3,326,2019-04-05T19:00:00Z,False,11,15,0,0,79,44,35,33,18,15,46,17
Sturridge,471,3,335,2019-04-14T15:30:00Z,True,11,5,0,0,82,44,38,66,38,28,16,16
Sturridge,471,3,342,2019-04-21T15:00:00Z,False,11,4,0,0,85,47,38,31,20,11,54,18
Sturridge,471,3,355,2019-04-26T19:00:00Z,True,11,9,72,2,88,47,41,14,8,6,74,41
Sturridge,471,3,367,2019-05-04T18:45:00Z,False,11,14,90,2,91,50,41,42,25,17,49,16
Sturridge,471,3,375,2019-05-12T14:00:00Z,True,11,19,0,0,94,50,44,57,34,23,37,27
Rico,472,1,1,2018-08-11T14:00:00Z,True,1,4,0,0,0,0,0,0,0,0,0,0
Rico,472,1,19,2018-08-18T14:00:00Z,False,1,18,0,0,3,3,0,0,0,0,3,0
Rico,472,1,21,2018-08-25T14:00:00Z,True,1,7,0,0,6,3,3,4,3,1,2,2
Rico,472,1,33,2018-09-01T14:00:00Z,False,1,5,90,1,7,4,3,9,3,6,-2,0
Rico,472,1,40,2018-09-15T14:00:00Z,True,1,10,90,1,7,4,3,6,3,3,1,1
Rico,472,1,52,2018-09-22T14:00:00Z,False,1,3,45,0,10,7,3,1,0,1,9,3
Rico,472,1,61,2018-10-01T19:00:00Z,True,1,6,0,0,10,7,3,7,1,6,3,1
Rico,472,1,79,2018-10-06T14:00:00Z,False,1,17,0,0,13,10,3,13,9,4,0,-6
Rico,472,1,81,2018-10-20T14:00:00Z,True,1,15,0,0,16,10,6,5,2,3,11,7
Rico,472,1,93,2018-10-27T14:00:00Z,False,1,8,0,0,17,11,6,5,4,1,12,2
Rico,472,1,101,2018-11-03T12:30:00Z,True,1,13,0,0,20,11,9,17,10,7,3,4
Rico,472,1,118,2018-11-10T15:00:00Z,False,1,14,0,0,20,11,9,6,3,3,14,6
Rico,472,1,120,2018-11-25T13:30:00Z,True,1,0,0,0,20,11,9,24,14,10,-4,1
Rico,472,1,137,2018-12-01T15:00:00Z,False,1,12,0,0,20,11,9,35,21,14,-15,-12
Rico,472,1,140,2018-12-04T19:45:00Z,True,1,9,0,0,20,11,9,10,5,5,10,6
Rico,472,1,151,2018-12-08T12:30:00Z,True,1,11,7,1,23,14,9,39,19,20,-16,-6
Rico,472,1,169,2018-12-15T15:00:00Z,False,1,19,54,1,23,14,9,22,11,11,1,-2
Rico,472,1,171,2018-12-22T15:00:00Z,True,1,2,0,0,23,14,9,21,14,7,2,7
Rico,472,1,188,2018-12-26T15:00:00Z,False,1,16,45,0,26,17,9,42,15,27,-16,-6
Rico,472,1,196,2018-12-30T16:30:00Z,False,1,13,90,0,26,17,9,32,18,14,-6,-9
Rico,472,1,201,2019-01-02T19:45:00Z,True,1,17,0,0,26,17,9,28,16,12,-2,5
Rico,472,1,215,2019-01-13T14:15:00Z,False,1,7,0,0,27,18,9,27,18,9,0,-9
Rico,472,1,221,2019-01-19T15:00:00Z,True,1,18,0,0,27,18,9,31,17,14,-4,4
Rico,472,1,231,2019-01-30T19:45:00Z,True,1,5,0,0,30,21,9,47,25,22,-17,-1
Rico,472,1,242,2019-02-02T17:30:00Z,False,1,4,0,0,33,24,9,19,14,5,14,-5
Rico,472,1,254,2019-02-09T15:00:00Z,False,1,11,79,0,33,24,9,62,32,30,-29,-23
Rico,472,1,261,2019-02-23T15:00:00Z,True,1,19,0,0,33,24,9,39,21,18,-6,6
Rico,472,1,270,2019-02-27T19:45:00Z,False,1,0,20,1,34,25,9,53,35,18,-19,-26
Rico,472,1,280,2019-03-02T15:00:00Z,True,1,12,7,1,34,25,9,68,42,26,-34,-1
Rico,472,1,294,2019-03-09T15:00:00Z,False,1,9,0,0,34,25,9,14,8,6,20,1
Rico,472,1,300,2019-03-16T15:00:00Z,True,1,14,0,0,37,25,12,34,22,12,3,13
Rico,472,1,316,2019-03-30T15:00:00Z,False,1,10,34,1,38,26,12,41,20,21,-3,-8
Rico,472,1,320,2019-04-06T14:00:00Z,True,1,3,45,1,38,26,12,33,20,13,5,13
Rico,472,1,330,2019-04-13T14:00:00Z,False,1,2,0,0,38,26,12,33,22,11,5,-10
Rico,472,1,341,2019-04-20T14:00:00Z,True,1,8,0,0,41,26,15,20,18,2,21,24
Rico,472,1,357,2019-04-27T14:00:00Z,False,1,15,0,0,41,26,15,37,21,16,4,-6
Rico,472,1,361,2019-05-04T11:30:00Z,True,1,16,0,0,42,26,16,70,37,33,-28,-7
Rico,472,1,372,2019-05-12T14:00:00Z,False,1,6,0,0,45,29,16,46,17,29,-1,-1
Fabri,473,0,2,2018-08-11T14:00:00Z,True,8,6,90,3,0,0,0,0,0,0,0,0
Fabri,473,0,18,2018-08-18T14:00:00Z,False,8,16,90,5,0,0,0,3,0,3,-3,0
Fabri,473,0,22,2018-08-26T15:00:00Z,True,8,3,0,0,0,0,0,1,0,1,-1,-1
Fabri,473,0,30,2018-09-01T14:00:00Z,False,8,2,0,0,3,3,0,3,3,0,0,-3
Fabri,473,0,44,2018-09-15T14:00:00Z,False,8,12,0,0,4,3,1,10,6,4,-6,-5
Fabri,473,0,55,2018-09-22T11:30:00Z,True,8,17,0,0,4,3,1,12,9,3,-8,0
Fabri,473,0,64,2018-09-29T14:00:00Z,False,8,7,0,0,5,4,1,6,4,2,-1,-3
Fabri,473,0,73,2018-10-07T11:00:00Z,True,8,0,0,0,5,4,1,15,9,6,-10,-2
Fabri,473,0,82,2018-10-20T14:00:00Z,False,8,4,0,0,5,4,1,2,1,1,3,0
Fabri,473,0,93,2018-10-27T14:00:00Z,True,8,1,0,0,5,4,1,17,11,6,-12,-2
Fabri,473,0,105,2018-11-05T20:00:00Z,False,8,9,0,0,5,4,1,3,1,2,2,0
Fabri,473,0,116,2018-11-11T12:00:00Z,False,8,11,0,0,5,4,1,27,13,14,-22,-12
Fabri,473,0,124,2018-11-24T15:00:00Z,True,8,15,0,0,5,4,1,8,4,4,-3,0
Fabri,473,0,132,2018-12-02T12:00:00Z,False,8,5,0,0,8,7,1,28,15,13,-20,-14
Fabri,473,0,143,2018-12-05T19:45:00Z,True,8,10,0,0,8,7,1,21,11,10,-13,-3
Fabri,473,0,157,2018-12-08T15:00:00Z,False,8,13,0,0,9,8,1,23,12,11,-14,-11
Fabri,473,0,162,2018-12-15T17:30:00Z,True,8,18,0,0,9,8,1,21,13,8,-12,0
Fabri,473,0,177,2018-12-22T15:00:00Z,False,8,14,0,0,9,8,1,16,6,10,-7,-5
Fabri,473,0,183,2018-12-26T12:30:00Z,True,8,19,0,0,10,8,2,25,14,11,-15,-3
Fabri,473,0,193,2018-12-29T15:00:00Z,True,8,9,0,0,11,9,2,10,5,5,1,4
Fabri,473,0,200,2019-01-01T15:00:00Z,False,8,0,0,0,14,12,2,38,23,15,-24,-21
Fabri,473,0,211,2019-01-12T15:00:00Z,False,8,3,0,0,14,12,2,18,10,8,-4,-8
Fabri,473,0,222,2019-01-20T16:00:00Z,True,8,16,0,0,14,12,2,48,18,30,-34,-18
Fabri,473,0,232,2019-01-29T19:45:00Z,True,8,2,0,0,14,12,2,26,18,8,-12,4
Fabri,473,0,244,2019-02-02T15:00:00Z,False,8,6,0,0,17,15,2,23,9,14,-6,-7
Fabri,473,0,252,2019-02-09T12:30:00Z,True,8,13,0,0,17,15,2,48,25,23,-31,-8
Fabri,473,0,269,2019-02-22T19:45:00Z,False,8,18,0,0,17,15,2,33,18,15,-16,-16
Fabri,473,0,279,2019-02-27T19:45:00Z,False,8,15,0,0,17,15,2,24,12,12,-7,-10
Fabri,473,0,284,2019-03-03T14:05:00Z,True,8,5,0,0,17,15,2,53,31,22,-36,-7
Fabri,473,0,295,2019-03-09T15:00:00Z,False,8,10,0,0,17,15,2,35,17,18,-18,-15
Fabri,473,0,304,2019-03-17T14:15:00Z,True,8,11,0,0,17,15,2,73,41,32,-56,-17
Fabri,473,0,315,2019-03-30T12:30:00Z,True,8,12,0,0,17,15,2,74,45,29,-57,-14
Fabri,473,0,328,2019-04-02T18:45:00Z,False,8,17,0,0,17,15,2,43,23,20,-26,-21
Fabri,473,0,333,2019-04-13T14:00:00Z,True,8,7,0,0,17,15,2,46,28,18,-29,-3
Fabri,473,0,341,2019-04-20T14:00:00Z,False,8,1,0,0,20,18,2,41,26,15,-21,-24
Fabri,473,0,353,2019-04-27T14:00:00Z,True,8,4,0,0,23,18,5,31,20,11,-8,7
Fabri,473,0,369,2019-05-04T14:00:00Z,False,8,19,0,0,26,21,5,54,31,23,-28,-26
Fabri,473,0,373,2019-05-12T14:00:00Z,True,8,14,0,0,26,21,5,42,25,17,-16,4
Moutinho,474,2,9,2018-08-11T16:30:00Z,True,19,7,84,2,0,0,0,0,0,0,0,0
Moutinho,474,2,16,2018-08-18T14:00:00Z,False,19,10,90,2,1,1,0,0,0,0,1,0
Moutinho,474,2,29,2018-08-25T11:30:00Z,True,19,12,90,6,1,1,0,6,3,3,-5,-2
Moutinho,474,2,39,2018-09-01T14:00:00Z,False,19,18,90,3,2,2,0,0,0,0,2,0
Moutinho,474,2,49,2018-09-16T12:30:00Z,True,19,3,90,3,5,2,3,1,0,1,4,1
Moutinho,474,2,58,2018-09-22T14:00:00Z,False,19,13,79,10,8,5,3,9,3,6,-1,0
Moutinho,474,2,69,2018-09-29T14:00:00Z,True,19,15,90,3,9,5,4,5,2,3,4,2
Moutinho,474,2,72,2018-10-06T14:00:00Z,False,19,6,90,2,12,8,4,7,1,6,5,3
Moutinho,474,2,89,2018-10-20T14:00:00Z,True,19,17,90,2,15,8,7,13,9,4,2,4
Moutinho,474,2,90,2018-10-27T14:00:00Z,False,19,2,90,2,15,8,7,11,7,4,4,0
Moutinho,474,2,109,2018-11-03T19:45:00Z,True,19,16,61,2,15,8,7,21,6,15,-6,-7
Moutinho,474,2,110,2018-11-11T16:30:00Z,False,19,0,90,2,15,8,7,23,13,10,-8,-6
Moutinho,474,2,129,2018-11-25T16:00:00Z,True,19,9,45,1,16,8,8,7,5,2,9,6
Moutinho,474,2,131,2018-11-30T20:00:00Z,False,19,4,90,2,16,8,8,8,7,1,8,1
Moutinho,474,2,147,2018-12-05T19:45:00Z,True,19,5,90,1,16,8,8,31,18,13,-15,-5
Moutinho,474,2,158,2018-12-09T16:00:00Z,False,19,14,14,1,19,11,8,13,6,7,6,2
Moutinho,474,2,169,2018-12-15T15:00:00Z,True,19,1,90,3,22,11,11,23,14,9,-1,2
Moutinho,474,2,179,2018-12-21T20:00:00Z,True,19,11,62,2,25,14,11,45,22,23,-20,-9
Moutinho,474,2,183,2018-12-26T12:30:00Z,False,19,8,90,4,25,14,11,10,8,2,15,3
Moutinho,474,2,198,2018-12-29T15:00:00Z,False,19,16,22,4,26,14,12,45,18,27,-19,-6
Moutinho,474,2,209,2019-01-02T19:45:00Z,True,19,6,90,2,29,14,15,19,9,10,10,4
Moutinho,474,2,217,2019-01-14T20:00:00Z,False,19,12,72,2,29,14,15,50,30,20,-21,-15
Moutinho,474,2,229,2019-01-19T12:30:00Z,True,19,10,80,10,29,14,15,31,14,17,-2,-3
Moutinho,474,2,235,2019-01-29T19:45:00Z,True,19,18,88,11,32,17,15,31,17,14,1,3
Moutinho,474,2,245,2019-02-02T15:00:00Z,False,19,7,90,6,35,20,15,33,21,12,2,-6
Moutinho,474,2,259,2019-02-11T20:00:00Z,True,19,14,90,2,38,20,18,24,13,11,14,9
Moutinho,474,2,261,2019-02-23T15:00:00Z,False,19,1,90,2,39,21,18,33,24,9,6,-6
Moutinho,474,2,273,2019-02-26T19:45:00Z,False,19,9,65,3,40,21,19,11,5,6,29,14
Moutinho,474,2,289,2019-03-02T15:00:00Z,True,19,4,26,1,40,21,19,25,17,8,15,13
Moutinho,474,2,292,2019-03-10T14:05:00Z,False,19,5,90,2,43,24,19,56,31,25,-13,-12
Moutinho,474,2,312,2019-03-30T15:00:00Z,False,19,3,90,2,44,24,20,30,17,13,14,3
Moutinho,474,2,329,2019-04-02T18:45:00Z,True,19,13,90,2,44,24,20,61,32,29,-17,-5
Moutinho,474,2,337,2019-04-13T14:00:00Z,False,19,15,90,4,47,27,20,33,18,15,14,2
Moutinho,474,2,349,2019-04-20T14:00:00Z,True,19,2,90,3,47,27,20,33,22,11,14,16
Moutinho,474,2,309,2019-04-24T18:45:00Z,True,19,0,89,2,48,28,20,66,44,22,-18,6
Moutinho,474,2,359,2019-04-27T14:00:00Z,False,19,17,90,1,51,31,20,50,27,23,1,-7
Moutinho,474,2,369,2019-05-04T14:00:00Z,True,19,8,90,5,54,31,23,26,21,5,28,26
Moutinho,474,2,375,2019-05-12T14:00:00Z,False,19,11,83,2,57,34,23,94,50,44,-37,-27
Jahanbakhsh,475,2,8,2018-08-11T14:00:00Z,False,2,17,19,1,0,0,0,0,0,0,0,0
Jahanbakhsh,475,2,10,2018-08-19T15:00:00Z,True,2,13,0,0,0,0,0,3,3,0,-3,0
Jahanbakhsh,475,2,24,2018-08-25T16:30:00Z,False,2,11,14,1,3,3,0,6,3,3,-3,-3
Jahanbakhsh,475,2,30,2018-09-01T14:00:00Z,True,2,8,16,1,3,3,0,3,3,0,0,3
Jahanbakhsh,475,2,46,2018-09-17T19:00:00Z,False,2,15,19,1,4,4,0,4,1,3,0,-1
Jahanbakhsh,475,2,51,2018-09-22T16:30:00Z,True,2,16,17,1,5,4,1,9,3,6,-4,-2
Jahanbakhsh,475,2,66,2018-09-29T14:00:00Z,False,2,12,12,1,5,4,1,16,9,7,-11,-8
Jahanbakhsh,475,2,70,2018-10-05T19:00:00Z,True,2,18,70,2,5,4,1,7,4,3,-2,1
Jahanbakhsh,475,2,87,2018-10-20T14:00:00Z,False,2,14,90,2,8,7,1,2,0,2,6,1
Jahanbakhsh,475,2,90,2018-10-27T14:00:00Z,True,2,19,90,3,11,7,4,15,8,7,-4,0
Jahanbakhsh,475,2,104,2018-11-03T15:00:00Z,False,2,7,90,2,14,10,4,15,10,5,-1,-6
Jahanbakhsh,475,2,111,2018-11-10T12:30:00Z,False,2,4,0,0,14,10,4,5,4,1,9,0
Jahanbakhsh,475,2,121,2018-11-24T15:00:00Z,True,2,10,0,0,14,10,4,17,8,9,-3,1
Jahanbakhsh,475,2,134,2018-12-01T15:00:00Z,False,2,9,0,0,15,11,4,10,5,5,5,-1
Jahanbakhsh,475,2,141,2018-12-04T19:45:00Z,True,2,6,0,0,18,11,7,12,5,7,6,4
Jahanbakhsh,475,2,152,2018-12-08T15:00:00Z,False,2,3,0,0,21,14,7,9,4,5,12,3
Jahanbakhsh,475,2,160,2018-12-16T13:30:00Z,True,2,5,0,0,21,14,7,34,21,13,-13,1
Jahanbakhsh,475,2,171,2018-12-22T15:00:00Z,False,2,1,0,0,21,14,7,23,14,9,-2,-7
Jahanbakhsh,475,2,180,2018-12-26T17:15:00Z,True,2,0,0,0,21,14,7,37,23,14,-16,0
Jahanbakhsh,475,2,190,2018-12-29T15:00:00Z,True,2,7,0,0,22,15,7,27,18,9,-5,6
Jahanbakhsh,475,2,208,2019-01-02T19:45:00Z,False,2,18,0,0,25,18,7,27,13,14,-2,-6
Jahanbakhsh,475,2,210,2019-01-12T15:00:00Z,True,2,11,0,0,26,18,8,54,28,26,-28,-8
Jahanbakhsh,475,2,225,2019-01-19T15:00:00Z,False,2,13,0,0,26,18,8,41,21,20,-15,-13
Jahanbakhsh,475,2,232,2019-01-29T19:45:00Z,False,2,8,0,0,26,18,8,14,12,2,12,-4
Jahanbakhsh,475,2,240,2019-02-02T15:00:00Z,True,2,17,0,0,26,18,8,33,17,16,-7,2
Jahanbakhsh,475,2,250,2019-02-09T17:30:00Z,True,2,3,24,1,27,19,8,24,14,10,3,9
Jahanbakhsh,475,2,274,2019-02-26T19:45:00Z,False,2,10,0,0,27,19,8,32,14,18,-5,-6
Jahanbakhsh,475,2,281,2019-03-02T15:00:00Z,True,2,9,77,3,27,19,8,14,8,6,13,13
Jahanbakhsh,475,2,293,2019-03-09T12:30:00Z,False,2,6,90,2,30,22,8,33,13,20,-3,-5
Jahanbakhsh,475,2,311,2019-03-30T15:00:00Z,True,2,15,61,2,33,22,11,30,18,12,3,10
Jahanbakhsh,475,2,264,2019-04-03T18:45:00Z,False,2,5,74,2,33,22,11,60,32,28,-27,-21
Jahanbakhsh,475,2,330,2019-04-13T14:00:00Z,True,2,1,0,0,33,22,11,38,26,12,-5,10
Jahanbakhsh,475,2,301,2019-04-16T18:45:00Z,True,2,4,68,2,33,22,11,28,20,8,5,14
Jahanbakhsh,475,2,349,2019-04-20T14:00:00Z,False,2,19,0,0,33,22,11,47,27,20,-14,-16
Jahanbakhsh,475,2,327,2019-04-23T18:45:00Z,False,2,16,72,3,34,22,12,67,34,33,-33,-22
Jahanbakhsh,475,2,350,2019-04-27T16:30:00Z,True,2,14,0,0,34,22,12,41,25,16,-7,6
Jahanbakhsh,475,2,360,2019-05-05T15:30:00Z,False,2,0,45,1,35,23,12,66,44,22,-31,-32
Jahanbakhsh,475,2,370,2019-05-12T14:00:00Z,True,2,12,66,2,36,23,13,95,54,41,-59,-18
Kaikai,476,2,2,2018-08-11T14:00:00Z,False,6,8,0,0,0,0,0,0,0,0,0,0
Kaikai,476,2,14,2018-08-20T19:00:00Z,True,6,11,0,0,3,0,3,3,3,0,0,0
Kaikai,476,2,28,2018-08-26T12:30:00Z,False,6,17,0,0,3,0,3,6,3,3,-3,0
Kaikai,476,2,34,2018-09-01T14:00:00Z,True,6,15,0,0,3,0,3,1,1,0,2,0
Kaikai,476,2,43,2018-09-15T14:00:00Z,False,6,9,0,0,3,0,3,2,1,1,1,2
Kaikai,476,2,54,2018-09-22T14:00:00Z,True,6,14,0,0,6,0,6,1,0,1,5,-1
Kaikai,476,2,61,2018-10-01T19:00:00Z,False,6,1,0,0,7,1,6,10,7,3,-3,-1
Kaikai,476,2,72,2018-10-06T14:00:00Z,True,6,19,0,0,7,1,6,12,8,4,-5,-3
Kaikai,476,2,84,2018-10-21T15:00:00Z,False,6,7,0,0,7,1,6,12,7,5,-5,-1
Kaikai,476,2,92,2018-10-28T13:30:00Z,True,6,0,0,0,7,1,6,21,12,9,-14,-8
Kaikai,476,2,103,2018-11-04T16:00:00Z,False,6,5,0,0,8,2,6,24,11,13,-16,-5
Kaikai,476,2,113,2018-11-10T17:30:00Z,True,6,16,0,0,8,2,6,24,6,18,-16,-16
Kaikai,476,2,125,2018-11-24T15:00:00Z,False,6,13,0,0,8,2,6,20,10,10,-12,-4
Kaikai,476,2,133,2018-12-01T15:00:00Z,True,6,3,0,0,9,2,7,9,4,5,0,-3
Kaikai,476,2,141,2018-12-04T19:45:00Z,False,6,2,0,0,12,5,7,18,11,7,-6,-4
Kaikai,476,2,159,2018-12-08T15:00:00Z,False,6,18,0,0,12,5,7,18,10,8,-6,-3
Kaikai,476,2,161,2018-12-15T15:00:00Z,True,6,10,0,0,12,5,7,22,11,11,-10,-6
Kaikai,476,2,176,2018-12-22T15:00:00Z,False,6,12,0,0,15,8,7,44,27,17,-29,-20
Kaikai,476,2,182,2018-12-26T15:00:00Z,True,6,4,0,0,18,8,10,14,13,1,4,7
Kaikai,476,2,192,2018-12-30T12:00:00Z,True,6,5,0,0,19,9,10,40,21,19,-21,-10
Kaikai,476,2,209,2019-01-02T19:45:00Z,False,6,19,0,0,19,9,10,29,14,15,-10,-4
Kaikai,476,2,214,2019-01-12T15:00:00Z,True,6,17,0,0,22,9,13,29,16,13,-7,-4
Kaikai,476,2,224,2019-01-19T15:00:00Z,False,6,11,0,0,22,9,13,57,28,29,-35,-15
Kaikai,476,2,238,2019-01-30T19:45:00Z,False,6,15,0,0,22,9,13,22,11,11,0,2
Kaikai,476,2,244,2019-02-02T15:00:00Z,True,6,8,0,0,23,9,14,17,15,2,6,7
Kaikai,476,2,251,2019-02-09T15:00:00Z,True,6,18,0,0,26,12,14,32,18,14,-6,-2
Kaikai,476,2,266,2019-02-23T17:30:00Z,False,6,10,0,0,27,13,14,32,14,18,-5,0
Kaikai,476,2,272,2019-02-27T20:00:00Z,True,6,13,0,0,30,13,17,52,26,26,-22,-13
Kaikai,476,2,282,2019-03-02T15:00:00Z,False,6,3,0,0,30,13,17,30,17,13,0,0
Kaikai,476,2,293,2019-03-09T12:30:00Z,True,6,2,0,0,33,13,20,30,22,8,3,5
Kaikai,476,2,314,2019-03-30T15:00:00Z,True,6,9,0,0,33,13,20,14,8,6,19,7
Kaikai,476,2,306,2019-04-03T18:45:00Z,False,6,16,0,0,36,16,20,61,28,33,-25,-8
Kaikai,476,2,325,2019-04-06T14:00:00Z,False,6,14,0,0,36,16,20,35,22,13,1,-2
Kaikai,476,2,332,2019-04-14T13:05:00Z,True,6,12,0,0,39,16,23,80,48,32,-41,-16
Kaikai,476,2,340,2019-04-21T15:00:00Z,False,6,0,0,0,39,16,23,66,44,22,-27,-21
Kaikai,476,2,352,2019-04-27T14:00:00Z,True,6,7,0,0,42,16,26,49,31,18,-7,-2
Kaikai,476,2,362,2019-05-04T16:30:00Z,False,6,4,0,0,43,17,26,31,20,11,12,6
Kaikai,476,2,372,2019-05-12T14:00:00Z,True,6,1,0,0,46,17,29,45,29,16,1,1
Schurrle,477,2,2,2018-08-11T14:00:00Z,True,8,6,60,2,0,0,0,0,0,0,0,0
Schurrle,477,2,18,2018-08-18T14:00:00Z,False,8,16,2,1,0,0,0,3,0,3,-3,0
Schurrle,477,2,22,2018-08-26T15:00:00Z,True,8,3,88,6,0,0,0,1,0,1,-1,-1
Schurrle,477,2,30,2018-09-01T14:00:00Z,False,8,2,86,7,3,3,0,3,3,0,0,-3
Schurrle,477,2,44,2018-09-15T14:00:00Z,False,8,12,90,2,4,3,1,10,6,4,-6,-5
Schurrle,477,2,55,2018-09-22T11:30:00Z,True,8,17,90,2,4,3,1,12,9,3,-8,0
Schurrle,477,2,64,2018-09-29T14:00:00Z,False,8,7,90,2,5,4,1,6,4,2,-1,-3
Schurrle,477,2,73,2018-10-07T11:00:00Z,True,8,0,90,6,5,4,1,15,9,6,-10,-2
Schurrle,477,2,82,2018-10-20T14:00:00Z,False,8,4,90,7,5,4,1,2,1,1,3,0
Schurrle,477,2,93,2018-10-27T14:00:00Z,True,8,1,90,2,5,4,1,17,11,6,-12,-2
Schurrle,477,2,105,2018-11-05T20:00:00Z,False,8,9,90,2,5,4,1,3,1,2,2,0
Schurrle,477,2,116,2018-11-11T12:00:00Z,False,8,11,77,2,5,4,1,27,13,14,-22,-12
Schurrle,477,2,124,2018-11-24T15:00:00Z,True,8,15,73,7,5,4,1,8,4,4,-3,0
Schurrle,477,2,132,2018-12-02T12:00:00Z,False,8,5,0,0,8,7,1,28,15,13,-20,-14
Schurrle,477,2,143,2018-12-05T19:45:00Z,True,8,10,0,0,8,7,1,21,11,10,-13,-3
Schurrle,477,2,157,2018-12-08T15:00:00Z,False,8,13,72,2,9,8,1,23,12,11,-14,-11
Schurrle,477,2,162,2018-12-15T17:30:00Z,True,8,18,76,2,9,8,1,21,13,8,-12,0
Schurrle,477,2,177,2018-12-22T15:00:00Z,False,8,14,75,3,9,8,1,16,6,10,-7,-5
Schurrle,477,2,183,2018-12-26T12:30:00Z,True,8,19,66,3,10,8,2,25,14,11,-15,-3
Schurrle,477,2,193,2018-12-29T15:00:00Z,True,8,9,0,0,11,9,2,10,5,5,1,4
Schurrle,477,2,200,2019-01-01T15:00:00Z,False,8,0,60,2,14,12,2,38,23,15,-24,-21
Schurrle,477,2,211,2019-01-12T15:00:00Z,False,8,3,76,9,14,12,2,18,10,8,-4,-8
Schurrle,477,2,222,2019-01-20T16:00:00Z,True,8,16,71,2,14,12,2,48,18,30,-34,-18
Schurrle,477,2,232,2019-01-29T19:45:00Z,True,8,2,45,1,14,12,2,26,18,8,-12,4
Schurrle,477,2,244,2019-02-02T15:00:00Z,False,8,6,0,0,17,15,2,23,9,14,-6,-7
Schurrle,477,2,252,2019-02-09T12:30:00Z,True,8,13,52,1,17,15,2,48,25,23,-31,-8
Schurrle,477,2,269,2019-02-22T19:45:00Z,False,8,18,0,0,17,15,2,33,18,15,-16,-16
Schurrle,477,2,279,2019-02-27T19:45:00Z,False,8,15,0,0,17,15,2,24,12,12,-7,-10
Schurrle,477,2,284,2019-03-03T14:05:00Z,True,8,5,0,0,17,15,2,53,31,22,-36,-7
Schurrle,477,2,295,2019-03-09T15:00:00Z,False,8,10,0,0,17,15,2,35,17,18,-18,-15
Schurrle,477,2,304,2019-03-17T14:15:00Z,True,8,11,0,0,17,15,2,73,41,32,-56,-17
Schurrle,477,2,315,2019-03-30T12:30:00Z,True,8,12,20,1,17,15,2,74,45,29,-57,-14
Schurrle,477,2,328,2019-04-02T18:45:00Z,False,8,17,9,1,17,15,2,43,23,20,-26,-21
Schurrle,477,2,333,2019-04-13T14:00:00Z,True,8,7,0,0,17,15,2,46,28,18,-29,-3
Schurrle,477,2,341,2019-04-20T14:00:00Z,False,8,1,0,0,20,18,2,41,26,15,-21,-24
Schurrle,477,2,353,2019-04-27T14:00:00Z,True,8,4,0,0,23,18,5,31,20,11,-8,7
Schurrle,477,2,369,2019-05-04T14:00:00Z,False,8,19,0,0,26,21,5,54,31,23,-28,-26
Schurrle,477,2,373,2019-05-12T14:00:00Z,True,8,14,0,0,26,21,5,42,25,17,-16,4
Targett,478,1,7,2018-08-12T12:30:00Z,True,15,3,0,0,0,0,0,0,0,0,0,0
Targett,478,1,15,2018-08-18T14:00:00Z,False,15,7,0,0,1,1,0,1,0,1,0,0
Targett,478,1,27,2018-08-25T14:00:00Z,True,15,10,0,0,1,1,0,3,3,0,-2,1
Targett,478,1,34,2018-09-01T14:00:00Z,False,15,6,17,4,1,1,0,3,0,3,-2,0
Targett,478,1,46,2018-09-17T19:00:00Z,True,15,2,0,0,4,1,3,4,4,0,0,1
Targett,478,1,57,2018-09-22T14:00:00Z,False,15,11,54,0,5,2,3,15,6,9,-10,-3
Targett,478,1,69,2018-09-29T14:00:00Z,False,15,19,0,0,5,2,3,9,5,4,-4,-2
Targett,478,1,77,2018-10-07T13:15:00Z,True,15,5,0,0,5,2,3,17,10,7,-12,-5
Targett,478,1,81,2018-10-20T14:00:00Z,False,15,1,0,0,5,2,3,16,10,6,-11,-7
Targett,478,1,97,2018-10-27T14:00:00Z,True,15,14,0,0,6,2,4,2,0,2,4,0
Targett,478,1,106,2018-11-04T15:00:00Z,False,15,12,0,0,7,3,4,26,15,11,-19,-11
Targett,478,1,119,2018-11-10T15:00:00Z,True,15,17,0,0,7,3,4,19,12,7,-12,-4
Targett,478,1,124,2018-11-24T15:00:00Z,False,15,8,90,1,8,4,4,5,4,1,3,0
Targett,478,1,139,2018-12-01T17:30:00Z,True,15,13,0,0,8,4,4,21,11,10,-13,-6
Targett,478,1,149,2018-12-05T20:00:00Z,False,15,16,90,1,9,5,4,30,9,21,-21,-5
Targett,478,1,153,2018-12-08T15:00:00Z,False,15,4,90,3,9,5,4,11,10,1,-2,-6
Targett,478,1,166,2018-12-16T13:30:00Z,True,15,0,90,4,9,5,4,34,20,14,-25,-9
Targett,478,1,175,2018-12-22T15:00:00Z,False,15,9,90,2,12,8,4,10,5,5,2,-1
Targett,478,1,187,2018-12-27T19:45:00Z,True,15,18,90,0,15,8,7,24,13,11,-9,-3
Targett,478,1,197,2018-12-30T14:15:00Z,True,15,12,90,1,15,8,7,44,27,17,-29,-9
Targett,478,1,203,2019-01-02T19:45:00Z,False,15,5,0,0,15,8,7,43,21,22,-28,-14
Targett,478,1,216,2019-01-12T15:00:00Z,False,15,10,90,2,16,8,8,31,14,17,-15,-6
Targett,478,1,227,2019-01-19T15:00:00Z,True,15,7,34,1,19,8,11,30,21,9,-11,-1
Targett,478,1,238,2019-01-30T19:45:00Z,True,15,6,90,7,22,11,11,22,9,13,0,-2
Targett,478,1,241,2019-02-02T15:00:00Z,False,15,3,90,1,23,12,11,23,13,10,0,-2
Targett,478,1,256,2019-02-09T15:00:00Z,True,15,4,0,0,24,12,12,22,17,5,2,7
Targett,478,1,260,2019-02-24T14:05:00Z,False,15,0,90,1,24,12,12,50,32,18,-26,-20
Targett,478,1,279,2019-02-27T19:45:00Z,True,15,8,0,0,24,12,12,17,15,2,7,10
Targett,478,1,285,2019-03-02T15:00:00Z,False,15,13,0,0,27,15,12,55,26,29,-28,-14
Targett,478,1,299,2019-03-09T15:00:00Z,True,15,16,0,0,27,15,12,61,28,33,-34,-18
Targett,478,1,311,2019-03-30T15:00:00Z,False,15,2,0,0,30,18,12,33,22,11,-3,-10
Targett,478,1,326,2019-04-05T19:00:00Z,True,15,11,0,0,33,18,15,79,44,35,-46,-17
Targett,478,1,337,2019-04-13T14:00:00Z,True,15,19,0,0,33,18,15,47,27,20,-14,-2
Targett,478,1,347,2019-04-20T16:30:00Z,False,15,14,0,0,36,21,15,38,22,16,-2,-7
Targett,478,1,307,2019-04-23T18:45:00Z,False,15,17,0,0,36,21,15,49,26,23,-13,-11
Targett,478,1,357,2019-04-27T14:00:00Z,True,15,1,45,7,37,21,16,41,26,15,-4,6
Targett,478,1,368,2019-05-04T14:00:00Z,False,15,18,0,0,38,22,16,46,28,18,-8,-12
Targett,478,1,377,2019-05-12T14:00:00Z,True,15,9,45,1,38,22,16,15,9,6,23,16
Mitrovic,479,3,2,2018-08-11T14:00:00Z,True,8,6,90,2,0,0,0,0,0,0,0,0
Mitrovic,479,3,18,2018-08-18T14:00:00Z,False,8,16,90,6,0,0,0,3,0,3,-3,0
Mitrovic,479,3,22,2018-08-26T15:00:00Z,True,8,3,90,16,0,0,0,1,0,1,-1,-1
Mitrovic,479,3,30,2018-09-01T14:00:00Z,False,8,2,90,5,3,3,0,3,3,0,0,-3
Mitrovic,479,3,44,2018-09-15T14:00:00Z,False,8,12,90,2,4,3,1,10,6,4,-6,-5
Mitrovic,479,3,55,2018-09-22T11:30:00Z,True,8,17,90,8,4,3,1,12,9,3,-8,0
Mitrovic,479,3,64,2018-09-29T14:00:00Z,False,8,7,90,1,5,4,1,6,4,2,-1,-3
Mitrovic,479,3,73,2018-10-07T11:00:00Z,True,8,0,90,2,5,4,1,15,9,6,-10,-2
Mitrovic,479,3,82,2018-10-20T14:00:00Z,False,8,4,90,5,5,4,1,2,1,1,3,0
Mitrovic,479,3,93,2018-10-27T14:00:00Z,True,8,1,90,1,5,4,1,17,11,6,-12,-2
Mitrovic,479,3,105,2018-11-05T20:00:00Z,False,8,9,90,1,5,4,1,3,1,2,2,0
Mitrovic,479,3,116,2018-11-11T12:00:00Z,False,8,11,90,2,5,4,1,27,13,14,-22,-12
Mitrovic,479,3,124,2018-11-24T15:00:00Z,True,8,15,85,13,5,4,1,8,4,4,-3,0
Mitrovic,479,3,132,2018-12-02T12:00:00Z,False,8,5,90,2,8,7,1,28,15,13,-20,-14
Mitrovic,479,3,143,2018-12-05T19:45:00Z,True,8,10,90,5,8,7,1,21,11,10,-13,-3
Mitrovic,479,3,157,2018-12-08T15:00:00Z,False,8,13,45,1,9,8,1,23,12,11,-14,-11
Mitrovic,479,3,162,2018-12-15T17:30:00Z,True,8,18,90,2,9,8,1,21,13,8,-12,0
Mitrovic,479,3,177,2018-12-22T15:00:00Z,False,8,14,90,2,9,8,1,16,6,10,-7,-5
Mitrovic,479,3,183,2018-12-26T12:30:00Z,True,8,19,90,2,10,8,2,25,14,11,-15,-3
Mitrovic,479,3,193,2018-12-29T15:00:00Z,True,8,9,90,7,11,9,2,10,5,5,1,4
Mitrovic,479,3,200,2019-01-01T15:00:00Z,False,8,0,90,2,14,12,2,38,23,15,-24,-21
Mitrovic,479,3,211,2019-01-12T15:00:00Z,False,8,3,90,2,14,12,2,18,10,8,-4,-8
Mitrovic,479,3,222,2019-01-20T16:00:00Z,True,8,16,90,1,14,12,2,48,18,30,-34,-18
Mitrovic,479,3,232,2019-01-29T19:45:00Z,True,8,2,90,13,14,12,2,26,18,8,-12,4
Mitrovic,479,3,244,2019-02-02T15:00:00Z,False,8,6,90,2,17,15,2,23,9,14,-6,-7
Mitrovic,479,3,252,2019-02-09T12:30:00Z,True,8,13,90,1,17,15,2,48,25,23,-31,-8
Mitrovic,479,3,269,2019-02-22T19:45:00Z,False,8,18,90,2,17,15,2,33,18,15,-16,-16
Mitrovic,479,3,279,2019-02-27T19:45:00Z,False,8,15,90,2,17,15,2,24,12,12,-7,-10
Mitrovic,479,3,284,2019-03-03T14:05:00Z,True,8,5,90,2,17,15,2,53,31,22,-36,-7
Mitrovic,479,3,295,2019-03-09T15:00:00Z,False,8,10,90,2,17,15,2,35,17,18,-18,-15
Mitrovic,479,3,304,2019-03-17T14:15:00Z,True,8,11,90,2,17,15,2,73,41,32,-56,-17
Mitrovic,479,3,315,2019-03-30T12:30:00Z,True,8,12,0,0,17,15,2,74,45,29,-57,-14
Mitrovic,479,3,328,2019-04-02T18:45:00Z,False,8,17,90,2,17,15,2,43,23,20,-26,-21
Mitrovic,479,3,333,2019-04-13T14:00:00Z,True,8,7,90,5,17,15,2,46,28,18,-29,-3
Mitrovic,479,3,341,2019-04-20T14:00:00Z,False,8,1,90,5,20,18,2,41,26,15,-21,-24
Mitrovic,479,3,353,2019-04-27T14:00:00Z,True,8,4,90,2,23,18,5,31,20,11,-8,7
Mitrovic,479,3,369,2019-05-04T14:00:00Z,False,8,19,90,2,26,21,5,54,31,23,-28,-26
Mitrovic,479,3,373,2019-05-12T14:00:00Z,True,8,14,90,2,26,21,5,42,25,17,-16,4
Pereira,480,2,5,2018-08-10T19:00:00Z,True,13,10,90,1,0,0,0,0,0,0,0,0
Pereira,480,2,10,2018-08-19T15:00:00Z,False,13,2,45,1,3,3,0,0,0,0,3,0
Pereira,480,2,25,2018-08-27T19:00:00Z,True,13,16,0,0,3,3,0,6,3,3,-3,0
Pereira,480,2,31,2018-09-02T15:00:00Z,False,13,3,0,0,3,3,0,1,0,1,2,0
Pereira,480,2,48,2018-09-15T16:30:00Z,False,13,17,0,0,6,3,3,12,9,3,-6,-6
Pereira,480,2,58,2018-09-22T14:00:00Z,True,13,19,15,1,9,3,6,8,5,3,1,0
Pereira,480,2,68,2018-09-29T11:30:00Z,False,13,18,0,0,10,4,6,4,1,3,6,5
Pereira,480,2,76,2018-10-06T16:30:00Z,True,13,14,0,0,10,4,6,2,0,2,8,2
Pereira,480,2,83,2018-10-20T11:30:00Z,False,13,5,6,0,13,7,6,20,10,10,-7,-4
Pereira,480,2,96,2018-10-28T16:00:00Z,True,13,7,0,0,14,7,7,15,10,5,-1,2
Pereira,480,2,101,2018-11-03T12:30:00Z,False,13,1,0,0,17,10,7,20,11,9,-3,-4
Pereira,480,2,117,2018-11-11T16:30:00Z,False,13,12,0,0,20,10,10,29,18,11,-9,-8
Pereira,480,2,125,2018-11-24T15:00:00Z,True,13,6,0,0,20,10,10,8,2,6,12,4
Pereira,480,2,139,2018-12-01T17:30:00Z,False,13,15,0,0,21,11,10,8,4,4,13,6
Pereira,480,2,144,2018-12-05T20:00:00Z,True,13,0,0,0,22,11,11,30,17,13,-8,-2
Pereira,480,2,157,2018-12-08T15:00:00Z,True,13,8,0,0,23,12,11,9,8,1,14,11
Pereira,480,2,164,2018-12-16T16:00:00Z,False,13,11,0,0,26,15,11,42,19,23,-16,-8
Pereira,480,2,172,2018-12-22T17:30:00Z,False,13,4,3,1,26,15,11,14,13,1,12,-2
Pereira,480,2,186,2018-12-26T15:00:00Z,True,13,9,0,0,29,15,14,10,5,5,19,10
Pereira,480,2,196,2018-12-30T16:30:00Z,True,13,1,14,1,32,18,14,26,17,9,6,9
Pereira,480,2,207,2019-01-02T20:00:00Z,False,13,14,0,0,35,21,14,18,7,11,17,7
Pereira,480,2,218,2019-01-13T16:30:00Z,False,13,16,0,0,38,21,17,48,18,30,-10,-1
Pereira,480,2,225,2019-01-19T15:00:00Z,True,13,2,0,0,41,21,20,26,18,8,15,13
Pereira,480,2,234,2019-01-29T20:00:00Z,True,13,3,62,2,44,24,20,22,13,9,22,15
Pereira,480,2,246,2019-02-03T14:05:00Z,False,13,10,0,0,45,25,20,32,14,18,13,6
Pereira,480,2,252,2019-02-09T12:30:00Z,False,13,8,0,0,48,25,23,17,15,2,31,8
Pereira,480,2,267,2019-02-24T14:05:00Z,True,13,11,69,3,51,25,26,65,35,30,-14,-5
Pereira,480,2,272,2019-02-27T20:00:00Z,False,13,6,0,0,52,26,26,30,13,17,22,13
Pereira,480,2,285,2019-03-02T15:00:00Z,True,13,15,81,12,55,26,29,27,15,12,28,14
Pereira,480,2,290,2019-03-10T16:30:00Z,False,13,0,0,0,58,29,29,57,38,19,1,-9
Pereira,480,2,318,2019-03-30T15:00:00Z,True,13,17,27,0,58,29,29,43,23,20,15,9
Pereira,480,2,329,2019-04-02T18:45:00Z,False,13,19,6,1,61,32,29,44,24,20,17,5
Pereira,480,2,336,2019-04-13T16:30:00Z,True,13,18,15,1,61,32,29,42,27,15,19,17
Pereira,480,2,344,2019-04-21T12:30:00Z,False,13,7,13,1,64,35,29,46,28,18,18,1
Pereira,480,2,305,2019-04-24T19:00:00Z,True,13,12,71,1,64,35,29,86,51,35,-22,0
Pereira,480,2,356,2019-04-28T15:30:00Z,True,13,5,0,0,64,35,29,67,39,28,-3,7
Pereira,480,2,365,2019-05-05T13:00:00Z,False,13,9,0,0,65,36,29,14,8,6,51,21
Pereira,480,2,376,2019-05-12T14:00:00Z,True,13,4,73,1,66,36,30,31,20,11,35,25
Schar,481,1,6,2018-08-11T11:30:00Z,True,14,16,0,0,0,0,0,0,0,0,0,0
Schar,481,1,12,2018-08-18T11:30:00Z,False,14,4,0,0,0,0,0,0,0,0,0,0
Schar,481,1,26,2018-08-26T15:00:00Z,True,14,5,78,1,1,0,1,6,3,3,-5,-3
Schar,481,1,37,2018-09-01T16:30:00Z,False,14,12,0,0,1,0,1,7,3,4,-6,-2
Schar,481,1,45,2018-09-15T14:00:00Z,True,14,0,0,0,1,0,1,6,3,3,-5,-3
Schar,481,1,54,2018-09-22T14:00:00Z,False,14,6,0,0,1,0,1,6,0,6,-5,1
Schar,481,1,67,2018-09-29T14:00:00Z,True,14,10,0,0,2,0,2,9,6,3,-7,-3
Schar,481,1,76,2018-10-06T16:30:00Z,False,14,13,0,0,2,0,2,10,4,6,-8,-2
Schar,481,1,87,2018-10-20T14:00:00Z,True,14,2,0,0,2,0,2,8,7,1,-6,-1
Schar,481,1,97,2018-10-27T14:00:00Z,False,14,15,0,0,2,0,2,6,2,4,-4,0
Schar,481,1,107,2018-11-03T15:00:00Z,True,14,17,45,0,3,0,3,19,12,7,-16,-7
Schar,481,1,118,2018-11-10T15:00:00Z,True,14,1,90,1,6,3,3,20,11,9,-14,-6
Schar,481,1,122,2018-11-26T20:30:00Z,False,14,3,90,2,9,6,3,9,4,5,0,-1
Schar,481,1,138,2018-12-01T15:00:00Z,True,14,18,90,0,12,6,6,12,7,5,0,1
Schar,481,1,148,2018-12-05T19:45:00Z,False,14,7,90,1,12,6,6,22,16,6,-10,-10
Schar,481,1,158,2018-12-09T16:00:00Z,True,14,19,0,0,13,6,7,19,11,8,-6,-2
Schar,481,1,163,2018-12-15T15:00:00Z,False,14,9,90,6,13,6,7,10,5,5,3,2
Schar,481,1,177,2018-12-22T15:00:00Z,True,14,8,90,6,16,6,10,9,8,1,7,5
Schar,481,1,185,2018-12-26T15:00:00Z,False,14,11,0,0,17,7,10,48,22,26,-31,-12
Schar,481,1,199,2018-12-29T15:00:00Z,False,14,17,45,0,17,7,10,27,15,12,-10,-5
Schar,481,1,207,2019-01-02T20:00:00Z,True,14,13,80,1,18,7,11,35,21,14,-17,-7
Schar,481,1,213,2019-01-12T17:30:00Z,False,14,5,0,0,18,7,11,44,22,22,-26,-11
Schar,481,1,226,2019-01-19T15:00:00Z,True,14,4,90,21,18,7,11,19,14,5,-1,2
Schar,481,1,237,2019-01-29T20:00:00Z,True,14,12,90,1,21,10,11,56,33,23,-35,-13
Schar,481,1,248,2019-02-02T12:30:00Z,False,14,16,90,2,24,13,11,54,21,33,-30,-10
Schar,481,1,259,2019-02-11T20:00:00Z,False,14,19,90,4,24,13,11,38,20,18,-14,-9
Schar,481,1,268,2019-02-23T15:00:00Z,True,14,9,90,6,25,13,12,11,5,6,14,7
Schar,481,1,278,2019-02-26T20:00:00Z,True,14,3,90,15,28,16,12,30,17,13,-2,3
Schar,481,1,288,2019-03-02T17:30:00Z,False,14,18,64,0,31,19,12,36,21,15,-5,-9
Schar,481,1,298,2019-03-09T15:00:00Z,True,14,7,90,0,31,19,12,37,22,15,-6,4
Schar,481,1,300,2019-03-16T15:00:00Z,False,14,1,0,0,34,22,12,37,25,12,-3,-13
Schar,481,1,310,2019-04-01T19:00:00Z,False,14,0,0,0,35,22,13,60,41,19,-25,-28
Schar,481,1,325,2019-04-06T14:00:00Z,True,14,6,90,2,35,22,13,36,16,20,-1,2
Schar,481,1,334,2019-04-12T19:00:00Z,False,14,10,90,5,35,22,13,47,23,24,-12,-10
Schar,481,1,347,2019-04-20T16:30:00Z,True,14,15,68,2,38,22,16,36,21,15,2,7
Schar,481,1,350,2019-04-27T16:30:00Z,False,14,2,90,2,41,25,16,34,22,12,7,-6
Schar,481,1,367,2019-05-04T18:45:00Z,True,14,11,90,0,42,25,17,91,50,41,-49,-16
Schar,481,1,373,2019-05-12T14:00:00Z,False,14,8,90,15,42,25,17,26,21,5,16,-4
Jonny,482,1,9,2018-08-11T16:30:00Z,True,19,7,75,1,0,0,0,0,0,0,0,0
Jonny,482,1,16,2018-08-18T14:00:00Z,False,19,10,90,1,1,1,0,0,0,0,1,0
Jonny,482,1,29,2018-08-25T11:30:00Z,True,19,12,84,2,1,1,0,6,3,3,-5,-2
Jonny,482,1,39,2018-09-01T14:00:00Z,False,19,18,90,9,2,2,0,0,0,0,2,0
Jonny,482,1,49,2018-09-16T12:30:00Z,True,19,3,90,6,5,2,3,1,0,1,4,1
Jonny,482,1,58,2018-09-22T14:00:00Z,False,19,13,90,2,8,5,3,9,3,6,-1,0
Jonny,482,1,69,2018-09-29T14:00:00Z,True,19,15,90,12,9,5,4,5,2,3,4,2
Jonny,482,1,72,2018-10-06T14:00:00Z,False,19,6,90,5,12,8,4,7,1,6,5,3
Jonny,482,1,89,2018-10-20T14:00:00Z,True,19,17,45,0,15,8,7,13,9,4,2,4
Jonny,482,1,90,2018-10-27T14:00:00Z,False,19,2,84,2,15,8,7,11,7,4,4,0
Jonny,482,1,109,2018-11-03T19:45:00Z,True,19,16,90,4,15,8,7,21,6,15,-6,-7
Jonny,482,1,110,2018-11-11T16:30:00Z,False,19,0,90,2,15,8,7,23,13,10,-8,-6
Jonny,482,1,129,2018-11-25T16:00:00Z,True,19,9,0,0,16,8,8,7,5,2,9,6
Jonny,482,1,131,2018-11-30T20:00:00Z,False,19,4,0,0,16,8,8,8,7,1,8,1
Jonny,482,1,147,2018-12-05T19:45:00Z,True,19,5,0,0,16,8,8,31,18,13,-15,-5
Jonny,482,1,158,2018-12-09T16:00:00Z,False,19,14,0,0,19,11,8,13,6,7,6,2
Jonny,482,1,169,2018-12-15T15:00:00Z,True,19,1,90,7,22,11,11,23,14,9,-1,2
Jonny,482,1,179,2018-12-21T20:00:00Z,True,19,11,80,1,25,14,11,45,22,23,-20,-9
Jonny,482,1,183,2018-12-26T12:30:00Z,False,19,8,81,2,25,14,11,10,8,2,15,3
Jonny,482,1,198,2018-12-29T15:00:00Z,False,19,16,90,1,26,14,12,45,18,27,-19,-6
Jonny,482,1,209,2019-01-02T19:45:00Z,True,19,6,90,0,29,14,15,19,9,10,10,4
Jonny,482,1,217,2019-01-14T20:00:00Z,False,19,12,90,1,29,14,15,50,30,20,-21,-15
Jonny,482,1,229,2019-01-19T12:30:00Z,True,19,10,90,0,29,14,15,31,14,17,-2,-3
Jonny,482,1,235,2019-01-29T19:45:00Z,True,19,18,90,6,32,17,15,31,17,14,1,3
Jonny,482,1,245,2019-02-02T15:00:00Z,False,19,7,90,2,35,20,15,33,21,12,2,-6
Jonny,482,1,259,2019-02-11T20:00:00Z,True,19,14,90,2,38,20,18,24,13,11,14,9
Jonny,482,1,261,2019-02-23T15:00:00Z,False,19,1,90,2,39,21,18,33,24,9,6,-6
Jonny,482,1,273,2019-02-26T19:45:00Z,False,19,9,90,2,40,21,19,11,5,6,29,14
Jonny,482,1,289,2019-03-02T15:00:00Z,True,19,4,0,0,40,21,19,25,17,8,15,13
Jonny,482,1,292,2019-03-10T14:05:00Z,False,19,5,90,2,43,24,19,56,31,25,-13,-12
Jonny,482,1,312,2019-03-30T15:00:00Z,False,19,3,90,1,44,24,20,30,17,13,14,3
Jonny,482,1,329,2019-04-02T18:45:00Z,True,19,13,14,0,44,24,20,61,32,29,-17,-5
Jonny,482,1,337,2019-04-13T14:00:00Z,False,19,15,90,1,47,27,20,33,18,15,14,2
Jonny,482,1,349,2019-04-20T14:00:00Z,True,19,2,66,6,47,27,20,33,22,11,14,16
Jonny,482,1,309,2019-04-24T18:45:00Z,True,19,0,90,11,48,28,20,66,44,22,-18,6
Jonny,482,1,359,2019-04-27T14:00:00Z,False,19,17,90,2,51,31,20,50,27,23,1,-7
Jonny,482,1,369,2019-05-04T14:00:00Z,True,19,8,90,7,54,31,23,26,21,5,28,26
Jonny,482,1,375,2019-05-12T14:00:00Z,False,19,11,83,1,57,34,23,94,50,44,-37,-27
Digne,483,1,9,2018-08-11T16:30:00Z,False,7,19,4,1,0,0,0,0,0,0,0,0
Digne,483,1,15,2018-08-18T14:00:00Z,True,7,15,0,0,1,0,1,1,1,0,0,0
Digne,483,1,21,2018-08-25T14:00:00Z,False,7,1,0,0,4,3,1,6,3,3,-2,-2
Digne,483,1,35,2018-09-01T14:00:00Z,True,7,9,75,7,5,3,2,1,1,0,4,3
Digne,483,1,42,2018-09-16T15:00:00Z,True,7,18,90,1,6,4,2,0,0,0,6,4
Digne,483,1,50,2018-09-23T15:00:00Z,False,7,0,90,0,6,4,2,9,3,6,-3,-1
Digne,483,1,64,2018-09-29T14:00:00Z,True,7,8,90,6,6,4,2,5,4,1,1,3
Digne,483,1,74,2018-10-06T14:00:00Z,False,7,10,90,2,9,7,2,12,6,6,-3,-4
Digne,483,1,84,2018-10-21T15:00:00Z,True,7,6,90,6,12,7,5,7,1,6,5,1
Digne,483,1,96,2018-10-28T16:00:00Z,False,7,13,90,1,15,10,5,14,7,7,1,-2
Digne,483,1,104,2018-11-03T15:00:00Z,True,7,2,90,2,15,10,5,14,10,4,1,6
Digne,483,1,112,2018-11-11T14:15:00Z,False,7,5,90,7,18,13,5,27,14,13,-9,-9
Digne,483,1,123,2018-11-24T15:00:00Z,True,7,4,90,6,19,13,6,8,7,1,11,12
Digne,483,1,136,2018-12-02T16:15:00Z,False,7,11,90,2,22,16,6,33,16,17,-11,-10
Digne,483,1,148,2018-12-05T19:45:00Z,True,7,14,90,2,22,16,6,12,6,6,10,10
Digne,483,1,155,2018-12-10T20:00:00Z,True,7,17,90,10,23,17,6,20,12,8,3,9
Digne,483,1,165,2018-12-15T12:30:00Z,False,7,12,90,3,24,18,6,41,24,17,-17,-18
Digne,483,1,174,2018-12-23T16:00:00Z,True,7,16,90,-1,24,18,6,39,15,24,-15,-6
Digne,483,1,181,2018-12-26T15:00:00Z,False,7,3,90,17,24,18,6,12,7,5,12,-1
Digne,483,1,190,2018-12-29T15:00:00Z,False,7,2,90,2,27,18,9,22,15,7,5,-6
Digne,483,1,204,2019-01-01T12:30:00Z,True,7,10,90,1,27,18,9,28,14,14,-1,4
Digne,483,1,215,2019-01-13T14:15:00Z,True,7,1,90,12,27,18,9,27,18,9,0,9
Digne,483,1,227,2019-01-19T15:00:00Z,False,7,15,90,-1,30,21,9,19,8,11,11,1
Digne,483,1,233,2019-01-29T19:45:00Z,False,7,9,11,-2,30,21,9,11,5,6,19,4
Digne,483,1,245,2019-02-02T15:00:00Z,True,7,19,0,0,33,21,12,35,20,15,-2,6
Digne,483,1,265,2019-02-06T19:45:00Z,True,7,12,90,1,33,21,12,59,36,23,-26,-2
Digne,483,1,258,2019-02-09T15:00:00Z,False,7,17,90,2,33,21,12,34,17,17,-1,-5
Digne,483,1,271,2019-02-26T19:45:00Z,False,7,4,90,5,33,21,12,25,17,8,8,-5
Digne,483,1,283,2019-03-03T16:15:00Z,True,7,11,90,7,36,21,15,69,38,31,-33,-10
Digne,483,1,298,2019-03-09T15:00:00Z,False,7,14,90,4,37,22,15,31,19,12,6,-4
Digne,483,1,303,2019-03-17T16:30:00Z,True,7,5,90,6,37,22,15,57,32,25,-20,-3
Digne,483,1,319,2019-03-30T17:30:00Z,False,7,18,90,6,40,25,15,42,27,15,-2,-12
Digne,483,1,322,2019-04-07T13:05:00Z,True,7,0,90,8,43,25,18,63,44,19,-20,6
Digne,483,1,333,2019-04-13T14:00:00Z,False,7,8,90,1,46,28,18,17,15,2,29,3
Digne,483,1,344,2019-04-21T12:30:00Z,True,7,13,84,14,46,28,18,64,35,29,-18,-1
Digne,483,1,352,2019-04-27T14:00:00Z,False,7,6,90,8,49,31,18,42,16,26,7,2
Digne,483,1,364,2019-05-03T19:00:00Z,True,7,3,90,12,50,31,19,40,23,17,10,14
Digne,483,1,378,2019-05-12T14:00:00Z,False,7,16,90,0,53,34,19,70,37,33,-17,-18
Lindegaard,484,0,7,2018-08-12T12:30:00Z,False,3,15,0,0,0,0,0,0,0,0,0,0
Lindegaard,484,0,11,2018-08-19T12:30:00Z,True,3,17,0,0,1,0,1,3,3,0,-2,0
Lindegaard,484,0,22,2018-08-26T15:00:00Z,False,3,8,0,0,1,0,1,0,0,0,1,1
Lindegaard,484,0,31,2018-09-02T15:00:00Z,True,3,13,0,0,1,0,1,3,3,0,-2,0
Lindegaard,484,0,49,2018-09-16T12:30:00Z,False,3,19,0,0,1,0,1,5,2,3,-4,-1
Lindegaard,484,0,52,2018-09-22T14:00:00Z,True,3,1,0,0,1,0,1,10,7,3,-9,-3
Lindegaard,484,0,62,2018-09-30T15:00:00Z,False,3,4,0,0,4,3,1,2,1,1,2,0
Lindegaard,484,0,71,2018-10-06T14:00:00Z,True,3,9,0,0,7,3,4,2,1,1,5,2
Lindegaard,484,0,86,2018-10-20T14:00:00Z,False,3,12,0,0,8,4,4,20,12,8,-12,-8
Lindegaard,484,0,91,2018-10-28T13:30:00Z,True,3,5,0,0,8,4,4,21,11,10,-13,-6
Lindegaard,484,0,108,2018-11-03T15:00:00Z,False,3,18,0,0,8,4,4,8,4,4,0,0
Lindegaard,484,0,115,2018-11-10T15:00:00Z,False,3,10,0,0,8,4,4,16,7,9,-8,-3
Lindegaard,484,0,122,2018-11-26T20:30:00Z,True,3,14,0,0,9,4,5,9,6,3,0,1
Lindegaard,484,0,133,2018-12-01T15:00:00Z,False,3,6,0,0,9,4,5,9,2,7,0,3
Lindegaard,484,0,142,2018-12-05T19:45:00Z,True,3,11,0,0,9,4,5,36,19,17,-27,-13
Lindegaard,484,0,152,2018-12-08T15:00:00Z,True,3,2,0,0,9,4,5,21,14,7,-12,-3
Lindegaard,484,0,167,2018-12-15T15:00:00Z,False,3,16,0,0,12,7,5,36,12,24,-24,-7
Lindegaard,484,0,170,2018-12-22T12:30:00Z,False,3,0,0,0,12,7,5,34,20,14,-22,-15
Lindegaard,484,0,181,2018-12-26T15:00:00Z,True,3,7,0,0,12,7,5,24,18,6,-12,1
Lindegaard,484,0,191,2018-12-30T14:15:00Z,True,3,18,0,0,12,7,5,27,13,14,-15,-7
Lindegaard,484,0,205,2019-01-02T19:45:00Z,False,3,9,0,0,15,10,5,10,5,5,5,0
Lindegaard,484,0,211,2019-01-12T15:00:00Z,True,3,8,0,0,18,10,8,14,12,2,4,8
Lindegaard,484,0,228,2019-01-19T15:00:00Z,False,3,17,0,0,21,13,8,32,16,16,-11,-8
Lindegaard,484,0,234,2019-01-29T20:00:00Z,False,3,13,0,0,22,13,9,44,24,20,-22,-15
Lindegaard,484,0,241,2019-02-02T15:00:00Z,True,3,15,0,0,23,13,10,23,12,11,0,2
Lindegaard,484,0,250,2019-02-09T17:30:00Z,False,3,2,0,0,24,14,10,27,19,8,-3,-9
Lindegaard,484,0,262,2019-02-23T12:30:00Z,True,3,16,0,0,27,14,13,60,27,33,-33,-19
Lindegaard,484,0,278,2019-02-26T20:00:00Z,False,3,14,0,0,30,17,13,28,16,12,2,-3
Lindegaard,484,0,282,2019-03-02T15:00:00Z,True,3,6,0,0,30,17,13,30,13,17,0,0
Lindegaard,484,0,296,2019-03-10T12:00:00Z,False,3,11,0,0,30,17,13,70,38,32,-40,-25
Lindegaard,484,0,302,2019-03-16T15:00:00Z,True,3,10,0,0,30,17,13,38,20,18,-8,-1
Lindegaard,484,0,312,2019-03-30T15:00:00Z,True,3,19,0,0,30,17,13,44,24,20,-14,-3
Lindegaard,484,0,320,2019-04-06T14:00:00Z,False,3,1,0,0,33,20,13,38,26,12,-5,-13
Lindegaard,484,0,331,2019-04-13T14:00:00Z,True,3,4,0,0,36,20,16,28,20,8,8,12
Lindegaard,484,0,343,2019-04-22T19:00:00Z,False,3,5,0,0,39,23,16,66,38,28,-27,-22
Lindegaard,484,0,351,2019-04-28T13:05:00Z,True,3,12,0,0,40,23,17,89,51,38,-49,-15
Lindegaard,484,0,364,2019-05-03T19:00:00Z,False,3,7,0,0,40,23,17,50,31,19,-10,-14
Lindegaard,484,0,371,2019-05-12T14:00:00Z,True,3,0,0,0,40,23,17,67,45,22,-27,1
Meyer,485,2,2,2018-08-11T14:00:00Z,False,6,8,0,0,0,0,0,0,0,0,0,0
Meyer,485,2,14,2018-08-20T19:00:00Z,True,6,11,7,1,3,0,3,3,3,0,0,0
Meyer,485,2,28,2018-08-26T12:30:00Z,False,6,17,15,3,3,0,3,6,3,3,-3,0
Meyer,485,2,34,2018-09-01T14:00:00Z,True,6,15,14,1,3,0,3,1,1,0,2,0
Meyer,485,2,43,2018-09-15T14:00:00Z,False,6,9,0,0,3,0,3,2,1,1,1,2
Meyer,485,2,54,2018-09-22T14:00:00Z,True,6,14,27,1,6,0,6,1,0,1,5,-1
Meyer,485,2,61,2018-10-01T19:00:00Z,False,6,1,83,2,7,1,6,10,7,3,-3,-1
Meyer,485,2,72,2018-10-06T14:00:00Z,True,6,19,27,1,7,1,6,12,8,4,-5,-3
Meyer,485,2,84,2018-10-21T15:00:00Z,False,6,7,0,0,7,1,6,12,7,5,-5,-1
Meyer,485,2,92,2018-10-28T13:30:00Z,True,6,0,29,1,7,1,6,21,12,9,-14,-8
Meyer,485,2,103,2018-11-04T16:00:00Z,False,6,5,70,2,8,2,6,24,11,13,-16,-5
Meyer,485,2,113,2018-11-10T17:30:00Z,True,6,16,66,2,8,2,6,24,6,18,-16,-16
Meyer,485,2,125,2018-11-24T15:00:00Z,False,6,13,90,3,8,2,6,20,10,10,-12,-4
Meyer,485,2,133,2018-12-01T15:00:00Z,True,6,3,90,2,9,2,7,9,4,5,0,-3
Meyer,485,2,141,2018-12-04T19:45:00Z,False,6,2,90,2,12,5,7,18,11,7,-6,-4
Meyer,485,2,159,2018-12-08T15:00:00Z,False,6,18,83,5,12,5,7,18,10,8,-6,-3
Meyer,485,2,161,2018-12-15T15:00:00Z,True,6,10,90,3,12,5,7,22,11,11,-10,-6
Meyer,485,2,176,2018-12-22T15:00:00Z,False,6,12,90,5,15,8,7,44,27,17,-29,-20
Meyer,485,2,182,2018-12-26T15:00:00Z,True,6,4,62,3,18,8,10,14,13,1,4,7
Meyer,485,2,192,2018-12-30T12:00:00Z,True,6,5,12,1,19,9,10,40,21,19,-21,-10
Meyer,485,2,209,2019-01-02T19:45:00Z,False,6,19,0,0,19,9,10,29,14,15,-10,-4
Meyer,485,2,214,2019-01-12T15:00:00Z,True,6,17,0,0,22,9,13,29,16,13,-7,-4
Meyer,485,2,224,2019-01-19T15:00:00Z,False,6,11,9,6,22,9,13,57,28,29,-35,-15
Meyer,485,2,238,2019-01-30T19:45:00Z,False,6,15,0,0,22,9,13,22,11,11,0,2
Meyer,485,2,244,2019-02-02T15:00:00Z,True,6,8,18,1,23,9,14,17,15,2,6,7
Meyer,485,2,251,2019-02-09T15:00:00Z,True,6,18,11,1,26,12,14,32,18,14,-6,-2
Meyer,485,2,266,2019-02-23T17:30:00Z,False,6,10,0,0,27,13,14,32,14,18,-5,0
Meyer,485,2,272,2019-02-27T20:00:00Z,True,6,13,29,1,30,13,17,52,26,26,-22,-13
Meyer,485,2,282,2019-03-02T15:00:00Z,False,6,3,70,2,30,13,17,30,17,13,0,0
Meyer,485,2,293,2019-03-09T12:30:00Z,True,6,2,13,1,33,13,20,30,22,8,3,5
Meyer,485,2,314,2019-03-30T15:00:00Z,True,6,9,45,1,33,13,20,14,8,6,19,7
Meyer,485,2,306,2019-04-03T18:45:00Z,False,6,16,0,0,36,16,20,61,28,33,-25,-8
Meyer,485,2,325,2019-04-06T14:00:00Z,False,6,14,0,0,36,16,20,35,22,13,1,-2
Meyer,485,2,332,2019-04-14T13:05:00Z,True,6,12,13,1,39,16,23,80,48,32,-41,-16
Meyer,485,2,340,2019-04-21T15:00:00Z,False,6,0,79,2,39,16,23,66,44,22,-27,-21
Meyer,485,2,352,2019-04-27T14:00:00Z,True,6,7,71,3,42,16,26,49,31,18,-7,-2
Meyer,485,2,362,2019-05-04T16:30:00Z,False,6,4,12,1,43,17,26,31,20,11,12,6
Meyer,485,2,372,2019-05-12T14:00:00Z,True,6,1,90,2,46,17,29,45,29,16,1,1
Mawson,486,1,2,2018-08-11T14:00:00Z,True,8,6,0,0,0,0,0,0,0,0,0,0
Mawson,486,1,18,2018-08-18T14:00:00Z,False,8,16,0,0,0,0,0,3,0,3,-3,0
Mawson,486,1,22,2018-08-26T15:00:00Z,True,8,3,0,0,0,0,0,1,0,1,-1,-1
Mawson,486,1,30,2018-09-01T14:00:00Z,False,8,2,90,1,3,3,0,3,3,0,0,-3
Mawson,486,1,44,2018-09-15T14:00:00Z,False,8,12,90,1,4,3,1,10,6,4,-6,-5
Mawson,486,1,55,2018-09-22T11:30:00Z,True,8,17,45,0,4,3,1,12,9,3,-8,0
Mawson,486,1,64,2018-09-29T14:00:00Z,False,8,7,0,0,5,4,1,6,4,2,-1,-3
Mawson,486,1,73,2018-10-07T11:00:00Z,True,8,0,0,0,5,4,1,15,9,6,-10,-2
Mawson,486,1,82,2018-10-20T14:00:00Z,False,8,4,45,0,5,4,1,2,1,1,3,0
Mawson,486,1,93,2018-10-27T14:00:00Z,True,8,1,0,0,5,4,1,17,11,6,-12,-2
Mawson,486,1,105,2018-11-05T20:00:00Z,False,8,9,0,0,5,4,1,3,1,2,2,0
Mawson,486,1,116,2018-11-11T12:00:00Z,False,8,11,90,1,5,4,1,27,13,14,-22,-12
Mawson,486,1,124,2018-11-24T15:00:00Z,True,8,15,90,0,5,4,1,8,4,4,-3,0
Mawson,486,1,132,2018-12-02T12:00:00Z,False,8,5,90,1,8,7,1,28,15,13,-20,-14
Mawson,486,1,143,2018-12-05T19:45:00Z,True,8,10,90,2,8,7,1,21,11,10,-13,-3
Mawson,486,1,157,2018-12-08T15:00:00Z,False,8,13,90,0,9,8,1,23,12,11,-14,-11
Mawson,486,1,162,2018-12-15T17:30:00Z,True,8,18,90,1,9,8,1,21,13,8,-12,0
Mawson,486,1,177,2018-12-22T15:00:00Z,False,8,14,90,8,9,8,1,16,6,10,-7,-5
Mawson,486,1,183,2018-12-26T12:30:00Z,True,8,19,90,2,10,8,2,25,14,11,-15,-3
Mawson,486,1,193,2018-12-29T15:00:00Z,True,8,9,45,1,11,9,2,10,5,5,1,4
Mawson,486,1,200,2019-01-01T15:00:00Z,False,8,0,0,0,14,12,2,38,23,15,-24,-21
Mawson,486,1,211,2019-01-12T15:00:00Z,False,8,3,0,0,14,12,2,18,10,8,-4,-8
Mawson,486,1,222,2019-01-20T16:00:00Z,True,8,16,0,0,14,12,2,48,18,30,-34,-18
Mawson,486,1,232,2019-01-29T19:45:00Z,True,8,2,0,0,14,12,2,26,18,8,-12,4
Mawson,486,1,244,2019-02-02T15:00:00Z,False,8,6,0,0,17,15,2,23,9,14,-6,-7
Mawson,486,1,252,2019-02-09T12:30:00Z,True,8,13,0,0,17,15,2,48,25,23,-31,-8
Mawson,486,1,269,2019-02-22T19:45:00Z,False,8,18,0,0,17,15,2,33,18,15,-16,-16
Mawson,486,1,279,2019-02-27T19:45:00Z,False,8,15,0,0,17,15,2,24,12,12,-7,-10
Mawson,486,1,284,2019-03-03T14:05:00Z,True,8,5,0,0,17,15,2,53,31,22,-36,-7
Mawson,486,1,295,2019-03-09T15:00:00Z,False,8,10,0,0,17,15,2,35,17,18,-18,-15
Mawson,486,1,304,2019-03-17T14:15:00Z,True,8,11,0,0,17,15,2,73,41,32,-56,-17
Mawson,486,1,315,2019-03-30T12:30:00Z,True,8,12,0,0,17,15,2,74,45,29,-57,-14
Mawson,486,1,328,2019-04-02T18:45:00Z,False,8,17,0,0,17,15,2,43,23,20,-26,-21
Mawson,486,1,333,2019-04-13T14:00:00Z,True,8,7,0,0,17,15,2,46,28,18,-29,-3
Mawson,486,1,341,2019-04-20T14:00:00Z,False,8,1,0,0,20,18,2,41,26,15,-21,-24
Mawson,486,1,353,2019-04-27T14:00:00Z,True,8,4,5,1,23,18,5,31,20,11,-8,7
Mawson,486,1,369,2019-05-04T14:00:00Z,False,8,19,0,0,26,21,5,54,31,23,-28,-26
Mawson,486,1,373,2019-05-12T14:00:00Z,True,8,14,90,0,26,21,5,42,25,17,-16,4
Muto,487,3,6,2018-08-11T11:30:00Z,True,14,16,9,1,0,0,0,0,0,0,0,0
Muto,487,3,12,2018-08-18T11:30:00Z,False,14,4,25,1,0,0,0,0,0,0,0,0
Muto,487,3,26,2018-08-26T15:00:00Z,True,14,5,11,1,1,0,1,6,3,3,-5,-3
Muto,487,3,37,2018-09-01T16:30:00Z,False,14,12,0,0,1,0,1,7,3,4,-6,-2
Muto,487,3,45,2018-09-15T14:00:00Z,True,14,0,11,1,1,0,1,6,3,3,-5,-3
Muto,487,3,54,2018-09-22T14:00:00Z,False,14,6,9,1,1,0,1,6,0,6,-5,1
Muto,487,3,67,2018-09-29T14:00:00Z,True,14,10,21,1,2,0,2,9,6,3,-7,-3
Muto,487,3,76,2018-10-06T16:30:00Z,False,14,13,77,6,2,0,2,10,4,6,-8,-2
Muto,487,3,87,2018-10-20T14:00:00Z,True,14,2,73,2,2,0,2,8,7,1,-6,-1
Muto,487,3,97,2018-10-27T14:00:00Z,False,14,15,79,2,2,0,2,6,2,4,-4,0
Muto,487,3,107,2018-11-03T15:00:00Z,True,14,17,45,1,3,0,3,19,12,7,-16,-7
Muto,487,3,118,2018-11-10T15:00:00Z,True,14,1,0,0,6,3,3,20,11,9,-14,-6
Muto,487,3,122,2018-11-26T20:30:00Z,False,14,3,0,0,9,6,3,9,4,5,0,-1
Muto,487,3,138,2018-12-01T15:00:00Z,True,14,18,0,0,12,6,6,12,7,5,0,1
Muto,487,3,148,2018-12-05T19:45:00Z,False,14,7,0,0,12,6,6,22,16,6,-10,-10
Muto,487,3,158,2018-12-09T16:00:00Z,True,14,19,0,0,13,6,7,19,11,8,-6,-2
Muto,487,3,163,2018-12-15T15:00:00Z,False,14,9,0,0,13,6,7,10,5,5,3,2
Muto,487,3,177,2018-12-22T15:00:00Z,True,14,8,0,0,16,6,10,9,8,1,7,5
Muto,487,3,185,2018-12-26T15:00:00Z,False,14,11,90,2,17,7,10,48,22,26,-31,-12
Muto,487,3,199,2018-12-29T15:00:00Z,False,14,17,0,0,17,7,10,27,15,12,-10,-5
Muto,487,3,207,2019-01-02T20:00:00Z,True,14,13,9,1,18,7,11,35,21,14,-17,-7
Muto,487,3,213,2019-01-12T17:30:00Z,False,14,5,0,0,18,7,11,44,22,22,-26,-11
Muto,487,3,226,2019-01-19T15:00:00Z,True,14,4,0,0,18,7,11,19,14,5,-1,2
Muto,487,3,237,2019-01-29T20:00:00Z,True,14,12,0,0,21,10,11,56,33,23,-35,-13
Muto,487,3,248,2019-02-02T12:30:00Z,False,14,16,0,0,24,13,11,54,21,33,-30,-10
Muto,487,3,259,2019-02-11T20:00:00Z,False,14,19,0,0,24,13,11,38,20,18,-14,-9
Muto,487,3,268,2019-02-23T15:00:00Z,True,14,9,0,0,25,13,12,11,5,6,14,7
Muto,487,3,278,2019-02-26T20:00:00Z,True,14,3,0,0,28,16,12,30,17,13,-2,3
Muto,487,3,288,2019-03-02T17:30:00Z,False,14,18,0,0,31,19,12,36,21,15,-5,-9
Muto,487,3,298,2019-03-09T15:00:00Z,True,14,7,0,0,31,19,12,37,22,15,-6,4
Muto,487,3,300,2019-03-16T15:00:00Z,False,14,1,8,1,34,22,12,37,25,12,-3,-13
Muto,487,3,310,2019-04-01T19:00:00Z,False,14,0,13,1,35,22,13,60,41,19,-25,-28
Muto,487,3,325,2019-04-06T14:00:00Z,True,14,6,0,0,35,22,13,36,16,20,-1,2
Muto,487,3,334,2019-04-12T19:00:00Z,False,14,10,0,0,35,22,13,47,23,24,-12,-10
Muto,487,3,347,2019-04-20T16:30:00Z,True,14,15,0,0,38,22,16,36,21,15,2,7
Muto,487,3,350,2019-04-27T16:30:00Z,False,14,2,9,0,41,25,16,34,22,12,7,-6
Muto,487,3,367,2019-05-04T18:45:00Z,True,14,11,1,1,42,25,17,91,50,41,-49,-16
Muto,487,3,373,2019-05-12T14:00:00Z,False,14,8,24,1,42,25,17,26,21,5,16,-4
Snodgrass,488,2,4,2018-08-12T12:30:00Z,False,18,11,45,1,0,0,0,0,0,0,0,0
Snodgrass,488,2,19,2018-08-18T14:00:00Z,True,18,1,76,2,0,0,0,3,3,0,-3,0
Snodgrass,488,2,20,2018-08-25T14:00:00Z,False,18,0,74,2,0,0,0,0,0,0,0,0
Snodgrass,488,2,39,2018-09-01T14:00:00Z,True,18,19,45,1,0,0,0,2,2,0,-2,0
Snodgrass,488,2,42,2018-09-16T15:00:00Z,False,18,7,8,0,0,0,0,6,4,2,-6,-4
Snodgrass,488,2,59,2018-09-23T12:30:00Z,True,18,5,16,0,3,0,3,15,9,6,-12,-6
Snodgrass,488,2,68,2018-09-29T11:30:00Z,True,18,13,18,1,4,1,3,10,4,6,-6,-5
Snodgrass,488,2,70,2018-10-05T19:00:00Z,False,18,2,7,0,7,4,3,5,4,1,2,-1
Snodgrass,488,2,88,2018-10-20T14:00:00Z,True,18,16,90,1,7,4,3,18,6,12,-11,-8
Snodgrass,488,2,94,2018-10-27T16:30:00Z,False,18,10,90,2,7,4,3,12,6,6,-5,-3
Snodgrass,488,2,108,2018-11-03T15:00:00Z,True,18,3,90,2,8,4,4,8,4,4,0,0
Snodgrass,488,2,114,2018-11-10T15:00:00Z,False,18,9,90,1,11,7,4,6,4,2,5,0
Snodgrass,488,2,128,2018-11-24T15:00:00Z,True,18,12,0,0,12,7,5,32,21,11,-20,-4
Snodgrass,488,2,138,2018-12-01T15:00:00Z,False,18,14,90,5,12,7,5,12,6,6,0,-1
Snodgrass,488,2,146,2018-12-04T19:45:00Z,True,18,4,75,11,15,7,8,11,10,1,4,6
Snodgrass,488,2,159,2018-12-08T15:00:00Z,True,18,6,90,8,18,10,8,12,5,7,6,3
Snodgrass,488,2,162,2018-12-15T17:30:00Z,False,18,8,90,11,21,13,8,9,8,1,12,0
Snodgrass,488,2,178,2018-12-22T15:00:00Z,True,18,17,90,2,24,13,11,24,15,9,0,4
Snodgrass,488,2,187,2018-12-27T19:45:00Z,False,18,15,90,2,24,13,11,15,8,7,9,3
Snodgrass,488,2,191,2018-12-30T14:15:00Z,False,18,3,45,0,27,13,14,12,7,5,15,7
Snodgrass,488,2,208,2019-01-02T19:45:00Z,True,18,2,62,2,27,13,14,25,18,7,2,6
Snodgrass,488,2,219,2019-01-12T12:30:00Z,True,18,0,19,1,28,14,14,41,26,15,-13,-1
Snodgrass,488,2,221,2019-01-19T15:00:00Z,False,18,1,24,1,31,17,14,27,18,9,4,-4
Snodgrass,488,2,235,2019-01-29T19:45:00Z,False,18,19,68,1,31,17,14,32,17,15,-1,-3
Snodgrass,488,2,249,2019-02-04T20:00:00Z,True,18,11,90,2,31,17,14,61,32,29,-30,-12
Snodgrass,488,2,251,2019-02-09T15:00:00Z,False,18,6,90,2,32,18,14,26,12,14,6,2
Snodgrass,488,2,269,2019-02-22T19:45:00Z,True,18,8,90,8,33,18,15,17,15,2,16,16
Snodgrass,488,2,277,2019-02-27T20:00:00Z,False,18,12,0,0,36,21,15,65,39,26,-29,-24
Snodgrass,488,2,288,2019-03-02T17:30:00Z,True,18,14,90,6,36,21,15,31,19,12,5,9
Snodgrass,488,2,291,2019-03-09T15:00:00Z,False,18,4,90,2,39,24,15,25,17,8,14,-2
Snodgrass,488,2,308,2019-03-16T15:00:00Z,True,18,9,0,0,39,24,15,14,8,6,25,18
Snodgrass,488,2,319,2019-03-30T17:30:00Z,True,18,7,90,2,42,27,15,40,25,15,2,12
Snodgrass,488,2,321,2019-04-08T19:00:00Z,False,18,5,45,1,42,27,15,63,35,28,-21,-20
Snodgrass,488,2,336,2019-04-13T16:30:00Z,False,18,13,90,2,42,27,15,61,32,29,-19,-17
Snodgrass,488,2,348,2019-04-20T14:00:00Z,True,18,10,72,1,42,27,15,47,23,24,-5,3
Snodgrass,488,2,358,2019-04-27T11:30:00Z,False,18,16,76,2,43,28,15,70,37,33,-27,-22
Snodgrass,488,2,368,2019-05-04T14:00:00Z,True,18,15,0,0,46,28,18,38,22,16,8,12
Snodgrass,488,2,379,2019-05-12T14:00:00Z,False,18,17,0,0,49,31,18,50,27,23,-1,-9
Hart,489,0,7,2018-08-12T12:30:00Z,False,3,15,90,7,0,0,0,0,0,0,0,0
Hart,489,0,11,2018-08-19T12:30:00Z,True,3,17,90,2,1,0,1,3,3,0,-2,0
Hart,489,0,22,2018-08-26T15:00:00Z,False,3,8,90,2,1,0,1,0,0,0,1,1
Hart,489,0,31,2018-09-02T15:00:00Z,True,3,13,90,10,1,0,1,3,3,0,-2,0
Hart,489,0,49,2018-09-16T12:30:00Z,False,3,19,90,3,1,0,1,5,2,3,-4,-1
Hart,489,0,52,2018-09-22T14:00:00Z,True,3,1,90,9,1,0,1,10,7,3,-9,-3
Hart,489,0,62,2018-09-30T15:00:00Z,False,3,4,90,3,4,3,1,2,1,1,2,0
Hart,489,0,71,2018-10-06T14:00:00Z,True,3,9,90,2,7,3,4,2,1,1,5,2
Hart,489,0,86,2018-10-20T14:00:00Z,False,3,12,90,1,8,4,4,20,12,8,-12,-8
Hart,489,0,91,2018-10-28T13:30:00Z,True,3,5,90,1,8,4,4,21,11,10,-13,-6
Hart,489,0,108,2018-11-03T15:00:00Z,False,3,18,90,1,8,4,4,8,4,4,0,0
Hart,489,0,115,2018-11-10T15:00:00Z,False,3,10,90,10,8,4,4,16,7,9,-8,-3
Hart,489,0,122,2018-11-26T20:30:00Z,True,3,14,90,1,9,4,5,9,6,3,0,1
Hart,489,0,133,2018-12-01T15:00:00Z,False,3,6,90,3,9,4,5,9,2,7,0,3
Hart,489,0,142,2018-12-05T19:45:00Z,True,3,11,90,3,9,4,5,36,19,17,-27,-13
Hart,489,0,152,2018-12-08T15:00:00Z,True,3,2,90,7,9,4,5,21,14,7,-12,-3
Hart,489,0,167,2018-12-15T15:00:00Z,False,3,16,90,2,12,7,5,36,12,24,-24,-7
Hart,489,0,170,2018-12-22T12:30:00Z,False,3,0,90,2,12,7,5,34,20,14,-22,-15
Hart,489,0,181,2018-12-26T15:00:00Z,True,3,7,90,0,12,7,5,24,18,6,-12,1
Hart,489,0,191,2018-12-30T14:15:00Z,True,3,18,0,0,12,7,5,27,13,14,-15,-7
Hart,489,0,205,2019-01-02T19:45:00Z,False,3,9,0,0,15,10,5,10,5,5,5,0
Hart,489,0,211,2019-01-12T15:00:00Z,True,3,8,0,0,18,10,8,14,12,2,4,8
Hart,489,0,228,2019-01-19T15:00:00Z,False,3,17,0,0,21,13,8,32,16,16,-11,-8
Hart,489,0,234,2019-01-29T20:00:00Z,False,3,13,0,0,22,13,9,44,24,20,-22,-15
Hart,489,0,241,2019-02-02T15:00:00Z,True,3,15,0,0,23,13,10,23,12,11,0,2
Hart,489,0,250,2019-02-09T17:30:00Z,False,3,2,0,0,24,14,10,27,19,8,-3,-9
Hart,489,0,262,2019-02-23T12:30:00Z,True,3,16,0,0,27,14,13,60,27,33,-33,-19
Hart,489,0,278,2019-02-26T20:00:00Z,False,3,14,0,0,30,17,13,28,16,12,2,-3
Hart,489,0,282,2019-03-02T15:00:00Z,True,3,6,0,0,30,17,13,30,13,17,0,0
Hart,489,0,296,2019-03-10T12:00:00Z,False,3,11,0,0,30,17,13,70,38,32,-40,-25
Hart,489,0,302,2019-03-16T15:00:00Z,True,3,10,0,0,30,17,13,38,20,18,-8,-1
Hart,489,0,312,2019-03-30T15:00:00Z,True,3,19,0,0,30,17,13,44,24,20,-14,-3
Hart,489,0,320,2019-04-06T14:00:00Z,False,3,1,0,0,33,20,13,38,26,12,-5,-13
Hart,489,0,331,2019-04-13T14:00:00Z,True,3,4,0,0,36,20,16,28,20,8,8,12
Hart,489,0,343,2019-04-22T19:00:00Z,False,3,5,0,0,39,23,16,66,38,28,-27,-22
Hart,489,0,351,2019-04-28T13:05:00Z,True,3,12,0,0,40,23,17,89,51,38,-49,-15
Hart,489,0,364,2019-05-03T19:00:00Z,False,3,7,0,0,40,23,17,50,31,19,-10,-14
Hart,489,0,371,2019-05-12T14:00:00Z,True,3,0,0,0,40,23,17,67,45,22,-27,1
Gibson,490,1,7,2018-08-12T12:30:00Z,False,3,15,0,0,0,0,0,0,0,0,0,0
Gibson,490,1,11,2018-08-19T12:30:00Z,True,3,17,0,0,1,0,1,3,3,0,-2,0
Gibson,490,1,22,2018-08-26T15:00:00Z,False,3,8,0,0,1,0,1,0,0,0,1,1
Gibson,490,1,31,2018-09-02T15:00:00Z,True,3,13,0,0,1,0,1,3,3,0,-2,0
Gibson,490,1,49,2018-09-16T12:30:00Z,False,3,19,0,0,1,0,1,5,2,3,-4,-1
Gibson,490,1,52,2018-09-22T14:00:00Z,True,3,1,0,0,1,0,1,10,7,3,-9,-3
Gibson,490,1,62,2018-09-30T15:00:00Z,False,3,4,0,0,4,3,1,2,1,1,2,0
Gibson,490,1,71,2018-10-06T14:00:00Z,True,3,9,0,0,7,3,4,2,1,1,5,2
Gibson,490,1,86,2018-10-20T14:00:00Z,False,3,12,0,0,8,4,4,20,12,8,-12,-8
Gibson,490,1,91,2018-10-28T13:30:00Z,True,3,5,0,0,8,4,4,21,11,10,-13,-6
Gibson,490,1,108,2018-11-03T15:00:00Z,False,3,18,0,0,8,4,4,8,4,4,0,0
Gibson,490,1,115,2018-11-10T15:00:00Z,False,3,10,0,0,8,4,4,16,7,9,-8,-3
Gibson,490,1,122,2018-11-26T20:30:00Z,True,3,14,0,0,9,4,5,9,6,3,0,1
Gibson,490,1,133,2018-12-01T15:00:00Z,False,3,6,0,0,9,4,5,9,2,7,0,3
Gibson,490,1,142,2018-12-05T19:45:00Z,True,3,11,0,0,9,4,5,36,19,17,-27,-13
Gibson,490,1,152,2018-12-08T15:00:00Z,True,3,2,0,0,9,4,5,21,14,7,-12,-3
Gibson,490,1,167,2018-12-15T15:00:00Z,False,3,16,0,0,12,7,5,36,12,24,-24,-7
Gibson,490,1,170,2018-12-22T12:30:00Z,False,3,0,0,0,12,7,5,34,20,14,-22,-15
Gibson,490,1,181,2018-12-26T15:00:00Z,True,3,7,62,6,12,7,5,24,18,6,-12,1
Gibson,490,1,191,2018-12-30T14:15:00Z,True,3,18,0,0,12,7,5,27,13,14,-15,-7
Gibson,490,1,205,2019-01-02T19:45:00Z,False,3,9,0,0,15,10,5,10,5,5,5,0
Gibson,490,1,211,2019-01-12T15:00:00Z,True,3,8,0,0,18,10,8,14,12,2,4,8
Gibson,490,1,228,2019-01-19T15:00:00Z,False,3,17,0,0,21,13,8,32,16,16,-11,-8
Gibson,490,1,234,2019-01-29T20:00:00Z,False,3,13,0,0,22,13,9,44,24,20,-22,-15
Gibson,490,1,241,2019-02-02T15:00:00Z,True,3,15,0,0,23,13,10,23,12,11,0,2
Gibson,490,1,250,2019-02-09T17:30:00Z,False,3,2,0,0,24,14,10,27,19,8,-3,-9
Gibson,490,1,262,2019-02-23T12:30:00Z,True,3,16,0,0,27,14,13,60,27,33,-33,-19
Gibson,490,1,278,2019-02-26T20:00:00Z,False,3,14,0,0,30,17,13,28,16,12,2,-3
Gibson,490,1,282,2019-03-02T15:00:00Z,True,3,6,0,0,30,17,13,30,13,17,0,0
Gibson,490,1,296,2019-03-10T12:00:00Z,False,3,11,0,0,30,17,13,70,38,32,-40,-25
Gibson,490,1,302,2019-03-16T15:00:00Z,True,3,10,0,0,30,17,13,38,20,18,-8,-1
Gibson,490,1,312,2019-03-30T15:00:00Z,True,3,19,0,0,30,17,13,44,24,20,-14,-3
Gibson,490,1,320,2019-04-06T14:00:00Z,False,3,1,0,0,33,20,13,38,26,12,-5,-13
Gibson,490,1,331,2019-04-13T14:00:00Z,True,3,4,0,0,36,20,16,28,20,8,8,12
Gibson,490,1,343,2019-04-22T19:00:00Z,False,3,5,0,0,39,23,16,66,38,28,-27,-22
Gibson,490,1,351,2019-04-28T13:05:00Z,True,3,12,0,0,40,23,17,89,51,38,-49,-15
Gibson,490,1,364,2019-05-03T19:00:00Z,False,3,7,0,0,40,23,17,50,31,19,-10,-14
Gibson,490,1,371,2019-05-12T14:00:00Z,True,3,0,0,0,40,23,17,67,45,22,-27,1
Ghezzal,491,2,5,2018-08-10T19:00:00Z,False,10,13,27,1,0,0,0,0,0,0,0,0
Ghezzal,491,2,16,2018-08-18T14:00:00Z,True,10,19,0,0,0,0,0,1,1,0,-1,0
Ghezzal,491,2,27,2018-08-25T14:00:00Z,False,10,15,12,1,3,3,0,1,1,0,2,-1
Ghezzal,491,2,36,2018-09-01T11:30:00Z,True,10,11,90,8,6,3,3,9,6,3,-3,0
Ghezzal,491,2,40,2018-09-15T14:00:00Z,False,10,1,60,2,6,3,3,7,4,3,-1,-1
Ghezzal,491,2,56,2018-09-22T14:00:00Z,True,10,9,45,0,6,3,3,2,1,1,4,2
Ghezzal,491,2,67,2018-09-29T14:00:00Z,False,10,14,0,0,9,6,3,2,0,2,7,3
Ghezzal,491,2,74,2018-10-06T14:00:00Z,True,10,7,10,1,12,6,6,9,7,2,3,4
Ghezzal,491,2,80,2018-10-22T19:00:00Z,False,10,0,21,1,12,6,6,18,9,9,-6,-3
Ghezzal,491,2,94,2018-10-27T16:30:00Z,True,10,18,45,1,12,6,6,7,4,3,5,3
Ghezzal,491,2,102,2018-11-03T15:00:00Z,False,10,4,0,0,13,7,6,5,4,1,8,2
Ghezzal,491,2,115,2018-11-10T15:00:00Z,True,10,3,90,3,16,7,9,8,4,4,8,3
Ghezzal,491,2,121,2018-11-24T15:00:00Z,False,10,2,0,0,17,8,9,14,10,4,3,-1
Ghezzal,491,2,135,2018-12-01T15:00:00Z,True,10,17,0,0,18,8,10,20,12,8,-2,0
Ghezzal,491,2,143,2018-12-05T19:45:00Z,False,10,8,0,0,21,11,10,8,7,1,13,3
Ghezzal,491,2,156,2018-12-08T19:45:00Z,True,10,16,34,1,22,11,11,33,12,21,-11,-10
Ghezzal,491,2,161,2018-12-15T15:00:00Z,False,10,6,45,1,22,11,11,12,5,7,10,6
Ghezzal,491,2,173,2018-12-22T15:00:00Z,False,10,5,0,0,22,11,11,37,21,16,-15,-10
Ghezzal,491,2,184,2018-12-26T15:00:00Z,True,10,12,0,0,25,11,14,44,27,17,-19,-6
Ghezzal,491,2,194,2018-12-29T15:00:00Z,True,10,4,32,1,28,14,14,15,13,2,13,12
Ghezzal,491,2,204,2019-01-01T12:30:00Z,False,10,7,45,1,28,14,14,27,18,9,1,-4
Ghezzal,491,2,216,2019-01-12T15:00:00Z,True,10,15,14,1,31,14,17,16,8,8,15,6
Ghezzal,491,2,229,2019-01-19T12:30:00Z,False,10,19,0,0,31,14,17,29,14,15,2,3
Ghezzal,491,2,236,2019-01-30T20:00:00Z,False,10,11,0,0,31,14,17,60,31,29,-29,-14
Ghezzal,491,2,246,2019-02-03T14:05:00Z,True,10,13,28,0,32,14,18,45,25,20,-13,-6
Ghezzal,491,2,257,2019-02-10T13:30:00Z,False,10,16,71,2,32,14,18,57,24,33,-25,-6
Ghezzal,491,2,266,2019-02-23T17:30:00Z,True,10,6,45,1,32,14,18,27,13,14,5,0
Ghezzal,491,2,274,2019-02-26T19:45:00Z,True,10,2,0,0,32,14,18,27,19,8,5,6
Ghezzal,491,2,287,2019-03-03T12:00:00Z,False,10,17,0,0,35,17,18,40,20,20,-5,-2
Ghezzal,491,2,295,2019-03-09T15:00:00Z,True,10,8,18,1,35,17,18,17,15,2,18,15
Ghezzal,491,2,302,2019-03-16T15:00:00Z,False,10,3,0,0,38,20,18,30,17,13,8,1
Ghezzal,491,2,316,2019-03-30T15:00:00Z,True,10,1,1,1,41,20,21,38,26,12,3,8
Ghezzal,491,2,323,2019-04-06T14:00:00Z,False,10,9,0,0,44,23,21,14,8,6,30,13
Ghezzal,491,2,334,2019-04-12T19:00:00Z,True,10,14,0,0,47,23,24,35,22,13,12,10
Ghezzal,491,2,348,2019-04-20T14:00:00Z,False,10,18,0,0,47,23,24,42,27,15,5,-3
Ghezzal,491,2,354,2019-04-28T11:00:00Z,True,10,0,0,0,48,23,25,66,44,22,-18,1
Ghezzal,491,2,366,2019-05-06T19:00:00Z,False,10,12,0,0,51,26,25,92,51,41,-41,-26
Ghezzal,491,2,374,2019-05-12T14:00:00Z,True,10,5,0,0,51,26,25,71,42,29,-20,-3
Rondon,492,3,6,2018-08-11T11:30:00Z,True,14,16,31,1,0,0,0,0,0,0,0,0
Rondon,492,3,12,2018-08-18T11:30:00Z,False,14,4,0,0,0,0,0,0,0,0,0,0
Rondon,492,3,26,2018-08-26T15:00:00Z,True,14,5,61,2,1,0,1,6,3,3,-5,-3
Rondon,492,3,37,2018-09-01T16:30:00Z,False,14,12,72,5,1,0,1,7,3,4,-6,-2
Rondon,492,3,45,2018-09-15T14:00:00Z,True,14,0,0,0,1,0,1,6,3,3,-5,-3
Rondon,492,3,54,2018-09-22T14:00:00Z,False,14,6,45,1,1,0,1,6,0,6,-5,1
Rondon,492,3,67,2018-09-29T14:00:00Z,True,14,10,0,0,2,0,2,9,6,3,-7,-3
Rondon,492,3,76,2018-10-06T16:30:00Z,False,14,13,0,0,2,0,2,10,4,6,-8,-2
Rondon,492,3,87,2018-10-20T14:00:00Z,True,14,2,0,0,2,0,2,8,7,1,-6,-1
Rondon,492,3,97,2018-10-27T14:00:00Z,False,14,15,21,1,2,0,2,6,2,4,-4,0
Rondon,492,3,107,2018-11-03T15:00:00Z,True,14,17,90,2,3,0,3,19,12,7,-16,-7
Rondon,492,3,118,2018-11-10T15:00:00Z,True,14,1,90,12,6,3,3,20,11,9,-14,-6
Rondon,492,3,122,2018-11-26T20:30:00Z,False,14,3,70,2,9,6,3,9,4,5,0,-1
Rondon,492,3,138,2018-12-01T15:00:00Z,True,14,18,90,2,12,6,6,12,7,5,0,1
Rondon,492,3,148,2018-12-05T19:45:00Z,False,14,7,73,9,12,6,6,22,16,6,-10,-10
Rondon,492,3,158,2018-12-09T16:00:00Z,True,14,19,85,5,13,6,7,19,11,8,-6,-2
Rondon,492,3,163,2018-12-15T15:00:00Z,False,14,9,80,7,13,6,7,10,5,5,3,2
Rondon,492,3,177,2018-12-22T15:00:00Z,True,14,8,90,2,16,6,10,9,8,1,7,5
Rondon,492,3,185,2018-12-26T15:00:00Z,False,14,11,0,0,17,7,10,48,22,26,-31,-12
Rondon,492,3,199,2018-12-29T15:00:00Z,False,14,17,90,8,17,7,10,27,15,12,-10,-5
Rondon,492,3,207,2019-01-02T20:00:00Z,True,14,13,90,2,18,7,11,35,21,14,-17,-7
Rondon,492,3,213,2019-01-12T17:30:00Z,False,14,5,90,2,18,7,11,44,22,22,-26,-11
Rondon,492,3,226,2019-01-19T15:00:00Z,True,14,4,90,5,18,7,11,19,14,5,-1,2
Rondon,492,3,237,2019-01-29T20:00:00Z,True,14,12,90,8,21,10,11,56,33,23,-35,-13
Rondon,492,3,248,2019-02-02T12:30:00Z,False,14,16,90,2,24,13,11,54,21,33,-30,-10
Rondon,492,3,259,2019-02-11T20:00:00Z,False,14,19,90,2,24,13,11,38,20,18,-14,-9
Rondon,492,3,268,2019-02-23T15:00:00Z,True,14,9,83,12,25,13,12,11,5,6,14,7
Rondon,492,3,278,2019-02-26T20:00:00Z,True,14,3,90,2,28,16,12,30,17,13,-2,3
Rondon,492,3,288,2019-03-02T17:30:00Z,False,14,18,90,2,31,19,12,36,21,15,-5,-9
Rondon,492,3,298,2019-03-09T15:00:00Z,True,14,7,90,11,31,19,12,37,22,15,-6,4
Rondon,492,3,300,2019-03-16T15:00:00Z,False,14,1,90,8,34,22,12,37,25,12,-3,-13
Rondon,492,3,310,2019-04-01T19:00:00Z,False,14,0,90,2,35,22,13,60,41,19,-25,-28
Rondon,492,3,325,2019-04-06T14:00:00Z,True,14,6,90,2,35,22,13,36,16,20,-1,2
Rondon,492,3,334,2019-04-12T19:00:00Z,False,14,10,90,2,35,22,13,47,23,24,-12,-10
Rondon,492,3,347,2019-04-20T16:30:00Z,True,14,15,90,5,38,22,16,36,21,15,2,7
Rondon,492,3,350,2019-04-27T16:30:00Z,False,14,2,90,5,41,25,16,34,22,12,7,-6
Rondon,492,3,367,2019-05-04T18:45:00Z,True,14,11,90,11,42,25,17,91,50,41,-49,-16
Rondon,492,3,373,2019-05-12T14:00:00Z,False,14,8,90,6,42,25,17,26,21,5,16,-4
Lerma,493,2,1,2018-08-11T14:00:00Z,True,1,4,0,0,0,0,0,0,0,0,0,0
Lerma,493,2,19,2018-08-18T14:00:00Z,False,1,18,0,0,3,3,0,0,0,0,3,0
Lerma,493,2,21,2018-08-25T14:00:00Z,True,1,7,0,0,6,3,3,4,3,1,2,2
Lerma,493,2,33,2018-09-01T14:00:00Z,False,1,5,87,1,7,4,3,9,3,6,-2,0
Lerma,493,2,40,2018-09-15T14:00:00Z,True,1,10,77,2,7,4,3,6,3,3,1,1
Lerma,493,2,52,2018-09-22T14:00:00Z,False,1,3,90,2,10,7,3,1,0,1,9,3
Lerma,493,2,61,2018-10-01T19:00:00Z,True,1,6,90,5,10,7,3,7,1,6,3,1
Lerma,493,2,79,2018-10-06T14:00:00Z,False,1,17,90,3,13,10,3,13,9,4,0,-6
Lerma,493,2,81,2018-10-20T14:00:00Z,True,1,15,90,3,16,10,6,5,2,3,11,7
Lerma,493,2,93,2018-10-27T14:00:00Z,False,1,8,90,3,17,11,6,5,4,1,12,2
Lerma,493,2,101,2018-11-03T12:30:00Z,True,1,13,90,1,20,11,9,17,10,7,3,4
Lerma,493,2,118,2018-11-10T15:00:00Z,False,1,14,45,8,20,11,9,6,3,3,14,6
Lerma,493,2,120,2018-11-25T13:30:00Z,True,1,0,90,-1,20,11,9,24,14,10,-4,1
Lerma,493,2,137,2018-12-01T15:00:00Z,False,1,12,0,0,20,11,9,35,21,14,-15,-12
Lerma,493,2,140,2018-12-04T19:45:00Z,True,1,9,90,2,20,11,9,10,5,5,10,6
Lerma,493,2,151,2018-12-08T12:30:00Z,True,1,11,90,1,23,14,9,39,19,20,-16,-6
Lerma,493,2,169,2018-12-15T15:00:00Z,False,1,19,90,1,23,14,9,22,11,11,1,-2
Lerma,493,2,171,2018-12-22T15:00:00Z,True,1,2,90,2,23,14,9,21,14,7,2,7
Lerma,493,2,188,2018-12-26T15:00:00Z,False,1,16,90,1,26,17,9,42,15,27,-16,-6
Lerma,493,2,196,2018-12-30T16:30:00Z,False,1,13,0,0,26,17,9,32,18,14,-6,-9
Lerma,493,2,201,2019-01-02T19:45:00Z,True,1,17,90,2,26,17,9,28,16,12,-2,5
Lerma,493,2,215,2019-01-13T14:15:00Z,False,1,7,90,2,27,18,9,27,18,9,0,-9
Lerma,493,2,221,2019-01-19T15:00:00Z,True,1,18,90,3,27,18,9,31,17,14,-4,4
Lerma,493,2,231,2019-01-30T19:45:00Z,True,1,5,0,0,30,21,9,47,25,22,-17,-1
Lerma,493,2,242,2019-02-02T17:30:00Z,False,1,4,21,1,33,24,9,19,14,5,14,-5
Lerma,493,2,254,2019-02-09T15:00:00Z,False,1,11,72,2,33,24,9,62,32,30,-29,-23
Lerma,493,2,261,2019-02-23T15:00:00Z,True,1,19,90,1,33,24,9,39,21,18,-6,6
Lerma,493,2,270,2019-02-27T19:45:00Z,False,1,0,0,0,34,25,9,53,35,18,-19,-26
Lerma,493,2,280,2019-03-02T15:00:00Z,True,1,12,0,0,34,25,9,68,42,26,-34,-1
Lerma,493,2,294,2019-03-09T15:00:00Z,False,1,9,90,3,34,25,9,14,8,6,20,1
Lerma,493,2,300,2019-03-16T15:00:00Z,True,1,14,90,1,37,25,12,34,22,12,3,13
Lerma,493,2,316,2019-03-30T15:00:00Z,False,1,10,63,2,38,26,12,41,20,21,-3,-8
Lerma,493,2,320,2019-04-06T14:00:00Z,True,1,3,70,6,38,26,12,33,20,13,5,13
Lerma,493,2,330,2019-04-13T14:00:00Z,False,1,2,90,3,38,26,12,33,22,11,5,-10
Lerma,493,2,341,2019-04-20T14:00:00Z,True,1,8,90,2,41,26,15,20,18,2,21,24
Lerma,493,2,357,2019-04-27T14:00:00Z,False,1,15,90,2,41,26,15,37,21,16,4,-6
Lerma,493,2,361,2019-05-04T11:30:00Z,True,1,16,90,2,42,26,16,70,37,33,-28,-7
Lerma,493,2,372,2019-05-12T14:00:00Z,False,1,6,90,9,45,29,16,46,17,29,-1,-1
Vydra,494,3,7,2018-08-12T12:30:00Z,False,3,15,0,0,0,0,0,0,0,0,0,0
Vydra,494,3,11,2018-08-19T12:30:00Z,True,3,17,0,0,1,0,1,3,3,0,-2,0
Vydra,494,3,22,2018-08-26T15:00:00Z,False,3,8,0,0,1,0,1,0,0,0,1,1
Vydra,494,3,31,2018-09-02T15:00:00Z,True,3,13,6,1,1,0,1,3,3,0,-2,0
Vydra,494,3,49,2018-09-16T12:30:00Z,False,3,19,34,1,1,0,1,5,2,3,-4,-1
Vydra,494,3,52,2018-09-22T14:00:00Z,True,3,1,59,5,1,0,1,10,7,3,-9,-3
Vydra,494,3,62,2018-09-30T15:00:00Z,False,3,4,71,2,4,3,1,2,1,1,2,0
Vydra,494,3,71,2018-10-06T14:00:00Z,True,3,9,1,1,7,3,4,2,1,1,5,2
Vydra,494,3,86,2018-10-20T14:00:00Z,False,3,12,0,0,8,4,4,20,12,8,-12,-8
Vydra,494,3,91,2018-10-28T13:30:00Z,True,3,5,0,0,8,4,4,21,11,10,-13,-6
Vydra,494,3,108,2018-11-03T15:00:00Z,False,3,18,71,2,8,4,4,8,4,4,0,0
Vydra,494,3,115,2018-11-10T15:00:00Z,False,3,10,0,0,8,4,4,16,7,9,-8,-3
Vydra,494,3,122,2018-11-26T20:30:00Z,True,3,14,0,0,9,4,5,9,6,3,0,1
Vydra,494,3,133,2018-12-01T15:00:00Z,False,3,6,0,0,9,4,5,9,2,7,0,3
Vydra,494,3,142,2018-12-05T19:45:00Z,True,3,11,7,0,9,4,5,36,19,17,-27,-13
Vydra,494,3,152,2018-12-08T15:00:00Z,True,3,2,0,0,9,4,5,21,14,7,-12,-3
Vydra,494,3,167,2018-12-15T15:00:00Z,False,3,16,0,0,12,7,5,36,12,24,-24,-7
Vydra,494,3,170,2018-12-22T12:30:00Z,False,3,0,13,1,12,7,5,34,20,14,-22,-15
Vydra,494,3,181,2018-12-26T15:00:00Z,True,3,7,0,0,12,7,5,24,18,6,-12,1
Vydra,494,3,191,2018-12-30T14:15:00Z,True,3,18,0,0,12,7,5,27,13,14,-15,-7
Vydra,494,3,205,2019-01-02T19:45:00Z,False,3,9,0,0,15,10,5,10,5,5,5,0
Vydra,494,3,211,2019-01-12T15:00:00Z,True,3,8,0,0,18,10,8,14,12,2,4,8
Vydra,494,3,228,2019-01-19T15:00:00Z,False,3,17,0,0,21,13,8,32,16,16,-11,-8
Vydra,494,3,234,2019-01-29T20:00:00Z,False,3,13,0,0,22,13,9,44,24,20,-22,-15
Vydra,494,3,241,2019-02-02T15:00:00Z,True,3,15,0,0,23,13,10,23,12,11,0,2
Vydra,494,3,250,2019-02-09T17:30:00Z,False,3,2,0,0,24,14,10,27,19,8,-3,-9
Vydra,494,3,262,2019-02-23T12:30:00Z,True,3,16,0,0,27,14,13,60,27,33,-33,-19
Vydra,494,3,278,2019-02-26T20:00:00Z,False,3,14,7,1,30,17,13,28,16,12,2,-3
Vydra,494,3,282,2019-03-02T15:00:00Z,True,3,6,0,0,30,17,13,30,13,17,0,0
Vydra,494,3,296,2019-03-10T12:00:00Z,False,3,11,4,4,30,17,13,70,38,32,-40,-25
Vydra,494,3,302,2019-03-16T15:00:00Z,True,3,10,1,1,30,17,13,38,20,18,-8,-1
Vydra,494,3,312,2019-03-30T15:00:00Z,True,3,19,0,0,30,17,13,44,24,20,-14,-3
Vydra,494,3,320,2019-04-06T14:00:00Z,False,3,1,0,0,33,20,13,38,26,12,-5,-13
Vydra,494,3,331,2019-04-13T14:00:00Z,True,3,4,0,0,36,20,16,28,20,8,8,12
Vydra,494,3,343,2019-04-22T19:00:00Z,False,3,5,0,0,39,23,16,66,38,28,-27,-22
Vydra,494,3,351,2019-04-28T13:05:00Z,True,3,12,18,1,40,23,17,89,51,38,-49,-15
Vydra,494,3,364,2019-05-03T19:00:00Z,False,3,7,18,1,40,23,17,50,31,19,-10,-14
Vydra,494,3,371,2019-05-12T14:00:00Z,True,3,0,0,0,40,23,17,67,45,22,-27,1
Abraham,495,3,3,2018-08-11T14:00:00Z,False,5,9,0,0,0,0,0,0,0,0,0,0
Abraham,495,3,13,2018-08-18T16:30:00Z,True,5,0,0,0,3,0,3,0,0,0,3,0
Abraham,495,3,26,2018-08-26T15:00:00Z,False,5,14,0,0,6,3,3,1,0,1,5,3
Abraham,495,3,33,2018-09-01T14:00:00Z,True,5,1,0,0,9,3,6,7,4,3,2,0
Abraham,495,3,41,2018-09-15T14:00:00Z,True,5,4,0,0,12,6,6,2,1,1,10,5
Abraham,495,3,59,2018-09-23T12:30:00Z,False,5,18,0,0,15,9,6,3,0,3,12,6
Abraham,495,3,63,2018-09-29T16:30:00Z,True,5,11,0,0,16,9,7,18,9,9,-2,0
Abraham,495,3,77,2018-10-07T13:15:00Z,False,5,15,0,0,17,10,7,5,2,3,12,5
Abraham,495,3,83,2018-10-20T11:30:00Z,True,5,13,0,0,20,10,10,13,7,6,7,4
Abraham,495,3,91,2018-10-28T13:30:00Z,False,5,3,0,0,21,11,10,8,4,4,13,6
Abraham,495,3,103,2018-11-04T16:00:00Z,True,5,6,0,0,24,11,13,8,2,6,16,5
Abraham,495,3,112,2018-11-11T14:15:00Z,True,5,7,0,0,27,14,13,18,13,5,9,9
Abraham,495,3,126,2018-11-24T17:30:00Z,False,5,16,0,0,28,15,13,27,6,21,1,7
Abraham,495,3,132,2018-12-02T12:00:00Z,True,5,8,0,0,28,15,13,8,7,1,20,14
Abraham,495,3,147,2018-12-05T19:45:00Z,False,5,19,0,0,31,18,13,16,8,8,15,5
Abraham,495,3,154,2018-12-08T17:30:00Z,True,5,12,0,0,31,18,13,41,24,17,-10,1
Abraham,495,3,160,2018-12-16T13:30:00Z,False,5,2,0,0,34,21,13,21,14,7,13,-1
Abraham,495,3,173,2018-12-22T15:00:00Z,True,5,10,0,0,37,21,16,22,11,11,15,10
Abraham,495,3,189,2018-12-26T19:30:00Z,False,5,17,0,0,37,21,16,27,15,12,10,1
Abraham,495,3,192,2018-12-30T12:00:00Z,False,5,6,0,0,40,21,19,19,9,10,21,10
Abraham,495,3,203,2019-01-02T19:45:00Z,True,5,15,0,0,43,21,22,15,8,7,28,14
Abraham,495,3,213,2019-01-12T17:30:00Z,True,5,14,0,0,44,22,22,18,7,11,26,11
Abraham,495,3,220,2019-01-19T17:30:00Z,False,5,0,0,0,47,25,22,41,26,15,6,-4
Abraham,495,3,231,2019-01-30T19:45:00Z,False,5,1,0,0,47,25,22,30,21,9,17,1
Abraham,495,3,243,2019-02-02T15:00:00Z,True,5,9,0,0,47,25,22,11,5,6,36,19
Abraham,495,3,255,2019-02-10T16:00:00Z,False,5,12,0,0,50,28,22,62,36,26,-12,-14
Abraham,495,3,275,2019-02-27T20:00:00Z,True,5,16,0,0,50,28,22,60,27,33,-10,-5
Abraham,495,3,284,2019-03-03T14:05:00Z,False,5,8,0,0,53,31,22,17,15,2,36,7
Abraham,495,3,292,2019-03-10T14:05:00Z,True,5,19,0,0,56,31,25,43,24,19,13,12
Abraham,495,3,303,2019-03-17T16:30:00Z,False,5,7,0,0,57,32,25,37,22,15,20,3
Abraham,495,3,313,2019-03-31T13:05:00Z,False,5,4,0,0,57,32,25,28,20,8,29,5
Abraham,495,3,264,2019-04-03T18:45:00Z,True,5,2,0,0,60,32,28,33,22,11,27,21
Abraham,495,3,321,2019-04-08T19:00:00Z,True,5,18,0,0,63,35,28,42,27,15,21,20
Abraham,495,3,335,2019-04-14T15:30:00Z,False,5,11,0,0,66,38,28,82,44,38,-16,-16
Abraham,495,3,343,2019-04-22T19:00:00Z,True,5,3,0,0,66,38,28,39,23,16,27,22
Abraham,495,3,356,2019-04-28T15:30:00Z,False,5,13,0,0,67,39,28,64,35,29,3,-7
Abraham,495,3,363,2019-05-05T13:00:00Z,True,5,17,0,0,68,39,29,50,27,23,18,16
Abraham,495,3,374,2019-05-12T14:00:00Z,False,5,10,0,0,71,42,29,51,26,25,20,3
Nkoudou,496,2,6,2018-08-11T11:30:00Z,False,16,14,0,0,0,0,0,0,0,0,0,0
Nkoudou,496,2,18,2018-08-18T14:00:00Z,True,16,8,0,0,3,0,3,0,0,0,3,0
Nkoudou,496,2,25,2018-08-27T19:00:00Z,False,16,13,0,0,6,3,3,3,3,0,3,0
Nkoudou,496,2,38,2018-09-02T15:00:00Z,False,16,17,0,0,9,3,6,9,6,3,0,0
Nkoudou,496,2,47,2018-09-15T11:30:00Z,True,16,11,0,0,9,3,6,12,6,6,-3,-3
Nkoudou,496,2,51,2018-09-22T16:30:00Z,False,16,2,0,0,9,3,6,5,4,1,4,2
Nkoudou,496,2,65,2018-09-29T14:00:00Z,False,16,9,0,0,12,3,9,2,1,1,10,8
Nkoudou,496,2,78,2018-10-06T14:00:00Z,True,16,4,0,0,15,3,12,2,1,1,13,2
Nkoudou,496,2,88,2018-10-20T14:00:00Z,False,16,18,0,0,18,6,12,7,4,3,11,8
Nkoudou,496,2,98,2018-10-29T20:00:00Z,True,16,12,0,0,21,6,15,23,15,8,-2,-2
Nkoudou,496,2,109,2018-11-03T19:45:00Z,False,16,19,0,0,21,6,15,15,8,7,6,7
Nkoudou,496,2,113,2018-11-10T17:30:00Z,False,16,6,0,0,24,6,18,8,2,6,16,16
Nkoudou,496,2,126,2018-11-24T17:30:00Z,True,16,5,0,0,27,6,21,28,15,13,-1,-7
Nkoudou,496,2,130,2018-12-02T14:05:00Z,False,16,0,0,0,30,9,21,27,14,13,3,7
Nkoudou,496,2,149,2018-12-05T20:00:00Z,True,16,15,0,0,30,9,21,9,5,4,21,5
Nkoudou,496,2,156,2018-12-08T19:45:00Z,False,16,10,0,0,33,12,21,22,11,11,11,10
Nkoudou,496,2,167,2018-12-15T15:00:00Z,True,16,3,0,0,36,12,24,12,7,5,24,7
Nkoudou,496,2,174,2018-12-23T16:00:00Z,False,16,7,0,0,39,15,24,24,18,6,15,6
Nkoudou,496,2,188,2018-12-26T15:00:00Z,True,16,1,0,0,42,15,27,26,17,9,16,6
Nkoudou,496,2,198,2018-12-29T15:00:00Z,True,16,19,0,0,45,18,27,26,14,12,19,6
Nkoudou,496,2,202,2019-01-01T17:30:00Z,False,16,4,0,0,45,18,27,18,13,5,27,14
Nkoudou,496,2,218,2019-01-13T16:30:00Z,True,16,13,0,0,48,18,30,38,21,17,10,1
Nkoudou,496,2,222,2019-01-20T16:00:00Z,False,16,8,4,4,48,18,30,14,12,2,34,18
Nkoudou,496,2,239,2019-01-30T20:00:00Z,True,16,17,0,0,51,18,33,33,17,16,18,2
Nkoudou,496,2,248,2019-02-02T12:30:00Z,True,16,14,0,0,54,21,33,24,13,11,30,10
Nkoudou,496,2,257,2019-02-10T13:30:00Z,True,16,10,0,0,57,24,33,32,14,18,25,6
Nkoudou,496,2,262,2019-02-23T12:30:00Z,False,16,3,0,0,60,27,33,27,14,13,33,19
Nkoudou,496,2,275,2019-02-27T20:00:00Z,False,16,5,0,0,60,27,33,50,28,22,10,5
Nkoudou,496,2,286,2019-03-02T12:30:00Z,True,16,0,0,0,60,27,33,56,38,18,4,9
Nkoudou,496,2,299,2019-03-09T15:00:00Z,False,16,15,0,0,61,28,33,27,15,12,34,18
Nkoudou,496,2,317,2019-03-31T15:30:00Z,False,16,11,0,0,61,28,33,76,41,35,-15,-8
Nkoudou,496,2,306,2019-04-03T18:45:00Z,True,16,6,0,0,61,28,33,36,16,20,25,8
Nkoudou,496,2,338,2019-04-13T11:30:00Z,True,16,9,0,0,64,31,33,14,8,6,50,25
Nkoudou,496,2,346,2019-04-20T11:30:00Z,False,16,12,0,0,67,34,33,83,48,35,-16,-15
Nkoudou,496,2,327,2019-04-23T18:45:00Z,True,16,2,0,0,67,34,33,34,22,12,33,22
Nkoudou,496,2,358,2019-04-27T11:30:00Z,True,16,18,0,0,70,37,33,43,28,15,27,22
Nkoudou,496,2,361,2019-05-04T11:30:00Z,False,16,1,0,0,70,37,33,42,26,16,28,7
Nkoudou,496,2,378,2019-05-12T14:00:00Z,True,16,7,0,0,70,37,33,53,34,19,17,18
Kepa,497,0,3,2018-08-11T14:00:00Z,False,5,9,90,6,0,0,0,0,0,0,0,0
Kepa,497,0,13,2018-08-18T16:30:00Z,True,5,0,90,2,3,0,3,0,0,0,3,0
Kepa,497,0,26,2018-08-26T15:00:00Z,False,5,14,90,2,6,3,3,1,0,1,5,3
Kepa,497,0,33,2018-09-01T14:00:00Z,True,5,1,90,6,9,3,6,7,4,3,2,0
Kepa,497,0,41,2018-09-15T14:00:00Z,True,5,4,90,2,12,6,6,2,1,1,10,5
Kepa,497,0,59,2018-09-23T12:30:00Z,False,5,18,90,6,15,9,6,3,0,3,12,6
Kepa,497,0,63,2018-09-29T16:30:00Z,True,5,11,90,3,16,9,7,18,9,9,-2,0
Kepa,497,0,77,2018-10-07T13:15:00Z,False,5,15,90,9,17,10,7,5,2,3,12,5
Kepa,497,0,83,2018-10-20T11:30:00Z,True,5,13,90,1,20,10,10,13,7,6,7,4
Kepa,497,0,91,2018-10-28T13:30:00Z,False,5,3,90,6,21,11,10,8,4,4,13,6
Kepa,497,0,103,2018-11-04T16:00:00Z,True,5,6,90,2,24,11,13,8,2,6,16,5
Kepa,497,0,112,2018-11-11T14:15:00Z,True,5,7,90,6,27,14,13,18,13,5,9,9
Kepa,497,0,126,2018-11-24T17:30:00Z,False,5,16,90,3,28,15,13,27,6,21,1,7
Kepa,497,0,132,2018-12-02T12:00:00Z,True,5,8,90,9,28,15,13,8,7,1,20,14
Kepa,497,0,147,2018-12-05T19:45:00Z,False,5,19,90,1,31,18,13,16,8,8,15,5
Kepa,497,0,154,2018-12-08T17:30:00Z,True,5,12,90,7,31,18,13,41,24,17,-10,1
Kepa,497,0,160,2018-12-16T13:30:00Z,False,5,2,90,1,34,21,13,21,14,7,13,-1
Kepa,497,0,173,2018-12-22T15:00:00Z,True,5,10,90,2,37,21,16,22,11,11,15,10
Kepa,497,0,189,2018-12-26T19:30:00Z,False,5,17,90,2,37,21,16,27,15,12,10,1
Kepa,497,0,192,2018-12-30T12:00:00Z,False,5,6,90,6,40,21,19,19,9,10,21,10
Kepa,497,0,203,2019-01-02T19:45:00Z,True,5,15,90,7,43,21,22,15,8,7,28,14
Kepa,497,0,213,2019-01-12T17:30:00Z,True,5,14,90,2,44,22,22,18,7,11,26,11
Kepa,497,0,220,2019-01-19T17:30:00Z,False,5,0,90,2,47,25,22,41,26,15,6,-4
Kepa,497,0,231,2019-01-30T19:45:00Z,False,5,1,90,1,47,25,22,30,21,9,17,1
Kepa,497,0,243,2019-02-02T15:00:00Z,True,5,9,90,6,47,25,22,11,5,6,36,19
Kepa,497,0,255,2019-02-10T16:00:00Z,False,5,12,90,0,50,28,22,62,36,26,-12,-14
Kepa,497,0,275,2019-02-27T20:00:00Z,True,5,16,0,0,50,28,22,60,27,33,-10,-5
Kepa,497,0,284,2019-03-03T14:05:00Z,False,5,8,90,3,53,31,22,17,15,2,36,7
Kepa,497,0,292,2019-03-10T14:05:00Z,True,5,19,90,2,56,31,25,43,24,19,13,12
Kepa,497,0,303,2019-03-17T16:30:00Z,False,5,7,90,11,57,32,25,37,22,15,20,3
Kepa,497,0,313,2019-03-31T13:05:00Z,False,5,4,90,2,57,32,25,28,20,8,29,5
Kepa,497,0,264,2019-04-03T18:45:00Z,True,5,2,90,6,60,32,28,33,22,11,27,21
Kepa,497,0,321,2019-04-08T19:00:00Z,True,5,18,90,5,63,35,28,42,27,15,21,20
Kepa,497,0,335,2019-04-14T15:30:00Z,False,5,11,90,2,66,38,28,82,44,38,-16,-16
Kepa,497,0,343,2019-04-22T19:00:00Z,True,5,3,90,1,66,38,28,39,23,16,27,22
Kepa,497,0,356,2019-04-28T15:30:00Z,False,5,13,90,3,67,39,28,64,35,29,3,-7
Kepa,497,0,363,2019-05-05T13:00:00Z,True,5,17,90,7,68,39,29,50,27,23,18,16
Kepa,497,0,374,2019-05-12T14:00:00Z,False,5,10,0,0,71,42,29,51,26,25,20,3
Kovacic,498,2,3,2018-08-11T14:00:00Z,False,5,9,0,0,0,0,0,0,0,0,0,0
Kovacic,498,2,13,2018-08-18T16:30:00Z,True,5,0,30,1,3,0,3,0,0,0,3,0
Kovacic,498,2,26,2018-08-26T15:00:00Z,False,5,14,78,2,6,3,3,1,0,1,5,3
Kovacic,498,2,33,2018-09-01T14:00:00Z,True,5,1,78,3,9,3,6,7,4,3,2,0
Kovacic,498,2,41,2018-09-15T14:00:00Z,True,5,4,49,1,12,6,6,2,1,1,10,5
Kovacic,498,2,59,2018-09-23T12:30:00Z,False,5,18,78,3,15,9,6,3,0,3,12,6
Kovacic,498,2,63,2018-09-29T16:30:00Z,True,5,11,80,7,16,9,7,18,9,9,-2,0
Kovacic,498,2,77,2018-10-07T13:15:00Z,False,5,15,9,1,17,10,7,5,2,3,12,5
Kovacic,498,2,83,2018-10-20T11:30:00Z,True,5,13,68,2,20,10,10,13,7,6,7,4
Kovacic,498,2,91,2018-10-28T13:30:00Z,False,5,3,0,0,21,11,10,8,4,4,13,6
Kovacic,498,2,103,2018-11-04T16:00:00Z,True,5,6,26,1,24,11,13,8,2,6,16,5
Kovacic,498,2,112,2018-11-11T14:15:00Z,True,5,7,81,3,27,14,13,18,13,5,9,9
Kovacic,498,2,126,2018-11-24T17:30:00Z,False,5,16,57,1,28,15,13,27,6,21,1,7
Kovacic,498,2,132,2018-12-02T12:00:00Z,True,5,8,66,3,28,15,13,8,7,1,20,14
Kovacic,498,2,147,2018-12-05T19:45:00Z,False,5,19,13,1,31,18,13,16,8,8,15,5
Kovacic,498,2,154,2018-12-08T17:30:00Z,True,5,12,64,3,31,18,13,41,24,17,-10,1
Kovacic,498,2,160,2018-12-16T13:30:00Z,False,5,2,74,2,34,21,13,21,14,7,13,-1
Kovacic,498,2,173,2018-12-22T15:00:00Z,True,5,10,60,2,37,21,16,22,11,11,15,10
Kovacic,498,2,189,2018-12-26T19:30:00Z,False,5,17,79,6,37,21,16,27,15,12,10,1
Kovacic,498,2,192,2018-12-30T12:00:00Z,False,5,6,2,1,40,21,19,19,9,10,21,10
Kovacic,498,2,203,2019-01-02T19:45:00Z,True,5,15,0,0,43,21,22,15,8,7,28,14
Kovacic,498,2,213,2019-01-12T17:30:00Z,True,5,14,62,2,44,22,22,18,7,11,26,11
Kovacic,498,2,220,2019-01-19T17:30:00Z,False,5,0,62,2,47,25,22,41,26,15,6,-4
Kovacic,498,2,231,2019-01-30T19:45:00Z,False,5,1,76,2,47,25,22,30,21,9,17,1
Kovacic,498,2,243,2019-02-02T15:00:00Z,True,5,9,20,1,47,25,22,11,5,6,36,19
Kovacic,498,2,255,2019-02-10T16:00:00Z,False,5,12,38,1,50,28,22,62,36,26,-12,-14
Kovacic,498,2,275,2019-02-27T20:00:00Z,True,5,16,76,3,50,28,22,60,27,33,-10,-5
Kovacic,498,2,284,2019-03-03T14:05:00Z,False,5,8,22,1,53,31,22,17,15,2,36,7
Kovacic,498,2,292,2019-03-10T14:05:00Z,True,5,19,55,1,56,31,25,43,24,19,13,12
Kovacic,498,2,303,2019-03-17T16:30:00Z,False,5,7,0,0,57,32,25,37,22,15,20,3
Kovacic,498,2,313,2019-03-31T13:05:00Z,False,5,4,90,2,57,32,25,28,20,8,29,5
Kovacic,498,2,264,2019-04-03T18:45:00Z,True,5,2,8,1,60,32,28,33,22,11,27,21
Kovacic,498,2,321,2019-04-08T19:00:00Z,True,5,18,0,0,63,35,28,42,27,15,21,20
Kovacic,498,2,335,2019-04-14T15:30:00Z,False,5,11,0,0,66,38,28,82,44,38,-16,-16
Kovacic,498,2,343,2019-04-22T19:00:00Z,True,5,3,45,0,66,38,28,39,23,16,27,22
Kovacic,498,2,356,2019-04-28T15:30:00Z,False,5,13,75,1,67,39,28,64,35,29,3,-7
Kovacic,498,2,363,2019-05-05T13:00:00Z,True,5,17,90,3,68,39,29,50,27,23,18,16
Kovacic,498,2,374,2019-05-12T14:00:00Z,False,5,10,14,1,71,42,29,51,26,25,20,3
Traore,499,2,9,2018-08-11T16:30:00Z,True,19,7,0,0,0,0,0,0,0,0,0,0
Traore,499,2,16,2018-08-18T14:00:00Z,False,19,10,45,1,1,1,0,0,0,0,1,0
Traore,499,2,29,2018-08-25T11:30:00Z,True,19,12,18,1,1,1,0,6,3,3,-5,-2
Traore,499,2,39,2018-09-01T14:00:00Z,False,19,18,28,8,2,2,0,0,0,0,2,0
Traore,499,2,49,2018-09-16T12:30:00Z,True,19,3,24,1,5,2,3,1,0,1,4,1
Traore,499,2,58,2018-09-22T14:00:00Z,False,19,13,15,1,8,5,3,9,3,6,-1,0
Traore,499,2,69,2018-09-29T14:00:00Z,True,19,15,37,0,9,5,4,5,2,3,4,2
Traore,499,2,72,2018-10-06T14:00:00Z,False,19,6,3,1,12,8,4,7,1,6,5,3
Traore,499,2,89,2018-10-20T14:00:00Z,True,19,17,18,1,15,8,7,13,9,4,2,4
Traore,499,2,90,2018-10-27T14:00:00Z,False,19,2,60,2,15,8,7,11,7,4,4,0
Traore,499,2,109,2018-11-03T19:45:00Z,True,19,16,6,1,15,8,7,21,6,15,-6,-7
Traore,499,2,110,2018-11-11T16:30:00Z,False,19,0,15,1,15,8,7,23,13,10,-8,-6
Traore,499,2,129,2018-11-25T16:00:00Z,True,19,9,45,1,16,8,8,7,5,2,9,6
Traore,499,2,131,2018-11-30T20:00:00Z,False,19,4,72,2,16,8,8,8,7,1,8,1
Traore,499,2,147,2018-12-05T19:45:00Z,True,19,5,0,0,16,8,8,31,18,13,-15,-5
Traore,499,2,158,2018-12-09T16:00:00Z,False,19,14,59,1,19,11,8,13,6,7,6,2
Traore,499,2,169,2018-12-15T15:00:00Z,True,19,1,0,0,22,11,11,23,14,9,-1,2
Traore,499,2,179,2018-12-21T20:00:00Z,True,19,11,62,2,25,14,11,45,22,23,-20,-9
Traore,499,2,183,2018-12-26T12:30:00Z,False,19,8,45,1,25,14,11,10,8,2,15,3
Traore,499,2,198,2018-12-29T15:00:00Z,False,19,16,58,1,26,14,12,45,18,27,-19,-6
Traore,499,2,209,2019-01-02T19:45:00Z,True,19,6,6,1,29,14,15,19,9,10,10,4
Traore,499,2,217,2019-01-14T20:00:00Z,False,19,12,45,1,29,14,15,50,30,20,-21,-15
Traore,499,2,229,2019-01-19T12:30:00Z,True,19,10,0,0,29,14,15,31,14,17,-2,-3
Traore,499,2,235,2019-01-29T19:45:00Z,True,19,18,0,0,32,17,15,31,17,14,1,3
Traore,499,2,245,2019-02-02T15:00:00Z,False,19,7,1,1,35,20,15,33,21,12,2,-6
Traore,499,2,259,2019-02-11T20:00:00Z,True,19,14,9,4,38,20,18,24,13,11,14,9
Traore,499,2,261,2019-02-23T15:00:00Z,False,19,1,13,1,39,21,18,33,24,9,6,-6
Traore,499,2,273,2019-02-26T19:45:00Z,False,19,9,0,0,40,21,19,11,5,6,29,14
Traore,499,2,289,2019-03-02T15:00:00Z,True,19,4,74,3,40,21,19,25,17,8,15,13
Traore,499,2,292,2019-03-10T14:05:00Z,False,19,5,1,1,43,24,19,56,31,25,-13,-12
Traore,499,2,312,2019-03-30T15:00:00Z,False,19,3,71,2,44,24,20,30,17,13,14,3
Traore,499,2,329,2019-04-02T18:45:00Z,True,19,13,0,0,44,24,20,61,32,29,-17,-5
Traore,499,2,337,2019-04-13T14:00:00Z,False,19,15,30,1,47,27,20,33,18,15,14,2
Traore,499,2,349,2019-04-20T14:00:00Z,True,19,2,6,1,47,27,20,33,22,11,14,16
Traore,499,2,309,2019-04-24T18:45:00Z,True,19,0,8,1,48,28,20,66,44,22,-18,6
Traore,499,2,359,2019-04-27T14:00:00Z,False,19,17,0,0,51,31,20,50,27,23,1,-7
Traore,499,2,369,2019-05-04T14:00:00Z,True,19,8,0,0,54,31,23,26,21,5,28,26
Traore,499,2,375,2019-05-12T14:00:00Z,False,19,11,10,1,57,34,23,94,50,44,-37,-27
Benkovic,500,1,5,2018-08-10T19:00:00Z,False,10,13,0,0,0,0,0,0,0,0,0,0
Benkovic,500,1,16,2018-08-18T14:00:00Z,True,10,19,0,0,0,0,0,1,1,0,-1,0
Benkovic,500,1,27,2018-08-25T14:00:00Z,False,10,15,0,0,3,3,0,1,1,0,2,-1
Benkovic,500,1,36,2018-09-01T11:30:00Z,True,10,11,0,0,6,3,3,9,6,3,-3,0
Benkovic,500,1,40,2018-09-15T14:00:00Z,False,10,1,0,0,6,3,3,7,4,3,-1,-1
Benkovic,500,1,56,2018-09-22T14:00:00Z,True,10,9,0,0,6,3,3,2,1,1,4,2
Benkovic,500,1,67,2018-09-29T14:00:00Z,False,10,14,0,0,9,6,3,2,0,2,7,3
Benkovic,500,1,74,2018-10-06T14:00:00Z,True,10,7,0,0,12,6,6,9,7,2,3,4
Benkovic,500,1,80,2018-10-22T19:00:00Z,False,10,0,0,0,12,6,6,18,9,9,-6,-3
Benkovic,500,1,94,2018-10-27T16:30:00Z,True,10,18,0,0,12,6,6,7,4,3,5,3
Benkovic,500,1,102,2018-11-03T15:00:00Z,False,10,4,0,0,13,7,6,5,4,1,8,2
Benkovic,500,1,115,2018-11-10T15:00:00Z,True,10,3,0,0,16,7,9,8,4,4,8,3
Benkovic,500,1,121,2018-11-24T15:00:00Z,False,10,2,0,0,17,8,9,14,10,4,3,-1
Benkovic,500,1,135,2018-12-01T15:00:00Z,True,10,17,0,0,18,8,10,20,12,8,-2,0
Benkovic,500,1,143,2018-12-05T19:45:00Z,False,10,8,0,0,21,11,10,8,7,1,13,3
Benkovic,500,1,156,2018-12-08T19:45:00Z,True,10,16,0,0,22,11,11,33,12,21,-11,-10
Benkovic,500,1,161,2018-12-15T15:00:00Z,False,10,6,0,0,22,11,11,12,5,7,10,6
Benkovic,500,1,173,2018-12-22T15:00:00Z,False,10,5,0,0,22,11,11,37,21,16,-15,-10
Benkovic,500,1,184,2018-12-26T15:00:00Z,True,10,12,0,0,25,11,14,44,27,17,-19,-6
Benkovic,500,1,194,2018-12-29T15:00:00Z,True,10,4,0,0,28,14,14,15,13,2,13,12
Benkovic,500,1,204,2019-01-01T12:30:00Z,False,10,7,0,0,28,14,14,27,18,9,1,-4
Benkovic,500,1,216,2019-01-12T15:00:00Z,True,10,15,0,0,31,14,17,16,8,8,15,6
Benkovic,500,1,229,2019-01-19T12:30:00Z,False,10,19,0,0,31,14,17,29,14,15,2,3
Benkovic,500,1,236,2019-01-30T20:00:00Z,False,10,11,0,0,31,14,17,60,31,29,-29,-14
Benkovic,500,1,246,2019-02-03T14:05:00Z,True,10,13,0,0,32,14,18,45,25,20,-13,-6
Benkovic,500,1,257,2019-02-10T13:30:00Z,False,10,16,0,0,32,14,18,57,24,33,-25,-6
Benkovic,500,1,266,2019-02-23T17:30:00Z,True,10,6,0,0,32,14,18,27,13,14,5,0
Benkovic,500,1,274,2019-02-26T19:45:00Z,True,10,2,0,0,32,14,18,27,19,8,5,6
Benkovic,500,1,287,2019-03-03T12:00:00Z,False,10,17,0,0,35,17,18,40,20,20,-5,-2
Benkovic,500,1,295,2019-03-09T15:00:00Z,True,10,8,0,0,35,17,18,17,15,2,18,15
Benkovic,500,1,302,2019-03-16T15:00:00Z,False,10,3,0,0,38,20,18,30,17,13,8,1
Benkovic,500,1,316,2019-03-30T15:00:00Z,True,10,1,0,0,41,20,21,38,26,12,3,8
Benkovic,500,1,323,2019-04-06T14:00:00Z,False,10,9,0,0,44,23,21,14,8,6,30,13
Benkovic,500,1,334,2019-04-12T19:00:00Z,True,10,14,0,0,47,23,24,35,22,13,12,10
Benkovic,500,1,348,2019-04-20T14:00:00Z,False,10,18,0,0,47,23,24,42,27,15,5,-3
Benkovic,500,1,354,2019-04-28T11:00:00Z,True,10,0,0,0,48,23,25,66,44,22,-18,1
Benkovic,500,1,366,2019-05-06T19:00:00Z,False,10,12,0,0,51,26,25,92,51,41,-41,-26
Benkovic,500,1,374,2019-05-12T14:00:00Z,True,10,5,0,0,51,26,25,71,42,29,-20,-3
Lucas,501,3,4,2018-08-12T12:30:00Z,False,18,11,0,0,0,0,0,0,0,0,0,0
Lucas,501,3,19,2018-08-18T14:00:00Z,True,18,1,13,1,0,0,0,3,3,0,-3,0
Lucas,501,3,20,2018-08-25T14:00:00Z,False,18,0,27,1,0,0,0,0,0,0,0,0
Lucas,501,3,39,2018-09-01T14:00:00Z,True,18,19,0,0,0,0,0,2,2,0,-2,0
Lucas,501,3,42,2018-09-16T15:00:00Z,False,18,7,0,0,0,0,0,6,4,2,-6,-4
Lucas,501,3,59,2018-09-23T12:30:00Z,True,18,5,25,1,3,0,3,15,9,6,-12,-6
Lucas,501,3,68,2018-09-29T11:30:00Z,True,18,13,0,0,4,1,3,10,4,6,-6,-5
Lucas,501,3,70,2018-10-05T19:00:00Z,False,18,2,20,1,7,4,3,5,4,1,2,-1
Lucas,501,3,88,2018-10-20T14:00:00Z,True,18,16,0,0,7,4,3,18,6,12,-11,-8
Lucas,501,3,94,2018-10-27T16:30:00Z,False,18,10,0,0,7,4,3,12,6,6,-5,-3
Lucas,501,3,108,2018-11-03T15:00:00Z,True,18,3,0,0,8,4,4,8,4,4,0,0
Lucas,501,3,114,2018-11-10T15:00:00Z,False,18,9,0,0,11,7,4,6,4,2,5,0
Lucas,501,3,128,2018-11-24T15:00:00Z,True,18,12,22,1,12,7,5,32,21,11,-20,-4
Lucas,501,3,138,2018-12-01T15:00:00Z,False,18,14,0,0,12,7,5,12,6,6,0,-1
Lucas,501,3,146,2018-12-04T19:45:00Z,True,18,4,50,12,15,7,8,11,10,1,4,6
Lucas,501,3,159,2018-12-08T15:00:00Z,True,18,6,45,1,18,10,8,12,5,7,6,3
Lucas,501,3,162,2018-12-15T17:30:00Z,False,18,8,0,0,21,13,8,9,8,1,12,0
Lucas,501,3,178,2018-12-22T15:00:00Z,True,18,17,0,0,24,13,11,24,15,9,0,4
Lucas,501,3,187,2018-12-27T19:45:00Z,False,18,15,77,2,24,13,11,15,8,7,9,3
Lucas,501,3,191,2018-12-30T14:15:00Z,False,18,3,45,1,27,13,14,12,7,5,15,7
Lucas,501,3,208,2019-01-02T19:45:00Z,True,18,2,45,1,27,13,14,25,18,7,2,6
Lucas,501,3,219,2019-01-12T12:30:00Z,True,18,0,0,0,28,14,14,41,26,15,-13,-1
Lucas,501,3,221,2019-01-19T15:00:00Z,False,18,1,0,0,31,17,14,27,18,9,4,-4
Lucas,501,3,235,2019-01-29T19:45:00Z,False,18,19,0,0,31,17,14,32,17,15,-1,-3
Lucas,501,3,249,2019-02-04T20:00:00Z,True,18,11,0,0,31,17,14,61,32,29,-30,-12
Lucas,501,3,251,2019-02-09T15:00:00Z,False,18,6,0,0,32,18,14,26,12,14,6,2
Lucas,501,3,269,2019-02-22T19:45:00Z,True,18,8,0,0,33,18,15,17,15,2,16,16
Lucas,501,3,277,2019-02-27T20:00:00Z,False,18,12,0,0,36,21,15,65,39,26,-29,-24
Lucas,501,3,288,2019-03-02T17:30:00Z,True,18,14,0,0,36,21,15,31,19,12,5,9
Lucas,501,3,291,2019-03-09T15:00:00Z,False,18,4,0,0,39,24,15,25,17,8,14,-2
Lucas,501,3,308,2019-03-16T15:00:00Z,True,18,9,22,1,39,24,15,14,8,6,25,18
Lucas,501,3,319,2019-03-30T17:30:00Z,True,18,7,45,1,42,27,15,40,25,15,2,12
Lucas,501,3,321,2019-04-08T19:00:00Z,False,18,5,0,0,42,27,15,63,35,28,-21,-20
Lucas,501,3,336,2019-04-13T16:30:00Z,False,18,13,0,0,42,27,15,61,32,29,-19,-17
Lucas,501,3,348,2019-04-20T14:00:00Z,True,18,10,12,7,42,27,15,47,23,24,-5,3
Lucas,501,3,358,2019-04-27T11:30:00Z,False,18,16,10,1,43,28,15,70,37,33,-27,-22
Lucas,501,3,368,2019-05-04T14:00:00Z,True,18,15,7,1,46,28,18,38,22,16,8,12
Lucas,501,3,379,2019-05-12T14:00:00Z,False,18,17,0,0,49,31,18,50,27,23,-1,-9
Montoya,502,1,8,2018-08-11T14:00:00Z,False,2,17,0,0,0,0,0,0,0,0,0,0
Montoya,502,1,10,2018-08-19T15:00:00Z,True,2,13,90,1,0,0,0,3,3,0,-3,0
Montoya,502,1,24,2018-08-25T16:30:00Z,False,2,11,90,2,3,3,0,6,3,3,-3,-3
Montoya,502,1,30,2018-09-01T14:00:00Z,True,2,8,90,1,3,3,0,3,3,0,0,3
Montoya,502,1,46,2018-09-17T19:00:00Z,False,2,15,90,1,4,4,0,4,1,3,0,-1
Montoya,502,1,51,2018-09-22T16:30:00Z,True,2,16,90,1,5,4,1,9,3,6,-4,-2
Montoya,502,1,66,2018-09-29T14:00:00Z,False,2,12,90,0,5,4,1,16,9,7,-11,-8
Montoya,502,1,70,2018-10-05T19:00:00Z,True,2,18,0,0,5,4,1,7,4,3,-2,1
Montoya,502,1,87,2018-10-20T14:00:00Z,False,2,14,0,0,8,7,1,2,0,2,6,1
Montoya,502,1,90,2018-10-27T14:00:00Z,True,2,19,0,0,11,7,4,15,8,7,-4,0
Montoya,502,1,104,2018-11-03T15:00:00Z,False,2,7,0,0,14,10,4,15,10,5,-1,-6
Montoya,502,1,111,2018-11-10T12:30:00Z,False,2,4,90,1,14,10,4,5,4,1,9,0
Montoya,502,1,121,2018-11-24T15:00:00Z,True,2,10,0,0,14,10,4,17,8,9,-3,1
Montoya,502,1,134,2018-12-01T15:00:00Z,False,2,9,0,0,15,11,4,10,5,5,5,-1
Montoya,502,1,141,2018-12-04T19:45:00Z,True,2,6,90,2,18,11,7,12,5,7,6,4
Montoya,502,1,152,2018-12-08T15:00:00Z,False,2,3,0,0,21,14,7,9,4,5,12,3
Montoya,502,1,160,2018-12-16T13:30:00Z,True,2,5,90,1,21,14,7,34,21,13,-13,1
Montoya,502,1,171,2018-12-22T15:00:00Z,False,2,1,90,1,21,14,7,23,14,9,-2,-7
Montoya,502,1,180,2018-12-26T17:15:00Z,True,2,0,90,1,21,14,7,37,23,14,-16,0
Montoya,502,1,190,2018-12-29T15:00:00Z,True,2,7,90,7,22,15,7,27,18,9,-5,6
Montoya,502,1,208,2019-01-02T19:45:00Z,False,2,18,90,1,25,18,7,27,13,14,-2,-6
Montoya,502,1,210,2019-01-12T15:00:00Z,True,2,11,90,2,26,18,8,54,28,26,-28,-8
Montoya,502,1,225,2019-01-19T15:00:00Z,False,2,13,90,1,26,18,8,41,21,20,-15,-13
Montoya,502,1,232,2019-01-29T19:45:00Z,False,2,8,90,3,26,18,8,14,12,2,12,-4
Montoya,502,1,240,2019-02-02T15:00:00Z,True,2,17,90,6,26,18,8,33,17,16,-7,2
Montoya,502,1,250,2019-02-09T17:30:00Z,True,2,3,90,1,27,19,8,24,14,10,3,9
Montoya,502,1,274,2019-02-26T19:45:00Z,False,2,10,90,0,27,19,8,32,14,18,-5,-6
Montoya,502,1,281,2019-03-02T15:00:00Z,True,2,9,90,6,27,19,8,14,8,6,13,13
Montoya,502,1,293,2019-03-09T12:30:00Z,False,2,6,90,1,30,22,8,33,13,20,-3,-5
Montoya,502,1,311,2019-03-30T15:00:00Z,True,2,15,90,2,33,22,11,30,18,12,3,10
Montoya,502,1,264,2019-04-03T18:45:00Z,False,2,5,0,0,33,22,11,60,32,28,-27,-21
Montoya,502,1,330,2019-04-13T14:00:00Z,True,2,1,90,0,33,22,11,38,26,12,-5,10
Montoya,502,1,301,2019-04-16T18:45:00Z,True,2,4,0,0,33,22,11,28,20,8,5,14
Montoya,502,1,349,2019-04-20T14:00:00Z,False,2,19,0,0,33,22,11,47,27,20,-14,-16
Montoya,502,1,327,2019-04-23T18:45:00Z,False,2,16,90,2,34,22,12,67,34,33,-33,-22
Montoya,502,1,350,2019-04-27T16:30:00Z,True,2,14,0,0,34,22,12,41,25,16,-7,6
Montoya,502,1,360,2019-05-05T15:30:00Z,False,2,0,0,0,35,23,12,66,44,22,-31,-32
Montoya,502,1,370,2019-05-12T14:00:00Z,True,2,12,6,1,36,23,13,95,54,41,-59,-18
Camarasa,503,2,1,2018-08-11T14:00:00Z,False,4,1,0,0,0,0,0,0,0,0,0,0
Camarasa,503,2,12,2018-08-18T11:30:00Z,True,4,14,75,2,0,0,0,0,0,0,0,0
Camarasa,503,2,23,2018-08-25T14:00:00Z,False,4,9,74,3,1,1,0,0,0,0,1,0
Camarasa,503,2,32,2018-09-02T12:30:00Z,True,4,0,88,6,2,1,1,3,3,0,-1,1
Camarasa,503,2,41,2018-09-15T14:00:00Z,False,4,5,90,2,2,1,1,12,6,6,-10,-5
Camarasa,503,2,53,2018-09-22T14:00:00Z,True,4,12,90,2,2,1,1,13,9,4,-11,-3
Camarasa,503,2,62,2018-09-30T15:00:00Z,True,4,3,90,2,2,1,1,4,3,1,-2,0
Camarasa,503,2,78,2018-10-06T14:00:00Z,False,4,16,90,2,2,1,1,15,3,12,-13,-2
Camarasa,503,2,82,2018-10-20T14:00:00Z,True,4,8,90,7,2,1,1,5,4,1,-3,0
Camarasa,503,2,95,2018-10-27T14:00:00Z,False,4,11,90,2,5,4,1,23,10,13,-18,-9
Camarasa,503,2,102,2018-11-03T15:00:00Z,True,4,10,90,2,5,4,1,13,7,6,-8,-2
Camarasa,503,2,111,2018-11-10T12:30:00Z,True,4,2,90,2,5,4,1,14,10,4,-9,0
Camarasa,503,2,123,2018-11-24T15:00:00Z,False,4,7,84,1,8,7,1,19,13,6,-11,-12
Camarasa,503,2,131,2018-11-30T20:00:00Z,True,4,19,90,2,8,7,1,16,8,8,-8,-1
Camarasa,503,2,146,2018-12-04T19:45:00Z,False,4,18,90,2,11,10,1,15,7,8,-4,-6
Camarasa,503,2,153,2018-12-08T15:00:00Z,True,4,15,90,3,11,10,1,9,5,4,2,6
Camarasa,503,2,168,2018-12-15T15:00:00Z,False,4,17,90,5,14,13,1,21,12,9,-7,-11
Camarasa,503,2,172,2018-12-22T17:30:00Z,True,4,13,90,7,14,13,1,26,15,11,-12,2
Camarasa,503,2,182,2018-12-26T15:00:00Z,False,4,6,90,2,14,13,1,18,8,10,-4,-7
Camarasa,503,2,194,2018-12-29T15:00:00Z,False,4,10,90,10,15,13,2,28,14,14,-13,-12
Camarasa,503,2,202,2019-01-01T17:30:00Z,True,4,16,58,1,18,13,5,45,18,27,-27,-14
Camarasa,503,2,212,2019-01-12T15:00:00Z,True,4,9,63,3,18,13,5,10,5,5,8,8
Camarasa,503,2,226,2019-01-19T15:00:00Z,False,4,14,90,1,19,14,5,18,7,11,1,-2
Camarasa,503,2,230,2019-01-29T19:45:00Z,False,4,0,0,0,19,14,5,44,29,15,-25,-24
Camarasa,503,2,242,2019-02-02T17:30:00Z,True,4,1,0,0,19,14,5,33,24,9,-14,5
Camarasa,503,2,256,2019-02-09T15:00:00Z,False,4,15,7,4,22,17,5,24,12,12,-2,-7
Camarasa,503,2,263,2019-02-22T19:45:00Z,True,4,17,0,0,25,17,8,37,20,17,-12,0
Camarasa,503,2,271,2019-02-26T19:45:00Z,True,4,7,0,0,25,17,8,33,21,12,-8,5
Camarasa,503,2,289,2019-03-02T15:00:00Z,False,4,19,90,2,25,17,8,40,21,19,-15,-13
Camarasa,503,2,291,2019-03-09T15:00:00Z,True,4,18,67,8,25,17,8,39,24,15,-14,2
Camarasa,503,2,313,2019-03-31T13:05:00Z,True,4,5,90,8,28,20,8,57,32,25,-29,-5
Camarasa,503,2,324,2019-04-03T18:45:00Z,False,4,12,82,2,28,20,8,77,45,32,-49,-37
Camarasa,503,2,331,2019-04-13T14:00:00Z,False,4,3,90,1,28,20,8,36,20,16,-8,-12
Camarasa,503,2,301,2019-04-16T18:45:00Z,False,4,2,90,6,28,20,8,33,22,11,-5,-14
Camarasa,503,2,342,2019-04-21T15:00:00Z,True,4,11,90,2,31,20,11,85,47,38,-54,-18
Camarasa,503,2,353,2019-04-27T14:00:00Z,False,4,8,71,3,31,20,11,23,18,5,8,-7
Camarasa,503,2,362,2019-05-04T16:30:00Z,True,4,6,10,1,31,20,11,43,17,26,-12,-6
Camarasa,503,2,376,2019-05-12T14:00:00Z,False,4,13,0,0,31,20,11,66,36,30,-35,-25
Ayew,504,3,2,2018-08-11T14:00:00Z,False,6,8,0,0,0,0,0,0,0,0,0,0
Ayew,504,3,14,2018-08-20T19:00:00Z,True,6,11,0,0,3,0,3,3,3,0,0,0
Ayew,504,3,28,2018-08-26T12:30:00Z,False,6,17,0,0,3,0,3,6,3,3,-3,0
Ayew,504,3,34,2018-09-01T14:00:00Z,True,6,15,75,2,3,0,3,1,1,0,2,0
Ayew,504,3,43,2018-09-15T14:00:00Z,False,6,9,90,5,3,0,3,2,1,1,1,2
Ayew,504,3,54,2018-09-22T14:00:00Z,True,6,14,70,2,6,0,6,1,0,1,5,-1
Ayew,504,3,61,2018-10-01T19:00:00Z,False,6,1,81,2,7,1,6,10,7,3,-3,-1
Ayew,504,3,72,2018-10-06T14:00:00Z,True,6,19,71,2,7,1,6,12,8,4,-5,-3
Ayew,504,3,84,2018-10-21T15:00:00Z,False,6,7,0,0,7,1,6,12,7,5,-5,-1
Ayew,504,3,92,2018-10-28T13:30:00Z,True,6,0,63,1,7,1,6,21,12,9,-14,-8
Ayew,504,3,103,2018-11-04T16:00:00Z,False,6,5,19,1,8,2,6,24,11,13,-16,-5
Ayew,504,3,113,2018-11-10T17:30:00Z,True,6,16,90,2,8,2,6,24,6,18,-16,-16
Ayew,504,3,125,2018-11-24T15:00:00Z,False,6,13,1,1,8,2,6,20,10,10,-12,-4
Ayew,504,3,133,2018-12-01T15:00:00Z,True,6,3,0,0,9,2,7,9,4,5,0,-3
Ayew,504,3,141,2018-12-04T19:45:00Z,False,6,2,0,0,12,5,7,18,11,7,-6,-4
Ayew,504,3,159,2018-12-08T15:00:00Z,False,6,18,24,1,12,5,7,18,10,8,-6,-3
Ayew,504,3,161,2018-12-15T15:00:00Z,True,6,10,77,2,12,5,7,22,11,11,-10,-6
Ayew,504,3,176,2018-12-22T15:00:00Z,False,6,12,2,1,15,8,7,44,27,17,-29,-20
Ayew,504,3,182,2018-12-26T15:00:00Z,True,6,4,0,0,18,8,10,14,13,1,4,7
Ayew,504,3,192,2018-12-30T12:00:00Z,True,6,5,0,0,19,9,10,40,21,19,-21,-10
Ayew,504,3,209,2019-01-02T19:45:00Z,False,6,19,87,8,19,9,10,29,14,15,-10,-4
Ayew,504,3,214,2019-01-12T15:00:00Z,True,6,17,82,2,22,9,13,29,16,13,-7,-4
Ayew,504,3,224,2019-01-19T15:00:00Z,False,6,11,80,1,22,9,13,57,28,29,-35,-15
Ayew,504,3,238,2019-01-30T19:45:00Z,False,6,15,90,2,22,9,13,22,11,11,0,2
Ayew,504,3,244,2019-02-02T15:00:00Z,True,6,8,81,1,23,9,14,17,15,2,6,7
Ayew,504,3,251,2019-02-09T15:00:00Z,True,6,18,0,0,26,12,14,32,18,14,-6,-2
Ayew,504,3,266,2019-02-23T17:30:00Z,False,6,10,4,4,27,13,14,32,14,18,-5,0
Ayew,504,3,272,2019-02-27T20:00:00Z,True,6,13,0,0,30,13,17,52,26,26,-22,-13
Ayew,504,3,282,2019-03-02T15:00:00Z,False,6,3,0,0,30,13,17,30,17,13,0,0
Ayew,504,3,293,2019-03-09T12:30:00Z,True,6,2,0,0,33,13,20,30,22,8,3,5
Ayew,504,3,314,2019-03-30T15:00:00Z,True,6,9,0,0,33,13,20,14,8,6,19,7
Ayew,504,3,306,2019-04-03T18:45:00Z,False,6,16,0,0,36,16,20,61,28,33,-25,-8
Ayew,504,3,325,2019-04-06T14:00:00Z,False,6,14,0,0,36,16,20,35,22,13,1,-2
Ayew,504,3,332,2019-04-14T13:05:00Z,True,6,12,0,0,39,16,23,80,48,32,-41,-16
Ayew,504,3,340,2019-04-21T15:00:00Z,False,6,0,12,1,39,16,23,66,44,22,-27,-21
Ayew,504,3,352,2019-04-27T14:00:00Z,True,6,7,0,0,42,16,26,49,31,18,-7,-2
Ayew,504,3,362,2019-05-04T16:30:00Z,False,6,4,77,5,43,17,26,31,20,11,12,6
Ayew,504,3,372,2019-05-12T14:00:00Z,True,6,1,0,0,46,17,29,45,29,16,1,1
Mina,505,1,9,2018-08-11T16:30:00Z,False,7,19,0,0,0,0,0,0,0,0,0,0
Mina,505,1,15,2018-08-18T14:00:00Z,True,7,15,0,0,1,0,1,1,1,0,0,0
Mina,505,1,21,2018-08-25T14:00:00Z,False,7,1,0,0,4,3,1,6,3,3,-2,-2
Mina,505,1,35,2018-09-01T14:00:00Z,True,7,9,0,0,5,3,2,1,1,0,4,3
Mina,505,1,42,2018-09-16T15:00:00Z,True,7,18,0,0,6,4,2,0,0,0,6,4
Mina,505,1,50,2018-09-23T15:00:00Z,False,7,0,0,0,6,4,2,9,3,6,-3,-1
Mina,505,1,64,2018-09-29T14:00:00Z,True,7,8,0,0,6,4,2,5,4,1,1,3
Mina,505,1,74,2018-10-06T14:00:00Z,False,7,10,0,0,9,7,2,12,6,6,-3,-4
Mina,505,1,84,2018-10-21T15:00:00Z,True,7,6,0,0,12,7,5,7,1,6,5,1
Mina,505,1,96,2018-10-28T16:00:00Z,False,7,13,0,0,15,10,5,14,7,7,1,-2
Mina,505,1,104,2018-11-03T15:00:00Z,True,7,2,1,1,15,10,5,14,10,4,1,6
Mina,505,1,112,2018-11-11T14:15:00Z,False,7,5,90,5,18,13,5,27,14,13,-9,-9
Mina,505,1,123,2018-11-24T15:00:00Z,True,7,4,90,8,19,13,6,8,7,1,11,12
Mina,505,1,136,2018-12-02T16:15:00Z,False,7,11,90,2,22,16,6,33,16,17,-11,-10
Mina,505,1,148,2018-12-05T19:45:00Z,True,7,14,90,2,22,16,6,12,6,6,10,10
Mina,505,1,155,2018-12-10T20:00:00Z,True,7,17,90,0,23,17,6,20,12,8,3,9
Mina,505,1,165,2018-12-15T12:30:00Z,False,7,12,90,1,24,18,6,41,24,17,-17,-18
Mina,505,1,174,2018-12-23T16:00:00Z,True,7,16,0,0,24,18,6,39,15,24,-15,-6
Mina,505,1,181,2018-12-26T15:00:00Z,False,7,3,90,8,24,18,6,12,7,5,12,-1
Mina,505,1,190,2018-12-29T15:00:00Z,False,7,2,64,1,27,18,9,22,15,7,5,-6
Mina,505,1,204,2019-01-01T12:30:00Z,True,7,10,0,0,27,18,9,28,14,14,-1,4
Mina,505,1,215,2019-01-13T14:15:00Z,True,7,1,1,1,27,18,9,27,18,9,0,9
Mina,505,1,227,2019-01-19T15:00:00Z,False,7,15,0,0,30,21,9,19,8,11,11,1
Mina,505,1,233,2019-01-29T19:45:00Z,False,7,9,0,0,30,21,9,11,5,6,19,4
Mina,505,1,245,2019-02-02T15:00:00Z,True,7,19,0,0,33,21,12,35,20,15,-2,6
Mina,505,1,265,2019-02-06T19:45:00Z,True,7,12,0,0,33,21,12,59,36,23,-26,-2
Mina,505,1,258,2019-02-09T15:00:00Z,False,7,17,0,0,33,21,12,34,17,17,-1,-5
Mina,505,1,271,2019-02-26T19:45:00Z,False,7,4,0,0,33,21,12,25,17,8,8,-5
Mina,505,1,283,2019-03-03T16:15:00Z,True,7,11,0,0,36,21,15,69,38,31,-33,-10
Mina,505,1,298,2019-03-09T15:00:00Z,False,7,14,15,0,37,22,15,31,19,12,6,-4
Mina,505,1,303,2019-03-17T16:30:00Z,True,7,5,90,6,37,22,15,57,32,25,-20,-3
Mina,505,1,319,2019-03-30T17:30:00Z,False,7,18,0,0,40,25,15,42,27,15,-2,-12
Mina,505,1,322,2019-04-07T13:05:00Z,True,7,0,0,0,43,25,18,63,44,19,-20,6
Mina,505,1,333,2019-04-13T14:00:00Z,False,7,8,0,0,46,28,18,17,15,2,29,3
Mina,505,1,344,2019-04-21T12:30:00Z,True,7,13,0,0,46,28,18,64,35,29,-18,-1
Mina,505,1,352,2019-04-27T14:00:00Z,False,7,6,0,0,49,31,18,42,16,26,7,2
Mina,505,1,364,2019-05-03T19:00:00Z,True,7,3,0,0,50,31,19,40,23,17,10,14
Mina,505,1,378,2019-05-12T14:00:00Z,False,7,16,90,1,53,34,19,70,37,33,-17,-18
Bernard,506,2,9,2018-08-11T16:30:00Z,False,7,19,0,0,0,0,0,0,0,0,0,0
Bernard,506,2,15,2018-08-18T14:00:00Z,True,7,15,0,0,1,0,1,1,1,0,0,0
Bernard,506,2,21,2018-08-25T14:00:00Z,False,7,1,5,1,4,3,1,6,3,3,-2,-2
Bernard,506,2,35,2018-09-01T14:00:00Z,True,7,9,0,0,5,3,2,1,1,0,4,3
Bernard,506,2,42,2018-09-16T15:00:00Z,True,7,18,46,0,6,4,2,0,0,0,6,4
Bernard,506,2,50,2018-09-23T15:00:00Z,False,7,0,18,1,6,4,2,9,3,6,-3,-1
Bernard,506,2,64,2018-09-29T14:00:00Z,True,7,8,2,4,6,4,2,5,4,1,1,3
Bernard,506,2,74,2018-10-06T14:00:00Z,False,7,10,90,7,9,7,2,12,6,6,-3,-4
Bernard,506,2,84,2018-10-21T15:00:00Z,True,7,6,66,3,12,7,5,7,1,6,5,1
Bernard,506,2,96,2018-10-28T16:00:00Z,False,7,13,61,2,15,10,5,14,7,7,1,-2
Bernard,506,2,104,2018-11-03T15:00:00Z,True,7,2,67,2,15,10,5,14,10,4,1,6
Bernard,506,2,112,2018-11-11T14:15:00Z,False,7,5,63,2,18,13,5,27,14,13,-9,-9
Bernard,506,2,123,2018-11-24T15:00:00Z,True,7,4,76,3,19,13,6,8,7,1,11,12
Bernard,506,2,136,2018-12-02T16:15:00Z,False,7,11,88,3,22,16,6,33,16,17,-11,-10
Bernard,506,2,148,2018-12-05T19:45:00Z,True,7,14,21,1,22,16,6,12,6,6,10,10
Bernard,506,2,155,2018-12-10T20:00:00Z,True,7,17,65,2,23,17,6,20,12,8,3,9
Bernard,506,2,165,2018-12-15T12:30:00Z,False,7,12,56,1,24,18,6,41,24,17,-17,-18
Bernard,506,2,174,2018-12-23T16:00:00Z,True,7,16,15,1,24,18,6,39,15,24,-15,-6
Bernard,506,2,181,2018-12-26T15:00:00Z,False,7,3,79,10,24,18,6,12,7,5,12,-1
Bernard,506,2,190,2018-12-29T15:00:00Z,False,7,2,79,1,27,18,9,22,15,7,5,-6
Bernard,506,2,204,2019-01-01T12:30:00Z,True,7,10,28,1,27,18,9,28,14,14,-1,4
Bernard,506,2,215,2019-01-13T14:15:00Z,True,7,1,77,2,27,18,9,27,18,9,0,9
Bernard,506,2,227,2019-01-19T15:00:00Z,False,7,15,74,2,30,21,9,19,8,11,11,1
Bernard,506,2,233,2019-01-29T19:45:00Z,False,7,9,90,2,30,21,9,11,5,6,19,4
Bernard,506,2,245,2019-02-02T15:00:00Z,True,7,19,0,0,33,21,12,35,20,15,-2,6
Bernard,506,2,265,2019-02-06T19:45:00Z,True,7,12,72,2,33,21,12,59,36,23,-26,-2
Bernard,506,2,258,2019-02-09T15:00:00Z,False,7,17,24,1,33,21,12,34,17,17,-1,-5
Bernard,506,2,271,2019-02-26T19:45:00Z,False,7,4,29,1,33,21,12,25,17,8,8,-5
Bernard,506,2,283,2019-03-03T16:15:00Z,True,7,11,90,3,36,21,15,69,38,31,-33,-10
Bernard,506,2,298,2019-03-09T15:00:00Z,False,7,14,81,2,37,22,15,31,19,12,6,-4
Bernard,506,2,303,2019-03-17T16:30:00Z,True,7,5,77,3,37,22,15,57,32,25,-20,-3
Bernard,506,2,319,2019-03-30T17:30:00Z,False,7,18,90,9,40,25,15,42,27,15,-2,-12
Bernard,506,2,322,2019-04-07T13:05:00Z,True,7,0,87,3,43,25,18,63,44,19,-20,6
Bernard,506,2,333,2019-04-13T14:00:00Z,False,7,8,83,2,46,28,18,17,15,2,29,3
Bernard,506,2,344,2019-04-21T12:30:00Z,True,7,13,90,3,46,28,18,64,35,29,-18,-1
Bernard,506,2,352,2019-04-27T14:00:00Z,False,7,6,83,3,49,31,18,42,16,26,7,2
Bernard,506,2,364,2019-05-03T19:00:00Z,True,7,3,72,3,50,31,19,40,23,17,10,14
Bernard,506,2,378,2019-05-12T14:00:00Z,False,7,16,64,2,53,34,19,70,37,33,-17,-18
Andre Gomes,507,2,9,2018-08-11T16:30:00Z,False,7,19,0,0,0,0,0,0,0,0,0,0
Andre Gomes,507,2,15,2018-08-18T14:00:00Z,True,7,15,0,0,1,0,1,1,1,0,0,0
Andre Gomes,507,2,21,2018-08-25T14:00:00Z,False,7,1,0,0,4,3,1,6,3,3,-2,-2
Andre Gomes,507,2,35,2018-09-01T14:00:00Z,True,7,9,0,0,5,3,2,1,1,0,4,3
Andre Gomes,507,2,42,2018-09-16T15:00:00Z,True,7,18,0,0,6,4,2,0,0,0,6,4
Andre Gomes,507,2,50,2018-09-23T15:00:00Z,False,7,0,0,0,6,4,2,9,3,6,-3,-1
Andre Gomes,507,2,64,2018-09-29T14:00:00Z,True,7,8,0,0,6,4,2,5,4,1,1,3
Andre Gomes,507,2,74,2018-10-06T14:00:00Z,False,7,10,0,0,9,7,2,12,6,6,-3,-4
Andre Gomes,507,2,84,2018-10-21T15:00:00Z,True,7,6,81,3,12,7,5,7,1,6,5,1
Andre Gomes,507,2,96,2018-10-28T16:00:00Z,False,7,13,90,2,15,10,5,14,7,7,1,-2
Andre Gomes,507,2,104,2018-11-03T15:00:00Z,True,7,2,90,2,15,10,5,14,10,4,1,6
Andre Gomes,507,2,112,2018-11-11T14:15:00Z,False,7,5,90,3,18,13,5,27,14,13,-9,-9
Andre Gomes,507,2,123,2018-11-24T15:00:00Z,True,7,4,90,3,19,13,6,8,7,1,11,12
Andre Gomes,507,2,136,2018-12-02T16:15:00Z,False,7,11,90,1,22,16,6,33,16,17,-11,-10
Andre Gomes,507,2,148,2018-12-05T19:45:00Z,True,7,14,90,2,22,16,6,12,6,6,10,10
Andre Gomes,507,2,155,2018-12-10T20:00:00Z,True,7,17,90,5,23,17,6,20,12,8,3,9
Andre Gomes,507,2,165,2018-12-15T12:30:00Z,False,7,12,90,2,24,18,6,41,24,17,-17,-18
Andre Gomes,507,2,174,2018-12-23T16:00:00Z,True,7,16,52,1,24,18,6,39,15,24,-15,-6
Andre Gomes,507,2,181,2018-12-26T15:00:00Z,False,7,3,74,1,24,18,6,12,7,5,12,-1
Andre Gomes,507,2,190,2018-12-29T15:00:00Z,False,7,2,71,2,27,18,9,22,15,7,5,-6
Andre Gomes,507,2,204,2019-01-01T12:30:00Z,True,7,10,61,1,27,18,9,28,14,14,-1,4
Andre Gomes,507,2,215,2019-01-13T14:15:00Z,True,7,1,90,2,27,18,9,27,18,9,0,9
Andre Gomes,507,2,227,2019-01-19T15:00:00Z,False,7,15,56,1,30,21,9,19,8,11,11,1
Andre Gomes,507,2,233,2019-01-29T19:45:00Z,False,7,9,90,2,30,21,9,11,5,6,19,4
Andre Gomes,507,2,245,2019-02-02T15:00:00Z,True,7,19,90,9,33,21,12,35,20,15,-2,6
Andre Gomes,507,2,265,2019-02-06T19:45:00Z,True,7,12,62,2,33,21,12,59,36,23,-26,-2
Andre Gomes,507,2,258,2019-02-09T15:00:00Z,False,7,17,62,3,33,21,12,34,17,17,-1,-5
Andre Gomes,507,2,271,2019-02-26T19:45:00Z,False,7,4,2,1,33,21,12,25,17,8,8,-5
Andre Gomes,507,2,283,2019-03-03T16:15:00Z,True,7,11,14,1,36,21,15,69,38,31,-33,-10
Andre Gomes,507,2,298,2019-03-09T15:00:00Z,False,7,14,90,5,37,22,15,31,19,12,6,-4
Andre Gomes,507,2,303,2019-03-17T16:30:00Z,True,7,5,67,2,37,22,15,57,32,25,-20,-3
Andre Gomes,507,2,319,2019-03-30T17:30:00Z,False,7,18,90,3,40,25,15,42,27,15,-2,-12
Andre Gomes,507,2,322,2019-04-07T13:05:00Z,True,7,0,90,2,43,25,18,63,44,19,-20,6
Andre Gomes,507,2,333,2019-04-13T14:00:00Z,False,7,8,90,2,46,28,18,17,15,2,29,3
Andre Gomes,507,2,344,2019-04-21T12:30:00Z,True,7,13,0,0,46,28,18,64,35,29,-18,-1
Andre Gomes,507,2,352,2019-04-27T14:00:00Z,False,7,6,0,0,49,31,18,42,16,26,7,2
Andre Gomes,507,2,364,2019-05-03T19:00:00Z,True,7,3,0,0,50,31,19,40,23,17,10,14
Andre Gomes,507,2,378,2019-05-12T14:00:00Z,False,7,16,25,1,53,34,19,70,37,33,-17,-18
Rico,508,0,2,2018-08-11T14:00:00Z,True,8,6,0,0,0,0,0,0,0,0,0,0
Rico,508,0,18,2018-08-18T14:00:00Z,False,8,16,0,0,0,0,0,3,0,3,-3,0
Rico,508,0,22,2018-08-26T15:00:00Z,True,8,3,0,0,0,0,0,1,0,1,-1,-1
Rico,508,0,30,2018-09-01T14:00:00Z,False,8,2,0,0,3,3,0,3,3,0,0,-3
Rico,508,0,44,2018-09-15T14:00:00Z,False,8,12,0,0,4,3,1,10,6,4,-6,-5
Rico,508,0,55,2018-09-22T11:30:00Z,True,8,17,0,0,4,3,1,12,9,3,-8,0
Rico,508,0,64,2018-09-29T14:00:00Z,False,8,7,0,0,5,4,1,6,4,2,-1,-3
Rico,508,0,73,2018-10-07T11:00:00Z,True,8,0,0,0,5,4,1,15,9,6,-10,-2
Rico,508,0,82,2018-10-20T14:00:00Z,False,8,4,0,0,5,4,1,2,1,1,3,0
Rico,508,0,93,2018-10-27T14:00:00Z,True,8,1,90,1,5,4,1,17,11,6,-12,-2
Rico,508,0,105,2018-11-05T20:00:00Z,False,8,9,90,2,5,4,1,3,1,2,2,0
Rico,508,0,116,2018-11-11T12:00:00Z,False,8,11,90,2,5,4,1,27,13,14,-22,-12
Rico,508,0,124,2018-11-24T15:00:00Z,True,8,15,90,3,5,4,1,8,4,4,-3,0
Rico,508,0,132,2018-12-02T12:00:00Z,False,8,5,90,3,8,7,1,28,15,13,-20,-14
Rico,508,0,143,2018-12-05T19:45:00Z,True,8,10,90,3,8,7,1,21,11,10,-13,-3
Rico,508,0,157,2018-12-08T15:00:00Z,False,8,13,90,2,9,8,1,23,12,11,-14,-11
Rico,508,0,162,2018-12-15T17:30:00Z,True,8,18,90,1,9,8,1,21,13,8,-12,0
Rico,508,0,177,2018-12-22T15:00:00Z,False,8,14,90,6,9,8,1,16,6,10,-7,-5
Rico,508,0,183,2018-12-26T12:30:00Z,True,8,19,90,4,10,8,2,25,14,11,-15,-3
Rico,508,0,193,2018-12-29T15:00:00Z,True,8,9,90,9,11,9,2,10,5,5,1,4
Rico,508,0,200,2019-01-01T15:00:00Z,False,8,0,90,1,14,12,2,38,23,15,-24,-21
Rico,508,0,211,2019-01-12T15:00:00Z,False,8,3,90,1,14,12,2,18,10,8,-4,-8
Rico,508,0,222,2019-01-20T16:00:00Z,True,8,16,90,2,14,12,2,48,18,30,-34,-18
Rico,508,0,232,2019-01-29T19:45:00Z,True,8,2,90,2,14,12,2,26,18,8,-12,4
Rico,508,0,244,2019-02-02T15:00:00Z,False,8,6,90,2,17,15,2,23,9,14,-6,-7
Rico,508,0,252,2019-02-09T12:30:00Z,True,8,13,90,2,17,15,2,48,25,23,-31,-8
Rico,508,0,269,2019-02-22T19:45:00Z,False,8,18,90,2,17,15,2,33,18,15,-16,-16
Rico,508,0,279,2019-02-27T19:45:00Z,False,8,15,90,1,17,15,2,24,12,12,-7,-10
Rico,508,0,284,2019-03-03T14:05:00Z,True,8,5,90,2,17,15,2,53,31,22,-36,-7
Rico,508,0,295,2019-03-09T15:00:00Z,False,8,10,90,2,17,15,2,35,17,18,-18,-15
Rico,508,0,304,2019-03-17T14:15:00Z,True,8,11,90,2,17,15,2,73,41,32,-56,-17
Rico,508,0,315,2019-03-30T12:30:00Z,True,8,12,90,2,17,15,2,74,45,29,-57,-14
Rico,508,0,328,2019-04-02T18:45:00Z,False,8,17,90,1,17,15,2,43,23,20,-26,-21
Rico,508,0,333,2019-04-13T14:00:00Z,True,8,7,90,6,17,15,2,46,28,18,-29,-3
Rico,508,0,341,2019-04-20T14:00:00Z,False,8,1,90,8,20,18,2,41,26,15,-21,-24
Rico,508,0,353,2019-04-27T14:00:00Z,True,8,4,90,11,23,18,5,31,20,11,-8,7
Rico,508,0,369,2019-05-04T14:00:00Z,False,8,19,90,3,26,21,5,54,31,23,-28,-26
Rico,508,0,373,2019-05-12T14:00:00Z,True,8,14,90,0,26,21,5,42,25,17,-16,4
Bryan,509,1,2,2018-08-11T14:00:00Z,True,8,6,70,2,0,0,0,0,0,0,0,0
Bryan,509,1,18,2018-08-18T14:00:00Z,False,8,16,84,1,0,0,0,3,0,3,-3,0
Bryan,509,1,22,2018-08-26T15:00:00Z,True,8,3,71,1,0,0,0,1,0,1,-1,-1
Bryan,509,1,30,2018-09-01T14:00:00Z,False,8,2,0,0,3,3,0,3,3,0,0,-3
Bryan,509,1,44,2018-09-15T14:00:00Z,False,8,12,0,0,4,3,1,10,6,4,-6,-5
Bryan,509,1,55,2018-09-22T11:30:00Z,True,8,17,0,0,4,3,1,12,9,3,-8,0
Bryan,509,1,64,2018-09-29T14:00:00Z,False,8,7,90,1,5,4,1,6,4,2,-1,-3
Bryan,509,1,73,2018-10-07T11:00:00Z,True,8,0,0,0,5,4,1,15,9,6,-10,-2
Bryan,509,1,82,2018-10-20T14:00:00Z,False,8,4,0,0,5,4,1,2,1,1,3,0
Bryan,509,1,93,2018-10-27T14:00:00Z,True,8,1,0,0,5,4,1,17,11,6,-12,-2
Bryan,509,1,105,2018-11-05T20:00:00Z,False,8,9,0,0,5,4,1,3,1,2,2,0
Bryan,509,1,116,2018-11-11T12:00:00Z,False,8,11,0,0,5,4,1,27,13,14,-22,-12
Bryan,509,1,124,2018-11-24T15:00:00Z,True,8,15,0,0,5,4,1,8,4,4,-3,0
Bryan,509,1,132,2018-12-02T12:00:00Z,False,8,5,0,0,8,7,1,28,15,13,-20,-14
Bryan,509,1,143,2018-12-05T19:45:00Z,True,8,10,13,1,8,7,1,21,11,10,-13,-3
Bryan,509,1,157,2018-12-08T15:00:00Z,False,8,13,90,0,9,8,1,23,12,11,-14,-11
Bryan,509,1,162,2018-12-15T17:30:00Z,True,8,18,90,1,9,8,1,21,13,8,-12,0
Bryan,509,1,177,2018-12-22T15:00:00Z,False,8,14,90,6,9,8,1,16,6,10,-7,-5
Bryan,509,1,183,2018-12-26T12:30:00Z,True,8,19,90,2,10,8,2,25,14,11,-15,-3
Bryan,509,1,193,2018-12-29T15:00:00Z,True,8,9,90,7,11,9,2,10,5,5,1,4
Bryan,509,1,200,2019-01-01T15:00:00Z,False,8,0,90,0,14,12,2,38,23,15,-24,-21
Bryan,509,1,211,2019-01-12T15:00:00Z,False,8,3,60,-1,14,12,2,18,10,8,-4,-8
Bryan,509,1,222,2019-01-20T16:00:00Z,True,8,16,90,1,14,12,2,48,18,30,-34,-18
Bryan,509,1,232,2019-01-29T19:45:00Z,True,8,2,76,4,14,12,2,26,18,8,-12,4
Bryan,509,1,244,2019-02-02T15:00:00Z,False,8,6,90,1,17,15,2,23,9,14,-6,-7
Bryan,509,1,252,2019-02-09T12:30:00Z,True,8,13,80,0,17,15,2,48,25,23,-31,-8
Bryan,509,1,269,2019-02-22T19:45:00Z,False,8,18,90,0,17,15,2,33,18,15,-16,-16
Bryan,509,1,279,2019-02-27T19:45:00Z,False,8,15,90,1,17,15,2,24,12,12,-7,-10
Bryan,509,1,284,2019-03-03T14:05:00Z,True,8,5,90,1,17,15,2,53,31,22,-36,-7
Bryan,509,1,295,2019-03-09T15:00:00Z,False,8,10,90,0,17,15,2,35,17,18,-18,-15
Bryan,509,1,304,2019-03-17T14:15:00Z,True,8,11,90,0,17,15,2,73,41,32,-56,-17
Bryan,509,1,315,2019-03-30T12:30:00Z,True,8,12,90,1,17,15,2,74,45,29,-57,-14
Bryan,509,1,328,2019-04-02T18:45:00Z,False,8,17,90,0,17,15,2,43,23,20,-26,-21
Bryan,509,1,333,2019-04-13T14:00:00Z,True,8,7,90,6,17,15,2,46,28,18,-29,-3
Bryan,509,1,341,2019-04-20T14:00:00Z,False,8,1,90,9,20,18,2,41,26,15,-21,-24
Bryan,509,1,353,2019-04-27T14:00:00Z,True,8,4,90,6,23,18,5,31,20,11,-8,7
Bryan,509,1,369,2019-05-04T14:00:00Z,False,8,19,90,2,26,21,5,54,31,23,-28,-26
Bryan,509,1,373,2019-05-12T14:00:00Z,True,8,14,90,-1,26,21,5,42,25,17,-16,4
Fosu-Mensah,510,1,2,2018-08-11T14:00:00Z,True,8,6,0,0,0,0,0,0,0,0,0,0
Fosu-Mensah,510,1,18,2018-08-18T14:00:00Z,False,8,16,90,1,0,0,0,3,0,3,-3,0
Fosu-Mensah,510,1,22,2018-08-26T15:00:00Z,True,8,3,90,1,0,0,0,1,0,1,-1,-1
Fosu-Mensah,510,1,30,2018-09-01T14:00:00Z,False,8,2,90,1,3,3,0,3,3,0,0,-3
Fosu-Mensah,510,1,44,2018-09-15T14:00:00Z,False,8,12,0,0,4,3,1,10,6,4,-6,-5
Fosu-Mensah,510,1,55,2018-09-22T11:30:00Z,True,8,17,90,1,4,3,1,12,9,3,-8,0
Fosu-Mensah,510,1,64,2018-09-29T14:00:00Z,False,8,7,7,1,5,4,1,6,4,2,-1,-3
Fosu-Mensah,510,1,73,2018-10-07T11:00:00Z,True,8,0,0,0,5,4,1,15,9,6,-10,-2
Fosu-Mensah,510,1,82,2018-10-20T14:00:00Z,False,8,4,0,0,5,4,1,2,1,1,3,0
Fosu-Mensah,510,1,93,2018-10-27T14:00:00Z,True,8,1,90,1,5,4,1,17,11,6,-12,-2
Fosu-Mensah,510,1,105,2018-11-05T20:00:00Z,False,8,9,45,-2,5,4,1,3,1,2,2,0
Fosu-Mensah,510,1,116,2018-11-11T12:00:00Z,False,8,11,0,0,5,4,1,27,13,14,-22,-12
Fosu-Mensah,510,1,124,2018-11-24T15:00:00Z,True,8,15,0,0,5,4,1,8,4,4,-3,0
Fosu-Mensah,510,1,132,2018-12-02T12:00:00Z,False,8,5,0,0,8,7,1,28,15,13,-20,-14
Fosu-Mensah,510,1,143,2018-12-05T19:45:00Z,True,8,10,0,0,8,7,1,21,11,10,-13,-3
Fosu-Mensah,510,1,157,2018-12-08T15:00:00Z,False,8,13,0,0,9,8,1,23,12,11,-14,-11
Fosu-Mensah,510,1,162,2018-12-15T17:30:00Z,True,8,18,0,0,9,8,1,21,13,8,-12,0
Fosu-Mensah,510,1,177,2018-12-22T15:00:00Z,False,8,14,0,0,9,8,1,16,6,10,-7,-5
Fosu-Mensah,510,1,183,2018-12-26T12:30:00Z,True,8,19,0,0,10,8,2,25,14,11,-15,-3
Fosu-Mensah,510,1,193,2018-12-29T15:00:00Z,True,8,9,0,0,11,9,2,10,5,5,1,4
Fosu-Mensah,510,1,200,2019-01-01T15:00:00Z,False,8,0,34,-1,14,12,2,38,23,15,-24,-21
Fosu-Mensah,510,1,211,2019-01-12T15:00:00Z,False,8,3,0,0,14,12,2,18,10,8,-4,-8
Fosu-Mensah,510,1,222,2019-01-20T16:00:00Z,True,8,16,0,0,14,12,2,48,18,30,-34,-18
Fosu-Mensah,510,1,232,2019-01-29T19:45:00Z,True,8,2,0,0,14,12,2,26,18,8,-12,4
Fosu-Mensah,510,1,244,2019-02-02T15:00:00Z,False,8,6,28,1,17,15,2,23,9,14,-6,-7
Fosu-Mensah,510,1,252,2019-02-09T12:30:00Z,True,8,13,0,0,17,15,2,48,25,23,-31,-8
Fosu-Mensah,510,1,269,2019-02-22T19:45:00Z,False,8,18,0,0,17,15,2,33,18,15,-16,-16
Fosu-Mensah,510,1,279,2019-02-27T19:45:00Z,False,8,15,0,0,17,15,2,24,12,12,-7,-10
Fosu-Mensah,510,1,284,2019-03-03T14:05:00Z,True,8,5,0,0,17,15,2,53,31,22,-36,-7
Fosu-Mensah,510,1,295,2019-03-09T15:00:00Z,False,8,10,0,0,17,15,2,35,17,18,-18,-15
Fosu-Mensah,510,1,304,2019-03-17T14:15:00Z,True,8,11,72,2,17,15,2,73,41,32,-56,-17
Fosu-Mensah,510,1,315,2019-03-30T12:30:00Z,True,8,12,90,1,17,15,2,74,45,29,-57,-14
Fosu-Mensah,510,1,328,2019-04-02T18:45:00Z,False,8,17,0,0,17,15,2,43,23,20,-26,-21
Fosu-Mensah,510,1,333,2019-04-13T14:00:00Z,True,8,7,65,7,17,15,2,46,28,18,-29,-3
Fosu-Mensah,510,1,341,2019-04-20T14:00:00Z,False,8,1,0,0,20,18,2,41,26,15,-21,-24
Fosu-Mensah,510,1,353,2019-04-27T14:00:00Z,True,8,4,0,0,23,18,5,31,20,11,-8,7
Fosu-Mensah,510,1,369,2019-05-04T14:00:00Z,False,8,19,0,0,26,21,5,54,31,23,-28,-26
Fosu-Mensah,510,1,373,2019-05-12T14:00:00Z,True,8,14,0,0,26,21,5,42,25,17,-16,4
Zambo Anguissa,511,2,2,2018-08-11T14:00:00Z,True,8,6,0,0,0,0,0,0,0,0,0,0
Zambo Anguissa,511,2,18,2018-08-18T14:00:00Z,False,8,16,90,2,0,0,0,3,0,3,-3,0
Zambo Anguissa,511,2,22,2018-08-26T15:00:00Z,True,8,3,12,1,0,0,0,1,0,1,-1,-1
Zambo Anguissa,511,2,30,2018-09-01T14:00:00Z,False,8,2,73,2,3,3,0,3,3,0,0,-3
Zambo Anguissa,511,2,44,2018-09-15T14:00:00Z,False,8,12,34,1,4,3,1,10,6,4,-6,-5
Zambo Anguissa,511,2,55,2018-09-22T11:30:00Z,True,8,17,26,1,4,3,1,12,9,3,-8,0
Zambo Anguissa,511,2,64,2018-09-29T14:00:00Z,False,8,7,90,2,5,4,1,6,4,2,-1,-3
Zambo Anguissa,511,2,73,2018-10-07T11:00:00Z,True,8,0,61,2,5,4,1,15,9,6,-10,-2
Zambo Anguissa,511,2,82,2018-10-20T14:00:00Z,False,8,4,0,0,5,4,1,2,1,1,3,0
Zambo Anguissa,511,2,93,2018-10-27T14:00:00Z,True,8,1,10,1,5,4,1,17,11,6,-12,-2
Zambo Anguissa,511,2,105,2018-11-05T20:00:00Z,False,8,9,90,2,5,4,1,3,1,2,2,0
Zambo Anguissa,511,2,116,2018-11-11T12:00:00Z,False,8,11,83,2,5,4,1,27,13,14,-22,-12
Zambo Anguissa,511,2,124,2018-11-24T15:00:00Z,True,8,15,0,0,5,4,1,8,4,4,-3,0
Zambo Anguissa,511,2,132,2018-12-02T12:00:00Z,False,8,5,0,0,8,7,1,28,15,13,-20,-14
Zambo Anguissa,511,2,143,2018-12-05T19:45:00Z,True,8,10,0,0,8,7,1,21,11,10,-13,-3
Zambo Anguissa,511,2,157,2018-12-08T15:00:00Z,False,8,13,67,-1,9,8,1,23,12,11,-14,-11
Zambo Anguissa,511,2,162,2018-12-15T17:30:00Z,True,8,18,0,0,9,8,1,21,13,8,-12,0
Zambo Anguissa,511,2,177,2018-12-22T15:00:00Z,False,8,14,0,0,9,8,1,16,6,10,-7,-5
Zambo Anguissa,511,2,183,2018-12-26T12:30:00Z,True,8,19,0,0,10,8,2,25,14,11,-15,-3
Zambo Anguissa,511,2,193,2018-12-29T15:00:00Z,True,8,9,0,0,11,9,2,10,5,5,1,4
Zambo Anguissa,511,2,200,2019-01-01T15:00:00Z,False,8,0,0,0,14,12,2,38,23,15,-24,-21
Zambo Anguissa,511,2,211,2019-01-12T15:00:00Z,False,8,3,0,0,14,12,2,18,10,8,-4,-8
Zambo Anguissa,511,2,222,2019-01-20T16:00:00Z,True,8,16,0,0,14,12,2,48,18,30,-34,-18
Zambo Anguissa,511,2,232,2019-01-29T19:45:00Z,True,8,2,0,0,14,12,2,26,18,8,-12,4
Zambo Anguissa,511,2,244,2019-02-02T15:00:00Z,False,8,6,0,0,17,15,2,23,9,14,-6,-7
Zambo Anguissa,511,2,252,2019-02-09T12:30:00Z,True,8,13,0,0,17,15,2,48,25,23,-31,-8
Zambo Anguissa,511,2,269,2019-02-22T19:45:00Z,False,8,18,45,1,17,15,2,33,18,15,-16,-16
Zambo Anguissa,511,2,279,2019-02-27T19:45:00Z,False,8,15,90,2,17,15,2,24,12,12,-7,-10
Zambo Anguissa,511,2,284,2019-03-03T14:05:00Z,True,8,5,28,1,17,15,2,53,31,22,-36,-7
Zambo Anguissa,511,2,295,2019-03-09T15:00:00Z,False,8,10,0,0,17,15,2,35,17,18,-18,-15
Zambo Anguissa,511,2,304,2019-03-17T14:15:00Z,True,8,11,90,1,17,15,2,73,41,32,-56,-17
Zambo Anguissa,511,2,315,2019-03-30T12:30:00Z,True,8,12,90,2,17,15,2,74,45,29,-57,-14
Zambo Anguissa,511,2,328,2019-04-02T18:45:00Z,False,8,17,90,2,17,15,2,43,23,20,-26,-21
Zambo Anguissa,511,2,333,2019-04-13T14:00:00Z,True,8,7,88,3,17,15,2,46,28,18,-29,-3
Zambo Anguissa,511,2,341,2019-04-20T14:00:00Z,False,8,1,88,3,20,18,2,41,26,15,-21,-24
Zambo Anguissa,511,2,353,2019-04-27T14:00:00Z,True,8,4,90,3,23,18,5,31,20,11,-8,7
Zambo Anguissa,511,2,369,2019-05-04T14:00:00Z,False,8,19,87,2,26,21,5,54,31,23,-28,-26
Zambo Anguissa,511,2,373,2019-05-12T14:00:00Z,True,8,14,90,2,26,21,5,42,25,17,-16,4
Vietto,512,3,2,2018-08-11T14:00:00Z,True,8,6,19,1,0,0,0,0,0,0,0,0
Vietto,512,3,18,2018-08-18T14:00:00Z,False,8,16,0,0,0,0,0,3,0,3,-3,0
Vietto,512,3,22,2018-08-26T15:00:00Z,True,8,3,90,9,0,0,0,1,0,1,-1,-1
Vietto,512,3,30,2018-09-01T14:00:00Z,False,8,2,73,2,3,3,0,3,3,0,0,-3
Vietto,512,3,44,2018-09-15T14:00:00Z,False,8,12,68,2,4,3,1,10,6,4,-6,-5
Vietto,512,3,55,2018-09-22T11:30:00Z,True,8,17,90,7,4,3,1,12,9,3,-8,0
Vietto,512,3,64,2018-09-29T14:00:00Z,False,8,7,63,2,5,4,1,6,4,2,-1,-3
Vietto,512,3,73,2018-10-07T11:00:00Z,True,8,0,82,4,5,4,1,15,9,6,-10,-2
Vietto,512,3,82,2018-10-20T14:00:00Z,False,8,4,8,1,5,4,1,2,1,1,3,0
Vietto,512,3,93,2018-10-27T14:00:00Z,True,8,1,0,0,5,4,1,17,11,6,-12,-2
Vietto,512,3,105,2018-11-05T20:00:00Z,False,8,9,45,1,5,4,1,3,1,2,2,0
Vietto,512,3,116,2018-11-11T12:00:00Z,False,8,11,12,1,5,4,1,27,13,14,-22,-12
Vietto,512,3,124,2018-11-24T15:00:00Z,True,8,15,0,0,5,4,1,8,4,4,-3,0
Vietto,512,3,132,2018-12-02T12:00:00Z,False,8,5,0,0,8,7,1,28,15,13,-20,-14
Vietto,512,3,143,2018-12-05T19:45:00Z,True,8,10,45,1,8,7,1,21,11,10,-13,-3
Vietto,512,3,157,2018-12-08T15:00:00Z,False,8,13,45,1,9,8,1,23,12,11,-14,-11
Vietto,512,3,162,2018-12-15T17:30:00Z,True,8,18,0,0,9,8,1,21,13,8,-12,0
Vietto,512,3,177,2018-12-22T15:00:00Z,False,8,14,0,0,9,8,1,16,6,10,-7,-5
Vietto,512,3,183,2018-12-26T12:30:00Z,True,8,19,0,0,10,8,2,25,14,11,-15,-3
Vietto,512,3,193,2018-12-29T15:00:00Z,True,8,9,76,2,11,9,2,10,5,5,1,4
Vietto,512,3,200,2019-01-01T15:00:00Z,False,8,0,0,0,14,12,2,38,23,15,-24,-21
Vietto,512,3,211,2019-01-12T15:00:00Z,False,8,3,45,1,14,12,2,18,10,8,-4,-8
Vietto,512,3,222,2019-01-20T16:00:00Z,True,8,16,0,0,14,12,2,48,18,30,-34,-18
Vietto,512,3,232,2019-01-29T19:45:00Z,True,8,2,45,6,14,12,2,26,18,8,-12,4
Vietto,512,3,244,2019-02-02T15:00:00Z,False,8,6,45,1,17,15,2,23,9,14,-6,-7
Vietto,512,3,252,2019-02-09T12:30:00Z,True,8,13,90,2,17,15,2,48,25,23,-31,-8
Vietto,512,3,269,2019-02-22T19:45:00Z,False,8,18,0,0,17,15,2,33,18,15,-16,-16
Vietto,512,3,279,2019-02-27T19:45:00Z,False,8,15,21,1,17,15,2,24,12,12,-7,-10
Vietto,512,3,284,2019-03-03T14:05:00Z,True,8,5,10,1,17,15,2,53,31,22,-36,-7
Vietto,512,3,295,2019-03-09T15:00:00Z,False,8,10,8,1,17,15,2,35,17,18,-18,-15
Vietto,512,3,304,2019-03-17T14:15:00Z,True,8,11,0,0,17,15,2,73,41,32,-56,-17
Vietto,512,3,315,2019-03-30T12:30:00Z,True,8,12,0,0,17,15,2,74,45,29,-57,-14
Vietto,512,3,328,2019-04-02T18:45:00Z,False,8,17,0,0,17,15,2,43,23,20,-26,-21
Vietto,512,3,333,2019-04-13T14:00:00Z,True,8,7,0,0,17,15,2,46,28,18,-29,-3
Vietto,512,3,341,2019-04-20T14:00:00Z,False,8,1,0,0,20,18,2,41,26,15,-21,-24
Vietto,512,3,353,2019-04-27T14:00:00Z,True,8,4,0,0,23,18,5,31,20,11,-8,7
Vietto,512,3,369,2019-05-04T14:00:00Z,False,8,19,0,0,26,21,5,54,31,23,-28,-26
Vietto,512,3,373,2019-05-12T14:00:00Z,True,8,14,0,0,26,21,5,42,25,17,-16,4
Mbenza,513,2,3,2018-08-11T14:00:00Z,True,9,5,0,0,0,0,0,0,0,0,0,0
Mbenza,513,2,17,2018-08-19T12:30:00Z,False,9,12,0,0,0,0,0,3,0,3,-3,0
Mbenza,513,2,23,2018-08-25T14:00:00Z,True,9,4,22,1,0,0,0,1,1,0,-1,0
Mbenza,513,2,35,2018-09-01T14:00:00Z,False,9,7,0,0,1,1,0,5,3,2,-4,-3
Mbenza,513,2,43,2018-09-15T14:00:00Z,True,9,6,12,1,2,1,1,3,0,3,-1,-2
Mbenza,513,2,56,2018-09-22T14:00:00Z,False,9,10,0,0,2,1,1,6,3,3,-4,-2
Mbenza,513,2,65,2018-09-29T14:00:00Z,True,9,16,19,1,2,1,1,12,3,9,-10,-8
Mbenza,513,2,71,2018-10-06T14:00:00Z,False,9,3,31,1,2,1,1,7,3,4,-5,-2
Mbenza,513,2,85,2018-10-20T16:30:00Z,True,9,11,21,1,3,1,2,20,10,10,-17,-9
Mbenza,513,2,99,2018-10-27T14:00:00Z,False,9,17,62,2,3,1,2,16,9,7,-13,-7
Mbenza,513,2,105,2018-11-05T20:00:00Z,True,9,8,8,0,3,1,2,5,4,1,-2,0
Mbenza,513,2,114,2018-11-10T15:00:00Z,True,9,18,18,1,6,4,2,11,7,4,-5,0
Mbenza,513,2,129,2018-11-25T16:00:00Z,False,9,19,1,1,7,5,2,16,8,8,-9,-6
Mbenza,513,2,134,2018-12-01T15:00:00Z,True,9,2,0,0,10,5,5,15,11,4,-5,1
Mbenza,513,2,140,2018-12-04T19:45:00Z,False,9,1,15,1,10,5,5,20,11,9,-10,-6
Mbenza,513,2,150,2018-12-08T15:00:00Z,False,9,0,0,0,10,5,5,31,17,14,-21,-12
Mbenza,513,2,163,2018-12-15T15:00:00Z,True,9,14,13,1,10,5,5,13,6,7,-3,-2
Mbenza,513,2,175,2018-12-22T15:00:00Z,True,9,15,80,2,10,5,5,12,8,4,-2,1
Mbenza,513,2,186,2018-12-26T15:00:00Z,False,9,13,61,2,10,5,5,29,15,14,-19,-10
Mbenza,513,2,193,2018-12-29T15:00:00Z,False,9,8,0,0,10,5,5,11,9,2,-1,-4
Mbenza,513,2,205,2019-01-02T19:45:00Z,True,9,3,90,5,10,5,5,15,10,5,-5,0
Mbenza,513,2,212,2019-01-12T15:00:00Z,False,9,4,17,1,10,5,5,18,13,5,-8,-8
Mbenza,513,2,223,2019-01-20T13:30:00Z,True,9,12,90,2,11,5,6,53,33,20,-42,-15
Mbenza,513,2,233,2019-01-29T19:45:00Z,True,9,7,0,0,11,5,6,30,21,9,-19,-4
Mbenza,513,2,243,2019-02-02T15:00:00Z,False,9,5,26,1,11,5,6,47,25,22,-36,-19
Mbenza,513,2,253,2019-02-09T15:00:00Z,True,9,0,0,0,11,5,6,47,32,15,-36,-10
Mbenza,513,2,268,2019-02-23T15:00:00Z,False,9,14,0,0,11,5,6,25,13,12,-14,-7
Mbenza,513,2,273,2019-02-26T19:45:00Z,True,9,19,0,0,11,5,6,40,21,19,-29,-14
Mbenza,513,2,281,2019-03-02T15:00:00Z,False,9,2,0,0,14,8,6,27,19,8,-13,-13
Mbenza,513,2,294,2019-03-09T15:00:00Z,True,9,1,0,0,14,8,6,34,25,9,-20,-1
Mbenza,513,2,308,2019-03-16T15:00:00Z,False,9,18,0,0,14,8,6,39,24,15,-25,-18
Mbenza,513,2,314,2019-03-30T15:00:00Z,False,9,6,0,0,14,8,6,33,13,20,-19,-7
Mbenza,513,2,323,2019-04-06T14:00:00Z,True,9,10,45,1,14,8,6,44,23,21,-30,-13
Mbenza,513,2,338,2019-04-13T11:30:00Z,False,9,16,0,0,14,8,6,64,31,33,-50,-25
Mbenza,513,2,345,2019-04-20T14:00:00Z,True,9,17,80,2,14,8,6,46,26,20,-32,-12
Mbenza,513,2,355,2019-04-26T19:00:00Z,False,9,11,86,2,14,8,6,88,47,41,-74,-41
Mbenza,513,2,365,2019-05-05T13:00:00Z,True,9,13,90,7,14,8,6,65,36,29,-51,-21
Mbenza,513,2,377,2019-05-12T14:00:00Z,False,9,15,90,2,15,9,6,38,22,16,-23,-16
Soyuncu,514,1,5,2018-08-10T19:00:00Z,False,10,13,0,0,0,0,0,0,0,0,0,0
Soyuncu,514,1,16,2018-08-18T14:00:00Z,True,10,19,0,0,0,0,0,1,1,0,-1,0
Soyuncu,514,1,27,2018-08-25T14:00:00Z,False,10,15,0,0,3,3,0,1,1,0,2,-1
Soyuncu,514,1,36,2018-09-01T11:30:00Z,True,10,11,0,0,6,3,3,9,6,3,-3,0
Soyuncu,514,1,40,2018-09-15T14:00:00Z,False,10,1,0,0,6,3,3,7,4,3,-1,-1
Soyuncu,514,1,56,2018-09-22T14:00:00Z,True,10,9,0,0,6,3,3,2,1,1,4,2
Soyuncu,514,1,67,2018-09-29T14:00:00Z,False,10,14,0,0,9,6,3,2,0,2,7,3
Soyuncu,514,1,74,2018-10-06T14:00:00Z,True,10,7,0,0,12,6,6,9,7,2,3,4
Soyuncu,514,1,80,2018-10-22T19:00:00Z,False,10,0,0,0,12,6,6,18,9,9,-6,-3
Soyuncu,514,1,94,2018-10-27T16:30:00Z,True,10,18,79,1,12,6,6,7,4,3,5,3
Soyuncu,514,1,102,2018-11-03T15:00:00Z,False,10,4,0,0,13,7,6,5,4,1,8,2
Soyuncu,514,1,115,2018-11-10T15:00:00Z,True,10,3,1,1,16,7,9,8,4,4,8,3
Soyuncu,514,1,121,2018-11-24T15:00:00Z,False,10,2,0,0,17,8,9,14,10,4,3,-1
Soyuncu,514,1,135,2018-12-01T15:00:00Z,True,10,17,21,1,18,8,10,20,12,8,-2,0
Soyuncu,514,1,143,2018-12-05T19:45:00Z,False,10,8,90,2,21,11,10,8,7,1,13,3
Soyuncu,514,1,156,2018-12-08T19:45:00Z,True,10,16,0,0,22,11,11,33,12,21,-11,-10
Soyuncu,514,1,161,2018-12-15T15:00:00Z,False,10,6,0,0,22,11,11,12,5,7,10,6
Soyuncu,514,1,173,2018-12-22T15:00:00Z,False,10,5,0,0,22,11,11,37,21,16,-15,-10
Soyuncu,514,1,184,2018-12-26T15:00:00Z,True,10,12,0,0,25,11,14,44,27,17,-19,-6
Soyuncu,514,1,194,2018-12-29T15:00:00Z,True,10,4,90,2,28,14,14,15,13,2,13,12
Soyuncu,514,1,204,2019-01-01T12:30:00Z,False,10,7,0,0,28,14,14,27,18,9,1,-4
Soyuncu,514,1,216,2019-01-12T15:00:00Z,True,10,15,0,0,31,14,17,16,8,8,15,6
Soyuncu,514,1,229,2019-01-19T12:30:00Z,False,10,19,0,0,31,14,17,29,14,15,2,3
Soyuncu,514,1,236,2019-01-30T20:00:00Z,False,10,11,0,0,31,14,17,60,31,29,-29,-14
Soyuncu,514,1,246,2019-02-03T14:05:00Z,True,10,13,0,0,32,14,18,45,25,20,-13,-6
Soyuncu,514,1,257,2019-02-10T13:30:00Z,False,10,16,0,0,32,14,18,57,24,33,-25,-6
Soyuncu,514,1,266,2019-02-23T17:30:00Z,True,10,6,0,0,32,14,18,27,13,14,5,0
Soyuncu,514,1,274,2019-02-26T19:45:00Z,True,10,2,0,0,32,14,18,27,19,8,5,6
Soyuncu,514,1,287,2019-03-03T12:00:00Z,False,10,17,0,0,35,17,18,40,20,20,-5,-2
Soyuncu,514,1,295,2019-03-09T15:00:00Z,True,10,8,0,0,35,17,18,17,15,2,18,15
Soyuncu,514,1,302,2019-03-16T15:00:00Z,False,10,3,0,0,38,20,18,30,17,13,8,1
Soyuncu,514,1,316,2019-03-30T15:00:00Z,True,10,1,0,0,41,20,21,38,26,12,3,8
Soyuncu,514,1,323,2019-04-06T14:00:00Z,False,10,9,90,2,44,23,21,14,8,6,30,13
Soyuncu,514,1,334,2019-04-12T19:00:00Z,True,10,14,0,0,47,23,24,35,22,13,12,10
Soyuncu,514,1,348,2019-04-20T14:00:00Z,False,10,18,0,0,47,23,24,42,27,15,5,-3
Soyuncu,514,1,354,2019-04-28T11:00:00Z,True,10,0,0,0,48,23,25,66,44,22,-18,1
Soyuncu,514,1,366,2019-05-06T19:00:00Z,False,10,12,0,0,51,26,25,92,51,41,-41,-26
Soyuncu,514,1,374,2019-05-12T14:00:00Z,True,10,5,0,0,51,26,25,71,42,29,-20,-3
Fernandez,515,1,6,2018-08-11T11:30:00Z,True,14,16,0,0,0,0,0,0,0,0,0,0
Fernandez,515,1,12,2018-08-18T11:30:00Z,False,14,4,0,0,0,0,0,0,0,0,0,0
Fernandez,515,1,26,2018-08-26T15:00:00Z,True,14,5,90,0,1,0,1,6,3,3,-5,-3
Fernandez,515,1,37,2018-09-01T16:30:00Z,False,14,12,90,1,1,0,1,7,3,4,-6,-2
Fernandez,515,1,45,2018-09-15T14:00:00Z,True,14,0,90,5,1,0,1,6,3,3,-5,-3
Fernandez,515,1,54,2018-09-22T14:00:00Z,False,14,6,90,6,1,0,1,6,0,6,-5,1
Fernandez,515,1,67,2018-09-29T14:00:00Z,True,14,10,0,0,2,0,2,9,6,3,-7,-3
Fernandez,515,1,76,2018-10-06T16:30:00Z,False,14,13,90,1,2,0,2,10,4,6,-8,-2
Fernandez,515,1,87,2018-10-20T14:00:00Z,True,14,2,90,2,2,0,2,8,7,1,-6,-1
Fernandez,515,1,97,2018-10-27T14:00:00Z,False,14,15,90,6,2,0,2,6,2,4,-4,0
Fernandez,515,1,107,2018-11-03T15:00:00Z,True,14,17,90,8,3,0,3,19,12,7,-16,-7
Fernandez,515,1,118,2018-11-10T15:00:00Z,True,14,1,90,2,6,3,3,20,11,9,-14,-6
Fernandez,515,1,122,2018-11-26T20:30:00Z,False,14,3,90,7,9,6,3,9,4,5,0,-1
Fernandez,515,1,138,2018-12-01T15:00:00Z,True,14,18,90,1,12,6,6,12,7,5,0,1
Fernandez,515,1,148,2018-12-05T19:45:00Z,False,14,7,90,1,12,6,6,22,16,6,-10,-10
Fernandez,515,1,158,2018-12-09T16:00:00Z,True,14,19,45,1,13,6,7,19,11,8,-6,-2
Fernandez,515,1,163,2018-12-15T15:00:00Z,False,14,9,0,0,13,6,7,10,5,5,3,2
Fernandez,515,1,177,2018-12-22T15:00:00Z,True,14,8,0,0,16,6,10,9,8,1,7,5
Fernandez,515,1,185,2018-12-26T15:00:00Z,False,14,11,90,0,17,7,10,48,22,26,-31,-12
Fernandez,515,1,199,2018-12-29T15:00:00Z,False,14,17,45,1,17,7,10,27,15,12,-10,-5
Fernandez,515,1,207,2019-01-02T20:00:00Z,True,14,13,0,0,18,7,11,35,21,14,-17,-7
Fernandez,515,1,213,2019-01-12T17:30:00Z,False,14,5,0,0,18,7,11,44,22,22,-26,-11
Fernandez,515,1,226,2019-01-19T15:00:00Z,True,14,4,0,0,18,7,11,19,14,5,-1,2
Fernandez,515,1,237,2019-01-29T20:00:00Z,True,14,12,0,0,21,10,11,56,33,23,-35,-13
Fernandez,515,1,248,2019-02-02T12:30:00Z,False,14,16,0,0,24,13,11,54,21,33,-30,-10
Fernandez,515,1,259,2019-02-11T20:00:00Z,False,14,19,0,0,24,13,11,38,20,18,-14,-9
Fernandez,515,1,268,2019-02-23T15:00:00Z,True,14,9,0,0,25,13,12,11,5,6,14,7
Fernandez,515,1,278,2019-02-26T20:00:00Z,True,14,3,0,0,28,16,12,30,17,13,-2,3
Fernandez,515,1,288,2019-03-02T17:30:00Z,False,14,18,0,0,31,19,12,36,21,15,-5,-9
Fernandez,515,1,298,2019-03-09T15:00:00Z,True,14,7,0,0,31,19,12,37,22,15,-6,4
Fernandez,515,1,300,2019-03-16T15:00:00Z,False,14,1,90,1,34,22,12,37,25,12,-3,-13
Fernandez,515,1,310,2019-04-01T19:00:00Z,False,14,0,0,0,35,22,13,60,41,19,-25,-28
Fernandez,515,1,325,2019-04-06T14:00:00Z,True,14,6,0,0,35,22,13,36,16,20,-1,2
Fernandez,515,1,334,2019-04-12T19:00:00Z,False,14,10,0,0,35,22,13,47,23,24,-12,-10
Fernandez,515,1,347,2019-04-20T16:30:00Z,True,14,15,21,1,38,22,16,36,21,15,2,7
Fernandez,515,1,350,2019-04-27T16:30:00Z,False,14,2,90,2,41,25,16,34,22,12,7,-6
Fernandez,515,1,367,2019-05-04T18:45:00Z,True,14,11,0,0,42,25,17,91,50,41,-49,-16
Fernandez,515,1,373,2019-05-12T14:00:00Z,False,14,8,21,1,42,25,17,26,21,5,16,-4
Quina,516,2,8,2018-08-11T14:00:00Z,True,17,2,0,0,0,0,0,0,0,0,0,0
Quina,516,2,11,2018-08-19T12:30:00Z,False,17,3,0,0,3,3,0,1,0,1,2,0
Quina,516,2,28,2018-08-26T12:30:00Z,True,17,6,0,0,6,3,3,3,0,3,3,0
Quina,516,2,38,2018-09-02T15:00:00Z,True,17,16,0,0,9,6,3,9,3,6,0,0
Quina,516,2,48,2018-09-15T16:30:00Z,True,17,13,0,0,12,9,3,6,3,3,6,6
Quina,516,2,55,2018-09-22T11:30:00Z,False,17,8,0,0,12,9,3,4,3,1,8,0
Quina,516,2,60,2018-09-29T14:00:00Z,False,17,0,0,0,13,9,4,12,6,6,1,-2
Quina,516,2,79,2018-10-06T14:00:00Z,True,17,1,0,0,13,9,4,13,10,3,0,6
Quina,516,2,89,2018-10-20T14:00:00Z,False,17,19,0,0,13,9,4,15,8,7,-2,-4
Quina,516,2,99,2018-10-27T14:00:00Z,True,17,9,0,0,16,9,7,3,1,2,13,7
Quina,516,2,107,2018-11-03T15:00:00Z,False,17,14,0,0,19,12,7,3,0,3,16,7
Quina,516,2,119,2018-11-10T15:00:00Z,False,17,15,0,0,19,12,7,7,3,4,12,4
Quina,516,2,127,2018-11-24T15:00:00Z,True,17,11,0,0,20,12,8,30,16,14,-10,-2
Quina,516,2,135,2018-12-01T15:00:00Z,False,17,10,0,0,20,12,8,18,8,10,2,0
Quina,516,2,145,2018-12-04T20:00:00Z,True,17,12,38,1,20,12,8,38,24,14,-18,-2
Quina,516,2,155,2018-12-10T20:00:00Z,False,17,7,90,2,20,12,8,23,17,6,-3,-9
Quina,516,2,168,2018-12-15T15:00:00Z,True,17,4,90,9,21,12,9,14,13,1,7,11
Quina,516,2,178,2018-12-22T15:00:00Z,False,17,18,0,0,24,15,9,24,13,11,0,-4
Quina,516,2,189,2018-12-26T19:30:00Z,True,17,5,23,1,27,15,12,37,21,16,-10,-1
Quina,516,2,199,2018-12-29T15:00:00Z,True,17,14,53,1,27,15,12,17,7,10,10,5
Quina,516,2,201,2019-01-02T19:45:00Z,False,17,1,0,0,28,16,12,26,17,9,2,-5
Quina,516,2,214,2019-01-12T15:00:00Z,False,17,6,0,0,29,16,13,22,9,13,7,4
Quina,516,2,228,2019-01-19T15:00:00Z,True,17,3,0,0,32,16,16,21,13,8,11,8
Quina,516,2,239,2019-01-30T20:00:00Z,False,17,16,0,0,33,17,16,51,18,33,-18,-2
Quina,516,2,240,2019-02-02T15:00:00Z,False,17,2,9,1,33,17,16,26,18,8,7,-2
Quina,516,2,258,2019-02-09T15:00:00Z,True,17,7,0,0,34,17,17,33,21,12,1,5
Quina,516,2,263,2019-02-22T19:45:00Z,False,17,4,19,1,37,20,17,25,17,8,12,0
Quina,516,2,276,2019-02-27T20:00:00Z,False,17,11,0,0,40,20,20,66,35,31,-26,-15
Quina,516,2,287,2019-03-03T12:00:00Z,True,17,10,0,0,40,20,20,35,17,18,5,2
Quina,516,2,297,2019-03-09T17:30:00Z,False,17,12,0,0,43,23,20,71,42,29,-28,-22
Quina,516,2,318,2019-03-30T15:00:00Z,False,17,13,0,0,43,23,20,58,29,29,-15,-9
Quina,516,2,328,2019-04-02T18:45:00Z,True,17,8,12,1,43,23,20,17,15,2,26,21
Quina,516,2,339,2019-04-15T19:00:00Z,True,17,0,0,0,46,26,20,63,44,19,-17,7
Quina,516,2,345,2019-04-20T14:00:00Z,False,17,9,0,0,46,26,20,14,8,6,32,12
Quina,516,2,307,2019-04-23T18:45:00Z,True,17,15,0,0,49,26,23,36,21,15,13,11
Quina,516,2,359,2019-04-27T14:00:00Z,True,17,19,0,0,50,27,23,51,31,20,-1,7
Quina,516,2,363,2019-05-05T13:00:00Z,False,17,5,0,0,50,27,23,68,39,29,-18,-16
Quina,516,2,379,2019-05-12T14:00:00Z,True,17,18,0,0,50,27,23,49,31,18,1,9
Carlos Sanchez,517,2,4,2018-08-12T12:30:00Z,False,18,11,0,0,0,0,0,0,0,0,0,0
Carlos Sanchez,517,2,19,2018-08-18T14:00:00Z,True,18,1,13,1,0,0,0,3,3,0,-3,0
Carlos Sanchez,517,2,20,2018-08-25T14:00:00Z,False,18,0,90,2,0,0,0,0,0,0,0,0
Carlos Sanchez,517,2,39,2018-09-01T14:00:00Z,True,18,19,90,2,0,0,0,2,2,0,-2,0
Carlos Sanchez,517,2,42,2018-09-16T15:00:00Z,False,18,7,19,1,0,0,0,6,4,2,-6,-4
Carlos Sanchez,517,2,59,2018-09-23T12:30:00Z,True,18,5,5,1,3,0,3,15,9,6,-12,-6
Carlos Sanchez,517,2,68,2018-09-29T11:30:00Z,True,18,13,0,0,4,1,3,10,4,6,-6,-5
Carlos Sanchez,517,2,70,2018-10-05T19:00:00Z,False,18,2,0,0,7,4,3,5,4,1,2,-1
Carlos Sanchez,517,2,88,2018-10-20T14:00:00Z,True,18,16,0,0,7,4,3,18,6,12,-11,-8
Carlos Sanchez,517,2,94,2018-10-27T16:30:00Z,False,18,10,0,0,7,4,3,12,6,6,-5,-3
Carlos Sanchez,517,2,108,2018-11-03T15:00:00Z,True,18,3,0,0,8,4,4,8,4,4,0,0
Carlos Sanchez,517,2,114,2018-11-10T15:00:00Z,False,18,9,0,0,11,7,4,6,4,2,5,0
Carlos Sanchez,517,2,128,2018-11-24T15:00:00Z,True,18,12,0,0,12,7,5,32,21,11,-20,-4
Carlos Sanchez,517,2,138,2018-12-01T15:00:00Z,False,18,14,0,0,12,7,5,12,6,6,0,-1
Carlos Sanchez,517,2,146,2018-12-04T19:45:00Z,True,18,4,0,0,15,7,8,11,10,1,4,6
Carlos Sanchez,517,2,159,2018-12-08T15:00:00Z,True,18,6,0,0,18,10,8,12,5,7,6,3
Carlos Sanchez,517,2,162,2018-12-15T17:30:00Z,False,18,8,0,0,21,13,8,9,8,1,12,0
Carlos Sanchez,517,2,178,2018-12-22T15:00:00Z,True,18,17,0,0,24,13,11,24,15,9,0,4
Carlos Sanchez,517,2,187,2018-12-27T19:45:00Z,False,18,15,0,0,24,13,11,15,8,7,9,3
Carlos Sanchez,517,2,191,2018-12-30T14:15:00Z,False,18,3,0,0,27,13,14,12,7,5,15,7
Carlos Sanchez,517,2,208,2019-01-02T19:45:00Z,True,18,2,0,0,27,13,14,25,18,7,2,6
Carlos Sanchez,517,2,219,2019-01-12T12:30:00Z,True,18,0,0,0,28,14,14,41,26,15,-13,-1
Carlos Sanchez,517,2,221,2019-01-19T15:00:00Z,False,18,1,0,0,31,17,14,27,18,9,4,-4
Carlos Sanchez,517,2,235,2019-01-29T19:45:00Z,False,18,19,0,0,31,17,14,32,17,15,-1,-3
Carlos Sanchez,517,2,249,2019-02-04T20:00:00Z,True,18,11,0,0,31,17,14,61,32,29,-30,-12
Carlos Sanchez,517,2,251,2019-02-09T15:00:00Z,False,18,6,0,0,32,18,14,26,12,14,6,2
Carlos Sanchez,517,2,269,2019-02-22T19:45:00Z,True,18,8,0,0,33,18,15,17,15,2,16,16
Carlos Sanchez,517,2,277,2019-02-27T20:00:00Z,False,18,12,0,0,36,21,15,65,39,26,-29,-24
Carlos Sanchez,517,2,288,2019-03-02T17:30:00Z,True,18,14,0,0,36,21,15,31,19,12,5,9
Carlos Sanchez,517,2,291,2019-03-09T15:00:00Z,False,18,4,0,0,39,24,15,25,17,8,14,-2
Carlos Sanchez,517,2,308,2019-03-16T15:00:00Z,True,18,9,0,0,39,24,15,14,8,6,25,18
Carlos Sanchez,517,2,319,2019-03-30T17:30:00Z,True,18,7,0,0,42,27,15,40,25,15,2,12
Carlos Sanchez,517,2,321,2019-04-08T19:00:00Z,False,18,5,0,0,42,27,15,63,35,28,-21,-20
Carlos Sanchez,517,2,336,2019-04-13T16:30:00Z,False,18,13,0,0,42,27,15,61,32,29,-19,-17
Carlos Sanchez,517,2,348,2019-04-20T14:00:00Z,True,18,10,0,0,42,27,15,47,23,24,-5,3
Carlos Sanchez,517,2,358,2019-04-27T11:30:00Z,False,18,16,0,0,43,28,15,70,37,33,-27,-22
Carlos Sanchez,517,2,368,2019-05-04T14:00:00Z,True,18,15,12,1,46,28,18,38,22,16,8,12
Carlos Sanchez,517,2,379,2019-05-12T14:00:00Z,False,18,17,11,1,49,31,18,50,27,23,-1,-9
Dendoncker,518,2,9,2018-08-11T16:30:00Z,True,19,7,0,0,0,0,0,0,0,0,0,0
Dendoncker,518,2,16,2018-08-18T14:00:00Z,False,19,10,0,0,1,1,0,0,0,0,1,0
Dendoncker,518,2,29,2018-08-25T11:30:00Z,True,19,12,0,0,1,1,0,6,3,3,-5,-2
Dendoncker,518,2,39,2018-09-01T14:00:00Z,False,19,18,0,0,2,2,0,0,0,0,2,0
Dendoncker,518,2,49,2018-09-16T12:30:00Z,True,19,3,0,0,5,2,3,1,0,1,4,1
Dendoncker,518,2,58,2018-09-22T14:00:00Z,False,19,13,0,0,8,5,3,9,3,6,-1,0
Dendoncker,518,2,69,2018-09-29T14:00:00Z,True,19,15,0,0,9,5,4,5,2,3,4,2
Dendoncker,518,2,72,2018-10-06T14:00:00Z,False,19,6,0,0,12,8,4,7,1,6,5,3
Dendoncker,518,2,89,2018-10-20T14:00:00Z,True,19,17,0,0,15,8,7,13,9,4,2,4
Dendoncker,518,2,90,2018-10-27T14:00:00Z,False,19,2,0,0,15,8,7,11,7,4,4,0
Dendoncker,518,2,109,2018-11-03T19:45:00Z,True,19,16,0,0,15,8,7,21,6,15,-6,-7
Dendoncker,518,2,110,2018-11-11T16:30:00Z,False,19,0,0,0,15,8,7,23,13,10,-8,-6
Dendoncker,518,2,129,2018-11-25T16:00:00Z,True,19,9,0,0,16,8,8,7,5,2,9,6
Dendoncker,518,2,131,2018-11-30T20:00:00Z,False,19,4,0,0,16,8,8,8,7,1,8,1
Dendoncker,518,2,147,2018-12-05T19:45:00Z,True,19,5,9,1,16,8,8,31,18,13,-15,-5
Dendoncker,518,2,158,2018-12-09T16:00:00Z,False,19,14,0,0,19,11,8,13,6,7,6,2
Dendoncker,518,2,169,2018-12-15T15:00:00Z,True,19,1,0,0,22,11,11,23,14,9,-1,2
Dendoncker,518,2,179,2018-12-21T20:00:00Z,True,19,11,0,0,25,14,11,45,22,23,-20,-9
Dendoncker,518,2,183,2018-12-26T12:30:00Z,False,19,8,0,0,25,14,11,10,8,2,15,3
Dendoncker,518,2,198,2018-12-29T15:00:00Z,False,19,16,67,2,26,14,12,45,18,27,-19,-6
Dendoncker,518,2,209,2019-01-02T19:45:00Z,True,19,6,0,0,29,14,15,19,9,10,10,4
Dendoncker,518,2,217,2019-01-14T20:00:00Z,False,19,12,90,2,29,14,15,50,30,20,-21,-15
Dendoncker,518,2,229,2019-01-19T12:30:00Z,True,19,10,90,2,29,14,15,31,14,17,-2,-3
Dendoncker,518,2,235,2019-01-29T19:45:00Z,True,19,18,90,3,32,17,15,31,17,14,1,3
Dendoncker,518,2,245,2019-02-02T15:00:00Z,False,19,7,90,8,35,20,15,33,21,12,2,-6
Dendoncker,518,2,259,2019-02-11T20:00:00Z,True,19,14,68,2,38,20,18,24,13,11,14,9
Dendoncker,518,2,261,2019-02-23T15:00:00Z,False,19,1,76,1,39,21,18,33,24,9,6,-6
Dendoncker,518,2,273,2019-02-26T19:45:00Z,False,19,9,90,2,40,21,19,11,5,6,29,14
Dendoncker,518,2,289,2019-03-02T15:00:00Z,True,19,4,90,3,40,21,19,25,17,8,15,13
Dendoncker,518,2,292,2019-03-10T14:05:00Z,False,19,5,90,2,43,24,19,56,31,25,-13,-12
Dendoncker,518,2,312,2019-03-30T15:00:00Z,False,19,3,58,1,44,24,20,30,17,13,14,3
Dendoncker,518,2,329,2019-04-02T18:45:00Z,True,19,13,90,2,44,24,20,61,32,29,-17,-5
Dendoncker,518,2,337,2019-04-13T14:00:00Z,False,19,15,90,2,47,27,20,33,18,15,14,2
Dendoncker,518,2,349,2019-04-20T14:00:00Z,True,19,2,17,1,47,27,20,33,22,11,14,16
Dendoncker,518,2,309,2019-04-24T18:45:00Z,True,19,0,90,2,48,28,20,66,44,22,-18,6
Dendoncker,518,2,359,2019-04-27T14:00:00Z,False,19,17,90,2,51,31,20,50,27,23,1,-7
Dendoncker,518,2,369,2019-05-04T14:00:00Z,True,19,8,90,8,54,31,23,26,21,5,28,26
Dendoncker,518,2,375,2019-05-12T14:00:00Z,False,19,11,90,2,57,34,23,94,50,44,-37,-27
Grant,519,0,5,2018-08-10T19:00:00Z,True,13,10,0,0,0,0,0,0,0,0,0,0
Grant,519,0,10,2018-08-19T15:00:00Z,False,13,2,0,0,3,3,0,0,0,0,3,0
Grant,519,0,25,2018-08-27T19:00:00Z,True,13,16,0,0,3,3,0,6,3,3,-3,0
Grant,519,0,31,2018-09-02T15:00:00Z,False,13,3,0,0,3,3,0,1,0,1,2,0
Grant,519,0,48,2018-09-15T16:30:00Z,False,13,17,0,0,6,3,3,12,9,3,-6,-6
Grant,519,0,58,2018-09-22T14:00:00Z,True,13,19,0,0,9,3,6,8,5,3,1,0
Grant,519,0,68,2018-09-29T11:30:00Z,False,13,18,0,0,10,4,6,4,1,3,6,5
Grant,519,0,76,2018-10-06T16:30:00Z,True,13,14,0,0,10,4,6,2,0,2,8,2
Grant,519,0,83,2018-10-20T11:30:00Z,False,13,5,0,0,13,7,6,20,10,10,-7,-4
Grant,519,0,96,2018-10-28T16:00:00Z,True,13,7,0,0,14,7,7,15,10,5,-1,2
Grant,519,0,101,2018-11-03T12:30:00Z,False,13,1,0,0,17,10,7,20,11,9,-3,-4
Grant,519,0,117,2018-11-11T16:30:00Z,False,13,12,0,0,20,10,10,29,18,11,-9,-8
Grant,519,0,125,2018-11-24T15:00:00Z,True,13,6,0,0,20,10,10,8,2,6,12,4
Grant,519,0,139,2018-12-01T17:30:00Z,False,13,15,0,0,21,11,10,8,4,4,13,6
Grant,519,0,144,2018-12-05T20:00:00Z,True,13,0,0,0,22,11,11,30,17,13,-8,-2
Grant,519,0,157,2018-12-08T15:00:00Z,True,13,8,0,0,23,12,11,9,8,1,14,11
Grant,519,0,164,2018-12-16T16:00:00Z,False,13,11,0,0,26,15,11,42,19,23,-16,-8
Grant,519,0,172,2018-12-22T17:30:00Z,False,13,4,0,0,26,15,11,14,13,1,12,-2
Grant,519,0,186,2018-12-26T15:00:00Z,True,13,9,0,0,29,15,14,10,5,5,19,10
Grant,519,0,196,2018-12-30T16:30:00Z,True,13,1,0,0,32,18,14,26,17,9,6,9
Grant,519,0,207,2019-01-02T20:00:00Z,False,13,14,0,0,35,21,14,18,7,11,17,7
Grant,519,0,218,2019-01-13T16:30:00Z,False,13,16,0,0,38,21,17,48,18,30,-10,-1
Grant,519,0,225,2019-01-19T15:00:00Z,True,13,2,0,0,41,21,20,26,18,8,15,13
Grant,519,0,234,2019-01-29T20:00:00Z,True,13,3,0,0,44,24,20,22,13,9,22,15
Grant,519,0,246,2019-02-03T14:05:00Z,False,13,10,0,0,45,25,20,32,14,18,13,6
Grant,519,0,252,2019-02-09T12:30:00Z,False,13,8,0,0,48,25,23,17,15,2,31,8
Grant,519,0,267,2019-02-24T14:05:00Z,True,13,11,0,0,51,25,26,65,35,30,-14,-5
Grant,519,0,272,2019-02-27T20:00:00Z,False,13,6,0,0,52,26,26,30,13,17,22,13
Grant,519,0,285,2019-03-02T15:00:00Z,True,13,15,0,0,55,26,29,27,15,12,28,14
Grant,519,0,290,2019-03-10T16:30:00Z,False,13,0,0,0,58,29,29,57,38,19,1,-9
Grant,519,0,318,2019-03-30T15:00:00Z,True,13,17,0,0,58,29,29,43,23,20,15,9
Grant,519,0,329,2019-04-02T18:45:00Z,False,13,19,0,0,61,32,29,44,24,20,17,5
Grant,519,0,336,2019-04-13T16:30:00Z,True,13,18,0,0,61,32,29,42,27,15,19,17
Grant,519,0,344,2019-04-21T12:30:00Z,False,13,7,0,0,64,35,29,46,28,18,18,1
Grant,519,0,305,2019-04-24T19:00:00Z,True,13,12,0,0,64,35,29,86,51,35,-22,0
Grant,519,0,356,2019-04-28T15:30:00Z,True,13,5,0,0,64,35,29,67,39,28,-3,7
Grant,519,0,365,2019-05-05T13:00:00Z,False,13,9,0,0,65,36,29,14,8,6,51,21
Grant,519,0,376,2019-05-12T14:00:00Z,True,13,4,0,0,66,36,30,31,20,11,35,25
Cisse,520,2,2,2018-08-11T14:00:00Z,True,8,6,0,0,0,0,0,0,0,0,0,0
Cisse,520,2,18,2018-08-18T14:00:00Z,False,8,16,0,0,0,0,0,3,0,3,-3,0
Cisse,520,2,22,2018-08-26T15:00:00Z,True,8,3,0,0,0,0,0,1,0,1,-1,-1
Cisse,520,2,30,2018-09-01T14:00:00Z,False,8,2,0,0,3,3,0,3,3,0,0,-3
Cisse,520,2,44,2018-09-15T14:00:00Z,False,8,12,0,0,4,3,1,10,6,4,-6,-5
Cisse,520,2,55,2018-09-22T11:30:00Z,True,8,17,0,0,4,3,1,12,9,3,-8,0
Cisse,520,2,64,2018-09-29T14:00:00Z,False,8,7,0,0,5,4,1,6,4,2,-1,-3
Cisse,520,2,73,2018-10-07T11:00:00Z,True,8,0,0,0,5,4,1,15,9,6,-10,-2
Cisse,520,2,82,2018-10-20T14:00:00Z,False,8,4,0,0,5,4,1,2,1,1,3,0
Cisse,520,2,93,2018-10-27T14:00:00Z,True,8,1,0,0,5,4,1,17,11,6,-12,-2
Cisse,520,2,105,2018-11-05T20:00:00Z,False,8,9,0,0,5,4,1,3,1,2,2,0
Cisse,520,2,116,2018-11-11T12:00:00Z,False,8,11,0,0,5,4,1,27,13,14,-22,-12
Cisse,520,2,124,2018-11-24T15:00:00Z,True,8,15,0,0,5,4,1,8,4,4,-3,0
Cisse,520,2,132,2018-12-02T12:00:00Z,False,8,5,0,0,8,7,1,28,15,13,-20,-14
Cisse,520,2,143,2018-12-05T19:45:00Z,True,8,10,0,0,8,7,1,21,11,10,-13,-3
Cisse,520,2,157,2018-12-08T15:00:00Z,False,8,13,17,1,9,8,1,23,12,11,-14,-11
Cisse,520,2,162,2018-12-15T17:30:00Z,True,8,18,0,0,9,8,1,21,13,8,-12,0
Cisse,520,2,177,2018-12-22T15:00:00Z,False,8,14,0,0,9,8,1,16,6,10,-7,-5
Cisse,520,2,183,2018-12-26T12:30:00Z,True,8,19,0,0,10,8,2,25,14,11,-15,-3
Cisse,520,2,193,2018-12-29T15:00:00Z,True,8,9,0,0,11,9,2,10,5,5,1,4
Cisse,520,2,200,2019-01-01T15:00:00Z,False,8,0,60,2,14,12,2,38,23,15,-24,-21
Cisse,520,2,211,2019-01-12T15:00:00Z,False,8,3,0,0,14,12,2,18,10,8,-4,-8
Cisse,520,2,222,2019-01-20T16:00:00Z,True,8,16,9,1,14,12,2,48,18,30,-34,-18
Cisse,520,2,232,2019-01-29T19:45:00Z,True,8,2,0,0,14,12,2,26,18,8,-12,4
Cisse,520,2,244,2019-02-02T15:00:00Z,False,8,6,0,0,17,15,2,23,9,14,-6,-7
Cisse,520,2,252,2019-02-09T12:30:00Z,True,8,13,0,0,17,15,2,48,25,23,-31,-8
Cisse,520,2,269,2019-02-22T19:45:00Z,False,8,18,0,0,17,15,2,33,18,15,-16,-16
Cisse,520,2,279,2019-02-27T19:45:00Z,False,8,15,0,0,17,15,2,24,12,12,-7,-10
Cisse,520,2,284,2019-03-03T14:05:00Z,True,8,5,0,0,17,15,2,53,31,22,-36,-7
Cisse,520,2,295,2019-03-09T15:00:00Z,False,8,10,0,0,17,15,2,35,17,18,-18,-15
Cisse,520,2,304,2019-03-17T14:15:00Z,True,8,11,0,0,17,15,2,73,41,32,-56,-17
Cisse,520,2,315,2019-03-30T12:30:00Z,True,8,12,0,0,17,15,2,74,45,29,-57,-14
Cisse,520,2,328,2019-04-02T18:45:00Z,False,8,17,0,0,17,15,2,43,23,20,-26,-21
Cisse,520,2,333,2019-04-13T14:00:00Z,True,8,7,0,0,17,15,2,46,28,18,-29,-3
Cisse,520,2,341,2019-04-20T14:00:00Z,False,8,1,0,0,20,18,2,41,26,15,-21,-24
Cisse,520,2,353,2019-04-27T14:00:00Z,True,8,4,0,0,23,18,5,31,20,11,-8,7
Cisse,520,2,369,2019-05-04T14:00:00Z,False,8,19,0,0,26,21,5,54,31,23,-28,-26
Cisse,520,2,373,2019-05-12T14:00:00Z,True,8,14,0,0,26,21,5,42,25,17,-16,4
Stankovic,521,1,3,2018-08-11T14:00:00Z,True,9,5,0,0,0,0,0,0,0,0,0,0
Stankovic,521,1,17,2018-08-19T12:30:00Z,False,9,12,90,5,0,0,0,3,0,3,-3,0
Stankovic,521,1,23,2018-08-25T14:00:00Z,True,9,4,0,0,0,0,0,1,1,0,-1,0
Stankovic,521,1,35,2018-09-01T14:00:00Z,False,9,7,0,0,1,1,0,5,3,2,-4,-3
Stankovic,521,1,43,2018-09-15T14:00:00Z,True,9,6,0,0,2,1,1,3,0,3,-1,-2
Stankovic,521,1,56,2018-09-22T14:00:00Z,False,9,10,0,0,2,1,1,6,3,3,-4,-2
Stankovic,521,1,65,2018-09-29T14:00:00Z,True,9,16,0,0,2,1,1,12,3,9,-10,-8
Stankovic,521,1,71,2018-10-06T14:00:00Z,False,9,3,0,0,2,1,1,7,3,4,-5,-2
Stankovic,521,1,85,2018-10-20T16:30:00Z,True,9,11,0,0,3,1,2,20,10,10,-17,-9
Stankovic,521,1,99,2018-10-27T14:00:00Z,False,9,17,0,0,3,1,2,16,9,7,-13,-7
Stankovic,521,1,105,2018-11-05T20:00:00Z,True,9,8,0,0,3,1,2,5,4,1,-2,0
Stankovic,521,1,114,2018-11-10T15:00:00Z,True,9,18,0,0,6,4,2,11,7,4,-5,0
Stankovic,521,1,129,2018-11-25T16:00:00Z,False,9,19,1,1,7,5,2,16,8,8,-9,-6
Stankovic,521,1,134,2018-12-01T15:00:00Z,True,9,2,0,0,10,5,5,15,11,4,-5,1
Stankovic,521,1,140,2018-12-04T19:45:00Z,False,9,1,0,0,10,5,5,20,11,9,-10,-6
Stankovic,521,1,150,2018-12-08T15:00:00Z,False,9,0,0,0,10,5,5,31,17,14,-21,-12
Stankovic,521,1,163,2018-12-15T15:00:00Z,True,9,14,0,0,10,5,5,13,6,7,-3,-2
Stankovic,521,1,175,2018-12-22T15:00:00Z,True,9,15,0,0,10,5,5,12,8,4,-2,1
Stankovic,521,1,186,2018-12-26T15:00:00Z,False,9,13,0,0,10,5,5,29,15,14,-19,-10
Stankovic,521,1,193,2018-12-29T15:00:00Z,False,9,8,0,0,10,5,5,11,9,2,-1,-4
Stankovic,521,1,205,2019-01-02T19:45:00Z,True,9,3,0,0,10,5,5,15,10,5,-5,0
Stankovic,521,1,212,2019-01-12T15:00:00Z,False,9,4,0,0,10,5,5,18,13,5,-8,-8
Stankovic,521,1,223,2019-01-20T13:30:00Z,True,9,12,0,0,11,5,6,53,33,20,-42,-15
Stankovic,521,1,233,2019-01-29T19:45:00Z,True,9,7,0,0,11,5,6,30,21,9,-19,-4
Stankovic,521,1,243,2019-02-02T15:00:00Z,False,9,5,0,0,11,5,6,47,25,22,-36,-19
Stankovic,521,1,253,2019-02-09T15:00:00Z,True,9,0,0,0,11,5,6,47,32,15,-36,-10
Stankovic,521,1,268,2019-02-23T15:00:00Z,False,9,14,0,0,11,5,6,25,13,12,-14,-7
Stankovic,521,1,273,2019-02-26T19:45:00Z,True,9,19,81,7,11,5,6,40,21,19,-29,-14
Stankovic,521,1,281,2019-03-02T15:00:00Z,False,9,2,66,7,14,8,6,27,19,8,-13,-13
Stankovic,521,1,294,2019-03-09T15:00:00Z,True,9,1,90,0,14,8,6,34,25,9,-20,-1
Stankovic,521,1,308,2019-03-16T15:00:00Z,False,9,18,90,0,14,8,6,39,24,15,-25,-18
Stankovic,521,1,314,2019-03-30T15:00:00Z,False,9,6,1,1,14,8,6,33,13,20,-19,-7
Stankovic,521,1,323,2019-04-06T14:00:00Z,True,9,10,45,0,14,8,6,44,23,21,-30,-13
Stankovic,521,1,338,2019-04-13T11:30:00Z,False,9,16,81,1,14,8,6,64,31,33,-50,-25
Stankovic,521,1,345,2019-04-20T14:00:00Z,True,9,17,0,0,14,8,6,46,26,20,-32,-12
Stankovic,521,1,355,2019-04-26T19:00:00Z,False,9,11,80,0,14,8,6,88,47,41,-74,-41
Stankovic,521,1,365,2019-05-05T13:00:00Z,True,9,13,0,0,14,8,6,65,36,29,-51,-21
Stankovic,521,1,377,2019-05-12T14:00:00Z,False,9,15,90,2,15,9,6,38,22,16,-23,-16
Amos,522,2,6,2018-08-11T11:30:00Z,False,16,14,2,1,0,0,0,0,0,0,0,0
Amos,522,2,18,2018-08-18T14:00:00Z,True,16,8,0,0,3,0,3,0,0,0,3,0
Amos,522,2,25,2018-08-27T19:00:00Z,False,16,13,0,0,6,3,3,3,3,0,3,0
Amos,522,2,38,2018-09-02T15:00:00Z,False,16,17,0,0,9,3,6,9,6,3,0,0
Amos,522,2,47,2018-09-15T11:30:00Z,True,16,11,0,0,9,3,6,12,6,6,-3,-3
Amos,522,2,51,2018-09-22T16:30:00Z,False,16,2,0,0,9,3,6,5,4,1,4,2
Amos,522,2,65,2018-09-29T14:00:00Z,False,16,9,0,0,12,3,9,2,1,1,10,8
Amos,522,2,78,2018-10-06T14:00:00Z,True,16,4,0,0,15,3,12,2,1,1,13,2
Amos,522,2,88,2018-10-20T14:00:00Z,False,16,18,0,0,18,6,12,7,4,3,11,8
Amos,522,2,98,2018-10-29T20:00:00Z,True,16,12,0,0,21,6,15,23,15,8,-2,-2
Amos,522,2,109,2018-11-03T19:45:00Z,False,16,19,0,0,21,6,15,15,8,7,6,7
Amos,522,2,113,2018-11-10T17:30:00Z,False,16,6,0,0,24,6,18,8,2,6,16,16
Amos,522,2,126,2018-11-24T17:30:00Z,True,16,5,0,0,27,6,21,28,15,13,-1,-7
Amos,522,2,130,2018-12-02T14:05:00Z,False,16,0,0,0,30,9,21,27,14,13,3,7
Amos,522,2,149,2018-12-05T20:00:00Z,True,16,15,0,0,30,9,21,9,5,4,21,5
Amos,522,2,156,2018-12-08T19:45:00Z,False,16,10,0,0,33,12,21,22,11,11,11,10
Amos,522,2,167,2018-12-15T15:00:00Z,True,16,3,0,0,36,12,24,12,7,5,24,7
Amos,522,2,174,2018-12-23T16:00:00Z,False,16,7,0,0,39,15,24,24,18,6,15,6
Amos,522,2,188,2018-12-26T15:00:00Z,True,16,1,0,0,42,15,27,26,17,9,16,6
Amos,522,2,198,2018-12-29T15:00:00Z,True,16,19,0,0,45,18,27,26,14,12,19,6
Amos,522,2,202,2019-01-01T17:30:00Z,False,16,4,0,0,45,18,27,18,13,5,27,14
Amos,522,2,218,2019-01-13T16:30:00Z,True,16,13,0,0,48,18,30,38,21,17,10,1
Amos,522,2,222,2019-01-20T16:00:00Z,False,16,8,0,0,48,18,30,14,12,2,34,18
Amos,522,2,239,2019-01-30T20:00:00Z,True,16,17,0,0,51,18,33,33,17,16,18,2
Amos,522,2,248,2019-02-02T12:30:00Z,True,16,14,0,0,54,21,33,24,13,11,30,10
Amos,522,2,257,2019-02-10T13:30:00Z,True,16,10,0,0,57,24,33,32,14,18,25,6
Amos,522,2,262,2019-02-23T12:30:00Z,False,16,3,0,0,60,27,33,27,14,13,33,19
Amos,522,2,275,2019-02-27T20:00:00Z,False,16,5,0,0,60,27,33,50,28,22,10,5
Amos,522,2,286,2019-03-02T12:30:00Z,True,16,0,0,0,60,27,33,56,38,18,4,9
Amos,522,2,299,2019-03-09T15:00:00Z,False,16,15,0,0,61,28,33,27,15,12,34,18
Amos,522,2,317,2019-03-31T15:30:00Z,False,16,11,0,0,61,28,33,76,41,35,-15,-8
Amos,522,2,306,2019-04-03T18:45:00Z,True,16,6,0,0,61,28,33,36,16,20,25,8
Amos,522,2,338,2019-04-13T11:30:00Z,True,16,9,0,0,64,31,33,14,8,6,50,25
Amos,522,2,346,2019-04-20T11:30:00Z,False,16,12,0,0,67,34,33,83,48,35,-16,-15
Amos,522,2,327,2019-04-23T18:45:00Z,True,16,2,0,0,67,34,33,34,22,12,33,22
Amos,522,2,358,2019-04-27T11:30:00Z,True,16,18,0,0,70,37,33,43,28,15,27,22
Amos,522,2,361,2019-05-04T11:30:00Z,False,16,1,0,0,70,37,33,42,26,16,28,7
Amos,522,2,378,2019-05-12T14:00:00Z,True,16,7,0,0,70,37,33,53,34,19,17,18
Success,523,3,8,2018-08-11T14:00:00Z,True,17,2,16,1,0,0,0,0,0,0,0,0
Success,523,3,11,2018-08-19T12:30:00Z,False,17,3,1,1,3,3,0,1,0,1,2,0
Success,523,3,28,2018-08-26T12:30:00Z,True,17,6,1,1,6,3,3,3,0,3,3,0
Success,523,3,38,2018-09-02T15:00:00Z,True,17,16,20,0,9,6,3,9,3,6,0,0
Success,523,3,48,2018-09-15T16:30:00Z,True,17,13,2,1,12,9,3,6,3,3,6,6
Success,523,3,55,2018-09-22T11:30:00Z,False,17,8,10,1,12,9,3,4,3,1,8,0
Success,523,3,60,2018-09-29T14:00:00Z,False,17,0,18,1,13,9,4,12,6,6,1,-2
Success,523,3,79,2018-10-06T14:00:00Z,True,17,1,35,1,13,9,4,13,10,3,0,6
Success,523,3,89,2018-10-20T14:00:00Z,False,17,19,74,2,13,9,4,15,8,7,-2,-4
Success,523,3,99,2018-10-27T14:00:00Z,True,17,9,82,6,16,9,7,3,1,2,13,7
Success,523,3,107,2018-11-03T15:00:00Z,False,17,14,84,2,19,12,7,3,0,3,16,7
Success,523,3,119,2018-11-10T15:00:00Z,False,17,15,90,2,19,12,7,7,3,4,12,4
Success,523,3,127,2018-11-24T15:00:00Z,True,17,11,33,1,20,12,8,30,16,14,-10,-2
Success,523,3,135,2018-12-01T15:00:00Z,False,17,10,90,1,20,12,8,18,8,10,2,0
Success,523,3,145,2018-12-04T20:00:00Z,True,17,12,74,2,20,12,8,38,24,14,-18,-2
Success,523,3,155,2018-12-10T20:00:00Z,False,17,7,73,2,20,12,8,23,17,6,-3,-9
Success,523,3,168,2018-12-15T15:00:00Z,True,17,4,13,1,21,12,9,14,13,1,7,11
Success,523,3,178,2018-12-22T15:00:00Z,False,17,18,4,1,24,15,9,24,13,11,0,-4
Success,523,3,189,2018-12-26T19:30:00Z,True,17,5,8,1,27,15,12,37,21,16,-10,-1
Success,523,3,199,2018-12-29T15:00:00Z,True,17,14,90,2,27,15,12,17,7,10,10,5
Success,523,3,201,2019-01-02T19:45:00Z,False,17,1,1,1,28,16,12,26,17,9,2,-5
Success,523,3,214,2019-01-12T15:00:00Z,False,17,6,0,0,29,16,13,22,9,13,7,4
Success,523,3,228,2019-01-19T15:00:00Z,True,17,3,34,1,32,16,16,21,13,8,11,8
Success,523,3,239,2019-01-30T20:00:00Z,False,17,16,29,0,33,17,16,51,18,33,-18,-2
Success,523,3,240,2019-02-02T15:00:00Z,False,17,2,0,0,33,17,16,26,18,8,7,-2
Success,523,3,258,2019-02-09T15:00:00Z,True,17,7,0,0,34,17,17,33,21,12,1,5
Success,523,3,263,2019-02-22T19:45:00Z,False,17,4,0,0,37,20,17,25,17,8,12,0
Success,523,3,276,2019-02-27T20:00:00Z,False,17,11,0,0,40,20,20,66,35,31,-26,-15
Success,523,3,287,2019-03-03T12:00:00Z,True,17,10,0,0,40,20,20,35,17,18,5,2
Success,523,3,297,2019-03-09T17:30:00Z,False,17,12,65,2,43,23,20,71,42,29,-28,-22
Success,523,3,318,2019-03-30T15:00:00Z,False,17,13,9,4,43,23,20,58,29,29,-15,-9
Success,523,3,328,2019-04-02T18:45:00Z,True,17,8,0,0,43,23,20,17,15,2,26,21
Success,523,3,339,2019-04-15T19:00:00Z,True,17,0,31,1,46,26,20,63,44,19,-17,7
Success,523,3,345,2019-04-20T14:00:00Z,False,17,9,18,1,46,26,20,14,8,6,32,12
Success,523,3,307,2019-04-23T18:45:00Z,True,17,15,13,1,49,26,23,36,21,15,13,11
Success,523,3,359,2019-04-27T14:00:00Z,True,17,19,8,0,50,27,23,51,31,20,-1,7
Success,523,3,363,2019-05-05T13:00:00Z,False,17,5,7,1,50,27,23,68,39,29,-18,-16
Success,523,3,379,2019-05-12T14:00:00Z,True,17,18,0,0,50,27,23,49,31,18,1,9
Hause,524,1,9,2018-08-11T16:30:00Z,True,19,7,0,0,0,0,0,0,0,0,0,0
Hause,524,1,16,2018-08-18T14:00:00Z,False,19,10,0,0,1,1,0,0,0,0,1,0
Hause,524,1,29,2018-08-25T11:30:00Z,True,19,12,0,0,1,1,0,6,3,3,-5,-2
Hause,524,1,39,2018-09-01T14:00:00Z,False,19,18,0,0,2,2,0,0,0,0,2,0
Hause,524,1,49,2018-09-16T12:30:00Z,True,19,3,0,0,5,2,3,1,0,1,4,1
Hause,524,1,58,2018-09-22T14:00:00Z,False,19,13,0,0,8,5,3,9,3,6,-1,0
Hause,524,1,69,2018-09-29T14:00:00Z,True,19,15,0,0,9,5,4,5,2,3,4,2
Hause,524,1,72,2018-10-06T14:00:00Z,False,19,6,0,0,12,8,4,7,1,6,5,3
Hause,524,1,89,2018-10-20T14:00:00Z,True,19,17,0,0,15,8,7,13,9,4,2,4
Hause,524,1,90,2018-10-27T14:00:00Z,False,19,2,0,0,15,8,7,11,7,4,4,0
Hause,524,1,109,2018-11-03T19:45:00Z,True,19,16,0,0,15,8,7,21,6,15,-6,-7
Hause,524,1,110,2018-11-11T16:30:00Z,False,19,0,0,0,15,8,7,23,13,10,-8,-6
Hause,524,1,129,2018-11-25T16:00:00Z,True,19,9,0,0,16,8,8,7,5,2,9,6
Hause,524,1,131,2018-11-30T20:00:00Z,False,19,4,0,0,16,8,8,8,7,1,8,1
Hause,524,1,147,2018-12-05T19:45:00Z,True,19,5,0,0,16,8,8,31,18,13,-15,-5
Hause,524,1,158,2018-12-09T16:00:00Z,False,19,14,0,0,19,11,8,13,6,7,6,2
Hause,524,1,169,2018-12-15T15:00:00Z,True,19,1,0,0,22,11,11,23,14,9,-1,2
Hause,524,1,179,2018-12-21T20:00:00Z,True,19,11,0,0,25,14,11,45,22,23,-20,-9
Hause,524,1,183,2018-12-26T12:30:00Z,False,19,8,0,0,25,14,11,10,8,2,15,3
Hause,524,1,198,2018-12-29T15:00:00Z,False,19,16,0,0,26,14,12,45,18,27,-19,-6
Hause,524,1,209,2019-01-02T19:45:00Z,True,19,6,0,0,29,14,15,19,9,10,10,4
Hause,524,1,217,2019-01-14T20:00:00Z,False,19,12,0,0,29,14,15,50,30,20,-21,-15
Hause,524,1,229,2019-01-19T12:30:00Z,True,19,10,0,0,29,14,15,31,14,17,-2,-3
Hause,524,1,235,2019-01-29T19:45:00Z,True,19,18,0,0,32,17,15,31,17,14,1,3
Hause,524,1,245,2019-02-02T15:00:00Z,False,19,7,0,0,35,20,15,33,21,12,2,-6
Hause,524,1,259,2019-02-11T20:00:00Z,True,19,14,0,0,38,20,18,24,13,11,14,9
Hause,524,1,261,2019-02-23T15:00:00Z,False,19,1,0,0,39,21,18,33,24,9,6,-6
Hause,524,1,273,2019-02-26T19:45:00Z,False,19,9,0,0,40,21,19,11,5,6,29,14
Hause,524,1,289,2019-03-02T15:00:00Z,True,19,4,0,0,40,21,19,25,17,8,15,13
Hause,524,1,292,2019-03-10T14:05:00Z,False,19,5,0,0,43,24,19,56,31,25,-13,-12
Hause,524,1,312,2019-03-30T15:00:00Z,False,19,3,0,0,44,24,20,30,17,13,14,3
Hause,524,1,329,2019-04-02T18:45:00Z,True,19,13,0,0,44,24,20,61,32,29,-17,-5
Hause,524,1,337,2019-04-13T14:00:00Z,False,19,15,0,0,47,27,20,33,18,15,14,2
Hause,524,1,349,2019-04-20T14:00:00Z,True,19,2,0,0,47,27,20,33,22,11,14,16
Hause,524,1,309,2019-04-24T18:45:00Z,True,19,0,0,0,48,28,20,66,44,22,-18,6
Hause,524,1,359,2019-04-27T14:00:00Z,False,19,17,0,0,51,31,20,50,27,23,1,-7
Hause,524,1,369,2019-05-04T14:00:00Z,True,19,8,0,0,54,31,23,26,21,5,28,26
Hause,524,1,375,2019-05-12T14:00:00Z,False,19,11,0,0,57,34,23,94,50,44,-37,-27
Zouma,525,1,15,2018-08-18T14:00:00Z,True,7,15,0,0,1,0,1,1,1,0,0,0
Zouma,525,1,21,2018-08-25T14:00:00Z,False,7,1,1,1,4,3,1,6,3,3,-2,-2
Zouma,525,1,35,2018-09-01T14:00:00Z,True,7,9,90,2,5,3,2,1,1,0,4,3
Zouma,525,1,42,2018-09-16T15:00:00Z,True,7,18,90,1,6,4,2,0,0,0,6,4
Zouma,525,1,50,2018-09-23T15:00:00Z,False,7,0,90,1,6,4,2,9,3,6,-3,-1
Zouma,525,1,64,2018-09-29T14:00:00Z,True,7,8,90,8,6,4,2,5,4,1,1,3
Zouma,525,1,74,2018-10-06T14:00:00Z,False,7,10,90,6,9,7,2,12,6,6,-3,-4
Zouma,525,1,84,2018-10-21T15:00:00Z,True,7,6,90,6,12,7,5,7,1,6,5,1
Zouma,525,1,96,2018-10-28T16:00:00Z,False,7,13,90,1,15,10,5,14,7,7,1,-2
Zouma,525,1,104,2018-11-03T15:00:00Z,True,7,2,90,2,15,10,5,14,10,4,1,6
Zouma,525,1,112,2018-11-11T14:15:00Z,False,7,5,0,0,18,13,5,27,14,13,-9,-9
Zouma,525,1,123,2018-11-24T15:00:00Z,True,7,4,1,1,19,13,6,8,7,1,11,12
Zouma,525,1,136,2018-12-02T16:15:00Z,False,7,11,1,1,22,16,6,33,16,17,-11,-10
Zouma,525,1,148,2018-12-05T19:45:00Z,True,7,14,90,3,22,16,6,12,6,6,10,10
Zouma,525,1,155,2018-12-10T20:00:00Z,True,7,17,0,0,23,17,6,20,12,8,3,9
Zouma,525,1,165,2018-12-15T12:30:00Z,False,7,12,90,1,24,18,6,41,24,17,-17,-18
Zouma,525,1,174,2018-12-23T16:00:00Z,True,7,16,90,-1,24,18,6,39,15,24,-15,-6
Zouma,525,1,181,2018-12-26T15:00:00Z,False,7,3,90,2,24,18,6,12,7,5,12,-1
Zouma,525,1,190,2018-12-29T15:00:00Z,False,7,2,90,2,27,18,9,22,15,7,5,-6
Zouma,525,1,204,2019-01-01T12:30:00Z,True,7,10,90,2,27,18,9,28,14,14,-1,4
Zouma,525,1,215,2019-01-13T14:15:00Z,True,7,1,90,13,27,18,9,27,18,9,0,9
Zouma,525,1,227,2019-01-19T15:00:00Z,False,7,15,90,5,30,21,9,19,8,11,11,1
Zouma,525,1,233,2019-01-29T19:45:00Z,False,7,9,90,6,30,21,9,11,5,6,19,4
Zouma,525,1,245,2019-02-02T15:00:00Z,True,7,19,90,0,33,21,12,35,20,15,-2,6
Zouma,525,1,265,2019-02-06T19:45:00Z,True,7,12,90,0,33,21,12,59,36,23,-26,-2
Zouma,525,1,258,2019-02-09T15:00:00Z,False,7,17,90,-1,33,21,12,34,17,17,-1,-5
Zouma,525,1,271,2019-02-26T19:45:00Z,False,7,4,0,0,33,21,12,25,17,8,8,-5
Zouma,525,1,283,2019-03-03T16:15:00Z,True,7,11,90,6,36,21,15,69,38,31,-33,-10
Zouma,525,1,298,2019-03-09T15:00:00Z,False,7,14,90,1,37,22,15,31,19,12,6,-4
Zouma,525,1,303,2019-03-17T16:30:00Z,True,7,5,0,0,37,22,15,57,32,25,-20,-3
Zouma,525,1,319,2019-03-30T17:30:00Z,False,7,18,90,15,40,25,15,42,27,15,-2,-12
Zouma,525,1,322,2019-04-07T13:05:00Z,True,7,0,90,6,43,25,18,63,44,19,-20,6
Zouma,525,1,333,2019-04-13T14:00:00Z,False,7,8,90,1,46,28,18,17,15,2,29,3
Zouma,525,1,344,2019-04-21T12:30:00Z,True,7,13,90,6,46,28,18,64,35,29,-18,-1
Zouma,525,1,352,2019-04-27T14:00:00Z,False,7,6,90,7,49,31,18,42,16,26,7,2
Zouma,525,1,364,2019-05-03T19:00:00Z,True,7,3,90,7,50,31,19,40,23,17,10,14
Zouma,525,1,378,2019-05-12T14:00:00Z,False,7,16,90,1,53,34,19,70,37,33,-17,-18
Mendy,526,2,16,2018-08-18T14:00:00Z,True,10,19,90,3,0,0,0,1,1,0,-1,0
Mendy,526,2,27,2018-08-25T14:00:00Z,False,10,15,90,2,3,3,0,1,1,0,2,-1
Mendy,526,2,36,2018-09-01T11:30:00Z,True,10,11,90,1,6,3,3,9,6,3,-3,0
Mendy,526,2,40,2018-09-15T14:00:00Z,False,10,1,90,2,6,3,3,7,4,3,-1,-1
Mendy,526,2,56,2018-09-22T14:00:00Z,True,10,9,90,5,6,3,3,2,1,1,4,2
Mendy,526,2,67,2018-09-29T14:00:00Z,False,10,14,90,3,9,6,3,2,0,2,7,3
Mendy,526,2,74,2018-10-06T14:00:00Z,True,10,7,90,2,12,6,6,9,7,2,3,4
Mendy,526,2,80,2018-10-22T19:00:00Z,False,10,0,90,2,12,6,6,18,9,9,-6,-3
Mendy,526,2,94,2018-10-27T16:30:00Z,True,10,18,0,0,12,6,6,7,4,3,5,3
Mendy,526,2,102,2018-11-03T15:00:00Z,False,10,4,90,3,13,7,6,5,4,1,8,2
Mendy,526,2,115,2018-11-10T15:00:00Z,True,10,3,90,3,16,7,9,8,4,4,8,3
Mendy,526,2,121,2018-11-24T15:00:00Z,False,10,2,90,2,17,8,9,14,10,4,3,-1
Mendy,526,2,135,2018-12-01T15:00:00Z,True,10,17,90,3,18,8,10,20,12,8,-2,0
Mendy,526,2,143,2018-12-05T19:45:00Z,False,10,8,70,2,21,11,10,8,7,1,13,3
Mendy,526,2,156,2018-12-08T19:45:00Z,True,10,16,78,1,22,11,11,33,12,21,-11,-10
Mendy,526,2,161,2018-12-15T15:00:00Z,False,10,6,90,2,22,11,11,12,5,7,10,6
Mendy,526,2,173,2018-12-22T15:00:00Z,False,10,5,90,2,22,11,11,37,21,16,-15,-10
Mendy,526,2,184,2018-12-26T15:00:00Z,True,10,12,90,2,25,11,14,44,27,17,-19,-6
Mendy,526,2,194,2018-12-29T15:00:00Z,True,10,4,90,2,28,14,14,15,13,2,13,12
Mendy,526,2,204,2019-01-01T12:30:00Z,False,10,7,90,3,28,14,14,27,18,9,1,-4
Mendy,526,2,216,2019-01-12T15:00:00Z,True,10,15,45,1,31,14,17,16,8,8,15,6
Mendy,526,2,229,2019-01-19T12:30:00Z,False,10,19,90,1,31,14,17,29,14,15,2,3
Mendy,526,2,236,2019-01-30T20:00:00Z,False,10,11,90,2,31,14,17,60,31,29,-29,-14
Mendy,526,2,246,2019-02-03T14:05:00Z,True,10,13,83,1,32,14,18,45,25,20,-13,-6
Mendy,526,2,257,2019-02-10T13:30:00Z,False,10,16,0,0,32,14,18,57,24,33,-25,-6
Mendy,526,2,266,2019-02-23T17:30:00Z,True,10,6,0,0,32,14,18,27,13,14,5,0
Mendy,526,2,274,2019-02-26T19:45:00Z,True,10,2,21,1,32,14,18,27,19,8,5,6
Mendy,526,2,287,2019-03-03T12:00:00Z,False,10,17,8,1,35,17,18,40,20,20,-5,-2
Mendy,526,2,295,2019-03-09T15:00:00Z,True,10,8,9,1,35,17,18,17,15,2,18,15
Mendy,526,2,302,2019-03-16T15:00:00Z,False,10,3,13,1,38,20,18,30,17,13,8,1
Mendy,526,2,316,2019-03-30T15:00:00Z,True,10,1,18,1,41,20,21,38,26,12,3,8
Mendy,526,2,323,2019-04-06T14:00:00Z,False,10,9,0,0,44,23,21,14,8,6,30,13
Mendy,526,2,334,2019-04-12T19:00:00Z,True,10,14,18,1,47,23,24,35,22,13,12,10
Mendy,526,2,348,2019-04-20T14:00:00Z,False,10,18,1,1,47,23,24,42,27,15,5,-3
Mendy,526,2,354,2019-04-28T11:00:00Z,True,10,0,11,1,48,23,25,66,44,22,-18,1
Mendy,526,2,366,2019-05-06T19:00:00Z,False,10,12,0,0,51,26,25,92,51,41,-41,-26
Mendy,526,2,374,2019-05-12T14:00:00Z,True,10,5,0,0,51,26,25,71,42,29,-20,-3
Dowell,527,2,21,2018-08-25T14:00:00Z,False,7,1,0,0,4,3,1,6,3,3,-2,-2
Dowell,527,2,35,2018-09-01T14:00:00Z,True,7,9,0,0,5,3,2,1,1,0,4,3
Dowell,527,2,42,2018-09-16T15:00:00Z,True,7,18,0,0,6,4,2,0,0,0,6,4
Dowell,527,2,50,2018-09-23T15:00:00Z,False,7,0,0,0,6,4,2,9,3,6,-3,-1
Dowell,527,2,64,2018-09-29T14:00:00Z,True,7,8,0,0,6,4,2,5,4,1,1,3
Dowell,527,2,74,2018-10-06T14:00:00Z,False,7,10,0,0,9,7,2,12,6,6,-3,-4
Dowell,527,2,84,2018-10-21T15:00:00Z,True,7,6,0,0,12,7,5,7,1,6,5,1
Dowell,527,2,96,2018-10-28T16:00:00Z,False,7,13,0,0,15,10,5,14,7,7,1,-2
Dowell,527,2,104,2018-11-03T15:00:00Z,True,7,2,0,0,15,10,5,14,10,4,1,6
Dowell,527,2,112,2018-11-11T14:15:00Z,False,7,5,0,0,18,13,5,27,14,13,-9,-9
Dowell,527,2,123,2018-11-24T15:00:00Z,True,7,4,0,0,19,13,6,8,7,1,11,12
Dowell,527,2,136,2018-12-02T16:15:00Z,False,7,11,0,0,22,16,6,33,16,17,-11,-10
Dowell,527,2,148,2018-12-05T19:45:00Z,True,7,14,0,0,22,16,6,12,6,6,10,10
Dowell,527,2,155,2018-12-10T20:00:00Z,True,7,17,0,0,23,17,6,20,12,8,3,9
Dowell,527,2,165,2018-12-15T12:30:00Z,False,7,12,0,0,24,18,6,41,24,17,-17,-18
Dowell,527,2,174,2018-12-23T16:00:00Z,True,7,16,0,0,24,18,6,39,15,24,-15,-6
Dowell,527,2,181,2018-12-26T15:00:00Z,False,7,3,0,0,24,18,6,12,7,5,12,-1
Dowell,527,2,190,2018-12-29T15:00:00Z,False,7,2,0,0,27,18,9,22,15,7,5,-6
Dowell,527,2,204,2019-01-01T12:30:00Z,True,7,10,0,0,27,18,9,28,14,14,-1,4
Dowell,527,2,215,2019-01-13T14:15:00Z,True,7,1,0,0,27,18,9,27,18,9,0,9
Dowell,527,2,227,2019-01-19T15:00:00Z,False,7,15,0,0,30,21,9,19,8,11,11,1
Dowell,527,2,233,2019-01-29T19:45:00Z,False,7,9,0,0,30,21,9,11,5,6,19,4
Dowell,527,2,245,2019-02-02T15:00:00Z,True,7,19,0,0,33,21,12,35,20,15,-2,6
Dowell,527,2,265,2019-02-06T19:45:00Z,True,7,12,0,0,33,21,12,59,36,23,-26,-2
Dowell,527,2,258,2019-02-09T15:00:00Z,False,7,17,0,0,33,21,12,34,17,17,-1,-5
Dowell,527,2,271,2019-02-26T19:45:00Z,False,7,4,0,0,33,21,12,25,17,8,8,-5
Dowell,527,2,283,2019-03-03T16:15:00Z,True,7,11,0,0,36,21,15,69,38,31,-33,-10
Dowell,527,2,298,2019-03-09T15:00:00Z,False,7,14,0,0,37,22,15,31,19,12,6,-4
Dowell,527,2,303,2019-03-17T16:30:00Z,True,7,5,0,0,37,22,15,57,32,25,-20,-3
Dowell,527,2,319,2019-03-30T17:30:00Z,False,7,18,0,0,40,25,15,42,27,15,-2,-12
Dowell,527,2,322,2019-04-07T13:05:00Z,True,7,0,0,0,43,25,18,63,44,19,-20,6
Dowell,527,2,333,2019-04-13T14:00:00Z,False,7,8,0,0,46,28,18,17,15,2,29,3
Dowell,527,2,344,2019-04-21T12:30:00Z,True,7,13,0,0,46,28,18,64,35,29,-18,-1
Dowell,527,2,352,2019-04-27T14:00:00Z,False,7,6,0,0,49,31,18,42,16,26,7,2
Dowell,527,2,364,2019-05-03T19:00:00Z,True,7,3,0,0,50,31,19,40,23,17,10,14
Dowell,527,2,378,2019-05-12T14:00:00Z,False,7,16,0,0,53,34,19,70,37,33,-17,-18
Muric,528,0,29,2018-08-25T11:30:00Z,False,12,19,0,0,6,3,3,1,1,0,5,2
Muric,528,0,37,2018-09-01T16:30:00Z,True,12,14,0,0,7,3,4,1,0,1,6,2
Muric,528,0,44,2018-09-15T14:00:00Z,True,12,8,0,0,10,6,4,4,3,1,6,5
Muric,528,0,53,2018-09-22T14:00:00Z,False,12,4,0,0,13,9,4,2,1,1,11,3
Muric,528,0,66,2018-09-29T14:00:00Z,True,12,2,0,0,16,9,7,5,4,1,11,8
Muric,528,0,75,2018-10-07T15:30:00Z,False,12,11,0,0,19,12,7,19,9,10,0,-2
Muric,528,0,86,2018-10-20T14:00:00Z,True,12,3,0,0,20,12,8,8,4,4,12,8
Muric,528,0,98,2018-10-29T20:00:00Z,False,12,16,0,0,23,15,8,21,6,15,2,2
Muric,528,0,106,2018-11-04T15:00:00Z,True,12,15,0,0,26,15,11,7,3,4,19,11
Muric,528,0,117,2018-11-11T16:30:00Z,True,12,13,0,0,29,18,11,20,10,10,9,8
Muric,528,0,128,2018-11-24T15:00:00Z,False,12,18,0,0,32,21,11,12,7,5,20,4
Muric,528,0,137,2018-12-01T15:00:00Z,True,12,1,0,0,35,21,14,20,11,9,15,12
Muric,528,0,145,2018-12-04T20:00:00Z,False,12,17,0,0,38,24,14,20,12,8,18,2
Muric,528,0,154,2018-12-08T17:30:00Z,False,12,5,0,0,41,24,17,31,18,13,10,-1
Muric,528,0,165,2018-12-15T12:30:00Z,True,12,7,0,0,41,24,17,24,18,6,17,18
Muric,528,0,176,2018-12-22T15:00:00Z,True,12,6,0,0,44,27,17,15,8,7,29,20
Muric,528,0,184,2018-12-26T15:00:00Z,False,12,10,0,0,44,27,17,25,11,14,19,6
Muric,528,0,197,2018-12-30T14:15:00Z,False,12,15,0,0,44,27,17,15,8,7,29,9
Muric,528,0,206,2019-01-03T20:00:00Z,True,12,11,0,0,47,27,20,54,28,26,-7,1
Muric,528,0,217,2019-01-14T20:00:00Z,True,12,19,0,0,50,30,20,29,14,15,21,15
Muric,528,0,223,2019-01-20T13:30:00Z,False,12,9,0,0,53,33,20,11,5,6,42,15
Muric,528,0,237,2019-01-29T20:00:00Z,False,12,14,0,0,56,33,23,21,10,11,35,13
Muric,528,0,247,2019-02-03T16:30:00Z,True,12,0,0,0,56,33,23,47,32,15,9,18
Muric,528,0,265,2019-02-06T19:45:00Z,False,12,7,0,0,59,36,23,33,21,12,26,2
Muric,528,0,255,2019-02-10T16:00:00Z,True,12,5,0,0,62,36,26,50,28,22,12,14
Muric,528,0,277,2019-02-27T20:00:00Z,True,12,18,0,0,65,39,26,36,21,15,29,24
Muric,528,0,280,2019-03-02T15:00:00Z,False,12,1,0,0,68,42,26,34,25,9,34,1
Muric,528,0,297,2019-03-09T17:30:00Z,True,12,17,0,0,71,42,29,43,23,20,28,22
Muric,528,0,315,2019-03-30T12:30:00Z,False,12,8,0,0,74,45,29,17,15,2,57,14
Muric,528,0,324,2019-04-03T18:45:00Z,True,12,4,0,0,77,45,32,28,20,8,49,37
Muric,528,0,332,2019-04-14T13:05:00Z,False,12,6,0,0,80,48,32,39,16,23,41,16
Muric,528,0,346,2019-04-20T11:30:00Z,True,12,16,0,0,83,48,35,67,34,33,16,15
Muric,528,0,305,2019-04-24T19:00:00Z,False,12,13,0,0,86,51,35,64,35,29,22,0
Muric,528,0,351,2019-04-28T13:05:00Z,False,12,3,0,0,89,51,38,40,23,17,49,15
Muric,528,0,366,2019-05-06T19:00:00Z,True,12,10,0,0,92,51,41,51,26,25,41,26
Muric,528,0,370,2019-05-12T14:00:00Z,False,12,2,0,0,95,54,41,36,23,13,59,18
Sterry,529,1,26,2018-08-26T15:00:00Z,True,14,5,0,0,1,0,1,6,3,3,-5,-3
Sterry,529,1,37,2018-09-01T16:30:00Z,False,14,12,0,0,1,0,1,7,3,4,-6,-2
Sterry,529,1,45,2018-09-15T14:00:00Z,True,14,0,0,0,1,0,1,6,3,3,-5,-3
Sterry,529,1,54,2018-09-22T14:00:00Z,False,14,6,0,0,1,0,1,6,0,6,-5,1
Sterry,529,1,67,2018-09-29T14:00:00Z,True,14,10,0,0,2,0,2,9,6,3,-7,-3
Sterry,529,1,76,2018-10-06T16:30:00Z,False,14,13,0,0,2,0,2,10,4,6,-8,-2
Sterry,529,1,87,2018-10-20T14:00:00Z,True,14,2,0,0,2,0,2,8,7,1,-6,-1
Sterry,529,1,97,2018-10-27T14:00:00Z,False,14,15,0,0,2,0,2,6,2,4,-4,0
Sterry,529,1,107,2018-11-03T15:00:00Z,True,14,17,0,0,3,0,3,19,12,7,-16,-7
Sterry,529,1,118,2018-11-10T15:00:00Z,True,14,1,0,0,6,3,3,20,11,9,-14,-6
Sterry,529,1,122,2018-11-26T20:30:00Z,False,14,3,0,0,9,6,3,9,4,5,0,-1
Sterry,529,1,138,2018-12-01T15:00:00Z,True,14,18,0,0,12,6,6,12,7,5,0,1
Sterry,529,1,148,2018-12-05T19:45:00Z,False,14,7,0,0,12,6,6,22,16,6,-10,-10
Sterry,529,1,158,2018-12-09T16:00:00Z,True,14,19,0,0,13,6,7,19,11,8,-6,-2
Sterry,529,1,163,2018-12-15T15:00:00Z,False,14,9,0,0,13,6,7,10,5,5,3,2
Sterry,529,1,177,2018-12-22T15:00:00Z,True,14,8,0,0,16,6,10,9,8,1,7,5
Sterry,529,1,185,2018-12-26T15:00:00Z,False,14,11,0,0,17,7,10,48,22,26,-31,-12
Sterry,529,1,199,2018-12-29T15:00:00Z,False,14,17,0,0,17,7,10,27,15,12,-10,-5
Sterry,529,1,207,2019-01-02T20:00:00Z,True,14,13,0,0,18,7,11,35,21,14,-17,-7
Sterry,529,1,213,2019-01-12T17:30:00Z,False,14,5,0,0,18,7,11,44,22,22,-26,-11
Sterry,529,1,226,2019-01-19T15:00:00Z,True,14,4,0,0,18,7,11,19,14,5,-1,2
Sterry,529,1,237,2019-01-29T20:00:00Z,True,14,12,0,0,21,10,11,56,33,23,-35,-13
Sterry,529,1,248,2019-02-02T12:30:00Z,False,14,16,0,0,24,13,11,54,21,33,-30,-10
Sterry,529,1,259,2019-02-11T20:00:00Z,False,14,19,0,0,24,13,11,38,20,18,-14,-9
Sterry,529,1,268,2019-02-23T15:00:00Z,True,14,9,0,0,25,13,12,11,5,6,14,7
Sterry,529,1,278,2019-02-26T20:00:00Z,True,14,3,0,0,28,16,12,30,17,13,-2,3
Sterry,529,1,288,2019-03-02T17:30:00Z,False,14,18,0,0,31,19,12,36,21,15,-5,-9
Sterry,529,1,298,2019-03-09T15:00:00Z,True,14,7,0,0,31,19,12,37,22,15,-6,4
Sterry,529,1,300,2019-03-16T15:00:00Z,False,14,1,0,0,34,22,12,37,25,12,-3,-13
Sterry,529,1,310,2019-04-01T19:00:00Z,False,14,0,0,0,35,22,13,60,41,19,-25,-28
Sterry,529,1,325,2019-04-06T14:00:00Z,True,14,6,0,0,35,22,13,36,16,20,-1,2
Sterry,529,1,334,2019-04-12T19:00:00Z,False,14,10,0,0,35,22,13,47,23,24,-12,-10
Sterry,529,1,347,2019-04-20T16:30:00Z,True,14,15,0,0,38,22,16,36,21,15,2,7
Sterry,529,1,350,2019-04-27T16:30:00Z,False,14,2,0,0,41,25,16,34,22,12,7,-6
Sterry,529,1,367,2019-05-04T18:45:00Z,True,14,11,0,0,42,25,17,91,50,41,-49,-16
Sterry,529,1,373,2019-05-12T14:00:00Z,False,14,8,0,0,42,25,17,26,21,5,16,-4
Longstaff,530,2,26,2018-08-26T15:00:00Z,True,14,5,0,0,1,0,1,6,3,3,-5,-3
Longstaff,530,2,37,2018-09-01T16:30:00Z,False,14,12,0,0,1,0,1,7,3,4,-6,-2
Longstaff,530,2,45,2018-09-15T14:00:00Z,True,14,0,0,0,1,0,1,6,3,3,-5,-3
Longstaff,530,2,54,2018-09-22T14:00:00Z,False,14,6,0,0,1,0,1,6,0,6,-5,1
Longstaff,530,2,67,2018-09-29T14:00:00Z,True,14,10,0,0,2,0,2,9,6,3,-7,-3
Longstaff,530,2,76,2018-10-06T16:30:00Z,False,14,13,0,0,2,0,2,10,4,6,-8,-2
Longstaff,530,2,87,2018-10-20T14:00:00Z,True,14,2,0,0,2,0,2,8,7,1,-6,-1
Longstaff,530,2,97,2018-10-27T14:00:00Z,False,14,15,0,0,2,0,2,6,2,4,-4,0
Longstaff,530,2,107,2018-11-03T15:00:00Z,True,14,17,0,0,3,0,3,19,12,7,-16,-7
Longstaff,530,2,118,2018-11-10T15:00:00Z,True,14,1,0,0,6,3,3,20,11,9,-14,-6
Longstaff,530,2,122,2018-11-26T20:30:00Z,False,14,3,0,0,9,6,3,9,4,5,0,-1
Longstaff,530,2,138,2018-12-01T15:00:00Z,True,14,18,0,0,12,6,6,12,7,5,0,1
Longstaff,530,2,148,2018-12-05T19:45:00Z,False,14,7,0,0,12,6,6,22,16,6,-10,-10
Longstaff,530,2,158,2018-12-09T16:00:00Z,True,14,19,0,0,13,6,7,19,11,8,-6,-2
Longstaff,530,2,163,2018-12-15T15:00:00Z,False,14,9,0,0,13,6,7,10,5,5,3,2
Longstaff,530,2,177,2018-12-22T15:00:00Z,True,14,8,0,0,16,6,10,9,8,1,7,5
Longstaff,530,2,185,2018-12-26T15:00:00Z,False,14,11,17,1,17,7,10,48,22,26,-31,-12
Longstaff,530,2,199,2018-12-29T15:00:00Z,False,14,17,0,0,17,7,10,27,15,12,-10,-5
Longstaff,530,2,207,2019-01-02T20:00:00Z,True,14,13,0,0,18,7,11,35,21,14,-17,-7
Longstaff,530,2,213,2019-01-12T17:30:00Z,False,14,5,90,2,18,7,11,44,22,22,-26,-11
Longstaff,530,2,226,2019-01-19T15:00:00Z,True,14,4,90,3,18,7,11,19,14,5,-1,2
Longstaff,530,2,237,2019-01-29T20:00:00Z,True,14,12,90,5,21,10,11,56,33,23,-35,-13
Longstaff,530,2,248,2019-02-02T12:30:00Z,False,14,16,90,2,24,13,11,54,21,33,-30,-10
Longstaff,530,2,259,2019-02-11T20:00:00Z,False,14,19,90,2,24,13,11,38,20,18,-14,-9
Longstaff,530,2,268,2019-02-23T15:00:00Z,True,14,9,90,3,25,13,12,11,5,6,14,7
Longstaff,530,2,278,2019-02-26T20:00:00Z,True,14,3,84,8,28,16,12,30,17,13,-2,3
Longstaff,530,2,288,2019-03-02T17:30:00Z,False,14,18,45,0,31,19,12,36,21,15,-5,-9
Longstaff,530,2,298,2019-03-09T15:00:00Z,True,14,7,0,0,31,19,12,37,22,15,-6,4
Longstaff,530,2,300,2019-03-16T15:00:00Z,False,14,1,0,0,34,22,12,37,25,12,-3,-13
Longstaff,530,2,310,2019-04-01T19:00:00Z,False,14,0,0,0,35,22,13,60,41,19,-25,-28
Longstaff,530,2,325,2019-04-06T14:00:00Z,True,14,6,0,0,35,22,13,36,16,20,-1,2
Longstaff,530,2,334,2019-04-12T19:00:00Z,False,14,10,0,0,35,22,13,47,23,24,-12,-10
Longstaff,530,2,347,2019-04-20T16:30:00Z,True,14,15,0,0,38,22,16,36,21,15,2,7
Longstaff,530,2,350,2019-04-27T16:30:00Z,False,14,2,0,0,41,25,16,34,22,12,7,-6
Longstaff,530,2,367,2019-05-04T18:45:00Z,True,14,11,0,0,42,25,17,91,50,41,-49,-16
Longstaff,530,2,373,2019-05-12T14:00:00Z,False,14,8,0,0,42,25,17,26,21,5,16,-4
Browning,531,1,35,2018-09-01T14:00:00Z,True,7,9,0,0,5,3,2,1,1,0,4,3
Browning,531,1,42,2018-09-16T15:00:00Z,True,7,18,0,0,6,4,2,0,0,0,6,4
Browning,531,1,50,2018-09-23T15:00:00Z,False,7,0,0,0,6,4,2,9,3,6,-3,-1
Browning,531,1,64,2018-09-29T14:00:00Z,True,7,8,0,0,6,4,2,5,4,1,1,3
Browning,531,1,74,2018-10-06T14:00:00Z,False,7,10,0,0,9,7,2,12,6,6,-3,-4
Browning,531,1,84,2018-10-21T15:00:00Z,True,7,6,0,0,12,7,5,7,1,6,5,1
Browning,531,1,96,2018-10-28T16:00:00Z,False,7,13,0,0,15,10,5,14,7,7,1,-2
Browning,531,1,104,2018-11-03T15:00:00Z,True,7,2,0,0,15,10,5,14,10,4,1,6
Browning,531,1,112,2018-11-11T14:15:00Z,False,7,5,0,0,18,13,5,27,14,13,-9,-9
Browning,531,1,123,2018-11-24T15:00:00Z,True,7,4,0,0,19,13,6,8,7,1,11,12
Browning,531,1,136,2018-12-02T16:15:00Z,False,7,11,0,0,22,16,6,33,16,17,-11,-10
Browning,531,1,148,2018-12-05T19:45:00Z,True,7,14,0,0,22,16,6,12,6,6,10,10
Browning,531,1,155,2018-12-10T20:00:00Z,True,7,17,0,0,23,17,6,20,12,8,3,9
Browning,531,1,165,2018-12-15T12:30:00Z,False,7,12,0,0,24,18,6,41,24,17,-17,-18
Browning,531,1,174,2018-12-23T16:00:00Z,True,7,16,0,0,24,18,6,39,15,24,-15,-6
Browning,531,1,181,2018-12-26T15:00:00Z,False,7,3,0,0,24,18,6,12,7,5,12,-1
Browning,531,1,190,2018-12-29T15:00:00Z,False,7,2,0,0,27,18,9,22,15,7,5,-6
Browning,531,1,204,2019-01-01T12:30:00Z,True,7,10,0,0,27,18,9,28,14,14,-1,4
Browning,531,1,215,2019-01-13T14:15:00Z,True,7,1,0,0,27,18,9,27,18,9,0,9
Browning,531,1,227,2019-01-19T15:00:00Z,False,7,15,0,0,30,21,9,19,8,11,11,1
Browning,531,1,233,2019-01-29T19:45:00Z,False,7,9,0,0,30,21,9,11,5,6,19,4
Browning,531,1,245,2019-02-02T15:00:00Z,True,7,19,0,0,33,21,12,35,20,15,-2,6
Browning,531,1,265,2019-02-06T19:45:00Z,True,7,12,0,0,33,21,12,59,36,23,-26,-2
Browning,531,1,258,2019-02-09T15:00:00Z,False,7,17,0,0,33,21,12,34,17,17,-1,-5
Browning,531,1,271,2019-02-26T19:45:00Z,False,7,4,0,0,33,21,12,25,17,8,8,-5
Browning,531,1,283,2019-03-03T16:15:00Z,True,7,11,0,0,36,21,15,69,38,31,-33,-10
Browning,531,1,298,2019-03-09T15:00:00Z,False,7,14,0,0,37,22,15,31,19,12,6,-4
Browning,531,1,303,2019-03-17T16:30:00Z,True,7,5,0,0,37,22,15,57,32,25,-20,-3
Browning,531,1,319,2019-03-30T17:30:00Z,False,7,18,0,0,40,25,15,42,27,15,-2,-12
Browning,531,1,322,2019-04-07T13:05:00Z,True,7,0,0,0,43,25,18,63,44,19,-20,6
Browning,531,1,333,2019-04-13T14:00:00Z,False,7,8,0,0,46,28,18,17,15,2,29,3
Browning,531,1,344,2019-04-21T12:30:00Z,True,7,13,0,0,46,28,18,64,35,29,-18,-1
Browning,531,1,352,2019-04-27T14:00:00Z,False,7,6,0,0,49,31,18,42,16,26,7,2
Browning,531,1,364,2019-05-03T19:00:00Z,True,7,3,0,0,50,31,19,40,23,17,10,14
Browning,531,1,378,2019-05-12T14:00:00Z,False,7,16,0,0,53,34,19,70,37,33,-17,-18
Schofield,532,0,35,2018-09-01T14:00:00Z,False,9,7,0,0,1,1,0,5,3,2,-4,-3
Schofield,532,0,43,2018-09-15T14:00:00Z,True,9,6,0,0,2,1,1,3,0,3,-1,-2
Schofield,532,0,56,2018-09-22T14:00:00Z,False,9,10,0,0,2,1,1,6,3,3,-4,-2
Schofield,532,0,65,2018-09-29T14:00:00Z,True,9,16,0,0,2,1,1,12,3,9,-10,-8
Schofield,532,0,71,2018-10-06T14:00:00Z,False,9,3,0,0,2,1,1,7,3,4,-5,-2
Schofield,532,0,85,2018-10-20T16:30:00Z,True,9,11,0,0,3,1,2,20,10,10,-17,-9
Schofield,532,0,99,2018-10-27T14:00:00Z,False,9,17,0,0,3,1,2,16,9,7,-13,-7
Schofield,532,0,105,2018-11-05T20:00:00Z,True,9,8,0,0,3,1,2,5,4,1,-2,0
Schofield,532,0,114,2018-11-10T15:00:00Z,True,9,18,0,0,6,4,2,11,7,4,-5,0
Schofield,532,0,129,2018-11-25T16:00:00Z,False,9,19,0,0,7,5,2,16,8,8,-9,-6
Schofield,532,0,134,2018-12-01T15:00:00Z,True,9,2,0,0,10,5,5,15,11,4,-5,1
Schofield,532,0,140,2018-12-04T19:45:00Z,False,9,1,0,0,10,5,5,20,11,9,-10,-6
Schofield,532,0,150,2018-12-08T15:00:00Z,False,9,0,0,0,10,5,5,31,17,14,-21,-12
Schofield,532,0,163,2018-12-15T15:00:00Z,True,9,14,0,0,10,5,5,13,6,7,-3,-2
Schofield,532,0,175,2018-12-22T15:00:00Z,True,9,15,0,0,10,5,5,12,8,4,-2,1
Schofield,532,0,186,2018-12-26T15:00:00Z,False,9,13,0,0,10,5,5,29,15,14,-19,-10
Schofield,532,0,193,2018-12-29T15:00:00Z,False,9,8,0,0,10,5,5,11,9,2,-1,-4
Schofield,532,0,205,2019-01-02T19:45:00Z,True,9,3,0,0,10,5,5,15,10,5,-5,0
Schofield,532,0,212,2019-01-12T15:00:00Z,False,9,4,0,0,10,5,5,18,13,5,-8,-8
Schofield,532,0,223,2019-01-20T13:30:00Z,True,9,12,0,0,11,5,6,53,33,20,-42,-15
Schofield,532,0,233,2019-01-29T19:45:00Z,True,9,7,0,0,11,5,6,30,21,9,-19,-4
Schofield,532,0,243,2019-02-02T15:00:00Z,False,9,5,0,0,11,5,6,47,25,22,-36,-19
Schofield,532,0,253,2019-02-09T15:00:00Z,True,9,0,0,0,11,5,6,47,32,15,-36,-10
Schofield,532,0,268,2019-02-23T15:00:00Z,False,9,14,0,0,11,5,6,25,13,12,-14,-7
Schofield,532,0,273,2019-02-26T19:45:00Z,True,9,19,0,0,11,5,6,40,21,19,-29,-14
Schofield,532,0,281,2019-03-02T15:00:00Z,False,9,2,0,0,14,8,6,27,19,8,-13,-13
Schofield,532,0,294,2019-03-09T15:00:00Z,True,9,1,0,0,14,8,6,34,25,9,-20,-1
Schofield,532,0,308,2019-03-16T15:00:00Z,False,9,18,0,0,14,8,6,39,24,15,-25,-18
Schofield,532,0,314,2019-03-30T15:00:00Z,False,9,6,0,0,14,8,6,33,13,20,-19,-7
Schofield,532,0,323,2019-04-06T14:00:00Z,True,9,10,0,0,14,8,6,44,23,21,-30,-13
Schofield,532,0,338,2019-04-13T11:30:00Z,False,9,16,0,0,14,8,6,64,31,33,-50,-25
Schofield,532,0,345,2019-04-20T14:00:00Z,True,9,17,0,0,14,8,6,46,26,20,-32,-12
Schofield,532,0,355,2019-04-26T19:00:00Z,False,9,11,0,0,14,8,6,88,47,41,-74,-41
Schofield,532,0,365,2019-05-05T13:00:00Z,True,9,13,0,0,14,8,6,65,36,29,-51,-21
Schofield,532,0,377,2019-05-12T14:00:00Z,False,9,15,0,0,15,9,6,38,22,16,-23,-16
McNeil,533,2,31,2018-09-02T15:00:00Z,True,3,13,79,1,1,0,1,3,3,0,-2,0
McNeil,533,2,49,2018-09-16T12:30:00Z,False,3,19,0,0,1,0,1,5,2,3,-4,-1
McNeil,533,2,52,2018-09-22T14:00:00Z,True,3,1,0,0,1,0,1,10,7,3,-9,-3
McNeil,533,2,62,2018-09-30T15:00:00Z,False,3,4,0,0,4,3,1,2,1,1,2,0
McNeil,533,2,71,2018-10-06T14:00:00Z,True,3,9,0,0,7,3,4,2,1,1,5,2
McNeil,533,2,86,2018-10-20T14:00:00Z,False,3,12,0,0,8,4,4,20,12,8,-12,-8
McNeil,533,2,91,2018-10-28T13:30:00Z,True,3,5,0,0,8,4,4,21,11,10,-13,-6
McNeil,533,2,108,2018-11-03T15:00:00Z,False,3,18,0,0,8,4,4,8,4,4,0,0
McNeil,533,2,115,2018-11-10T15:00:00Z,False,3,10,0,0,8,4,4,16,7,9,-8,-3
McNeil,533,2,122,2018-11-26T20:30:00Z,True,3,14,0,0,9,4,5,9,6,3,0,1
McNeil,533,2,133,2018-12-01T15:00:00Z,False,3,6,0,0,9,4,5,9,2,7,0,3
McNeil,533,2,142,2018-12-05T19:45:00Z,True,3,11,0,0,9,4,5,36,19,17,-27,-13
McNeil,533,2,152,2018-12-08T15:00:00Z,True,3,2,0,0,9,4,5,21,14,7,-12,-3
McNeil,533,2,167,2018-12-15T15:00:00Z,False,3,16,0,0,12,7,5,36,12,24,-24,-7
McNeil,533,2,170,2018-12-22T12:30:00Z,False,3,0,0,0,12,7,5,34,20,14,-22,-15
McNeil,533,2,181,2018-12-26T15:00:00Z,True,3,7,27,1,12,7,5,24,18,6,-12,1
McNeil,533,2,191,2018-12-30T14:15:00Z,True,3,18,90,8,12,7,5,27,13,14,-15,-7
McNeil,533,2,205,2019-01-02T19:45:00Z,False,3,9,62,5,15,10,5,10,5,5,5,0
McNeil,533,2,211,2019-01-12T15:00:00Z,True,3,8,90,2,18,10,8,14,12,2,4,8
McNeil,533,2,228,2019-01-19T15:00:00Z,False,3,17,90,3,21,13,8,32,16,16,-11,-8
McNeil,533,2,234,2019-01-29T20:00:00Z,False,3,13,77,3,22,13,9,44,24,20,-22,-15
McNeil,533,2,241,2019-02-02T15:00:00Z,True,3,15,80,2,23,13,10,23,12,11,0,2
McNeil,533,2,250,2019-02-09T17:30:00Z,False,3,2,90,6,24,14,10,27,19,8,-3,-9
McNeil,533,2,262,2019-02-23T12:30:00Z,True,3,16,79,5,27,14,13,60,27,33,-33,-19
McNeil,533,2,278,2019-02-26T20:00:00Z,False,3,14,45,1,30,17,13,28,16,12,2,-3
McNeil,533,2,282,2019-03-02T15:00:00Z,True,3,6,71,2,30,17,13,30,13,17,0,0
McNeil,533,2,296,2019-03-10T12:00:00Z,False,3,11,90,2,30,17,13,70,38,32,-40,-25
McNeil,533,2,302,2019-03-16T15:00:00Z,True,3,10,90,8,30,17,13,38,20,18,-8,-1
McNeil,533,2,312,2019-03-30T15:00:00Z,True,3,19,86,9,30,17,13,44,24,20,-14,-3
McNeil,533,2,320,2019-04-06T14:00:00Z,False,3,1,90,2,33,20,13,38,26,12,-5,-13
McNeil,533,2,331,2019-04-13T14:00:00Z,True,3,4,90,8,36,20,16,28,20,8,8,12
McNeil,533,2,343,2019-04-22T19:00:00Z,False,3,5,90,2,39,23,16,66,38,28,-27,-22
McNeil,533,2,351,2019-04-28T13:05:00Z,True,3,12,90,2,40,23,17,89,51,38,-49,-15
McNeil,533,2,364,2019-05-03T19:00:00Z,False,3,7,21,1,40,23,17,50,31,19,-10,-14
McNeil,533,2,371,2019-05-12T14:00:00Z,True,3,0,63,2,40,23,17,67,45,22,-27,1
Harris,534,2,32,2018-09-02T12:30:00Z,True,4,0,0,0,2,1,1,3,3,0,-1,1
Harris,534,2,41,2018-09-15T14:00:00Z,False,4,5,0,0,2,1,1,12,6,6,-10,-5
Harris,534,2,53,2018-09-22T14:00:00Z,True,4,12,0,0,2,1,1,13,9,4,-11,-3
Harris,534,2,62,2018-09-30T15:00:00Z,True,4,3,0,0,2,1,1,4,3,1,-2,0
Harris,534,2,78,2018-10-06T14:00:00Z,False,4,16,12,1,2,1,1,15,3,12,-13,-2
Harris,534,2,82,2018-10-20T14:00:00Z,True,4,8,8,6,2,1,1,5,4,1,-3,0
Harris,534,2,95,2018-10-27T14:00:00Z,False,4,11,16,1,5,4,1,23,10,13,-18,-9
Harris,534,2,102,2018-11-03T15:00:00Z,True,4,10,0,0,5,4,1,13,7,6,-8,-2
Harris,534,2,111,2018-11-10T12:30:00Z,True,4,2,90,5,5,4,1,14,10,4,-9,0
Harris,534,2,123,2018-11-24T15:00:00Z,False,4,7,66,1,8,7,1,19,13,6,-11,-12
Harris,534,2,131,2018-11-30T20:00:00Z,True,4,19,14,1,8,7,1,16,8,8,-8,-1
Harris,534,2,146,2018-12-04T19:45:00Z,False,4,18,17,1,11,10,1,15,7,8,-4,-6
Harris,534,2,153,2018-12-08T15:00:00Z,True,4,15,5,1,11,10,1,9,5,4,2,6
Harris,534,2,168,2018-12-15T15:00:00Z,False,4,17,0,0,14,13,1,21,12,9,-7,-11
Harris,534,2,172,2018-12-22T17:30:00Z,True,4,13,16,1,14,13,1,26,15,11,-12,2
Harris,534,2,182,2018-12-26T15:00:00Z,False,4,6,90,3,14,13,1,18,8,10,-4,-7
Harris,534,2,194,2018-12-29T15:00:00Z,False,4,10,12,1,15,13,2,28,14,14,-13,-12
Harris,534,2,202,2019-01-01T17:30:00Z,True,4,16,0,0,18,13,5,45,18,27,-27,-14
Harris,534,2,212,2019-01-12T15:00:00Z,True,4,9,0,0,18,13,5,10,5,5,8,8
Harris,534,2,226,2019-01-19T15:00:00Z,False,4,14,0,0,19,14,5,18,7,11,1,-2
Harris,534,2,230,2019-01-29T19:45:00Z,False,4,0,9,1,19,14,5,44,29,15,-25,-24
Harris,534,2,242,2019-02-02T17:30:00Z,True,4,1,0,0,19,14,5,33,24,9,-14,5
Harris,534,2,256,2019-02-09T15:00:00Z,False,4,15,0,0,22,17,5,24,12,12,-2,-7
Harris,534,2,263,2019-02-22T19:45:00Z,True,4,17,0,0,25,17,8,37,20,17,-12,0
Harris,534,2,271,2019-02-26T19:45:00Z,True,4,7,0,0,25,17,8,33,21,12,-8,5
Harris,534,2,289,2019-03-02T15:00:00Z,False,4,19,0,0,25,17,8,40,21,19,-15,-13
Harris,534,2,291,2019-03-09T15:00:00Z,True,4,18,0,0,25,17,8,39,24,15,-14,2
Harris,534,2,313,2019-03-31T13:05:00Z,True,4,5,0,0,28,20,8,57,32,25,-29,-5
Harris,534,2,324,2019-04-03T18:45:00Z,False,4,12,0,0,28,20,8,77,45,32,-49,-37
Harris,534,2,331,2019-04-13T14:00:00Z,False,4,3,0,0,28,20,8,36,20,16,-8,-12
Harris,534,2,301,2019-04-16T18:45:00Z,False,4,2,10,1,28,20,8,33,22,11,-5,-14
Harris,534,2,342,2019-04-21T15:00:00Z,True,4,11,0,0,31,20,11,85,47,38,-54,-18
Harris,534,2,353,2019-04-27T14:00:00Z,False,4,8,0,0,31,20,11,23,18,5,8,-7
Harris,534,2,362,2019-05-04T16:30:00Z,True,4,6,0,0,31,20,11,43,17,26,-12,-6
Harris,534,2,376,2019-05-12T14:00:00Z,False,4,13,0,0,31,20,11,66,36,30,-35,-25
Gazzaniga,535,0,38,2018-09-02T15:00:00Z,False,16,17,0,0,9,3,6,9,6,3,0,0
Gazzaniga,535,0,47,2018-09-15T11:30:00Z,True,16,11,0,0,9,3,6,12,6,6,-3,-3
Gazzaniga,535,0,51,2018-09-22T16:30:00Z,False,16,2,90,3,9,3,6,5,4,1,4,2
Gazzaniga,535,0,65,2018-09-29T14:00:00Z,False,16,9,90,7,12,3,9,2,1,1,10,8
Gazzaniga,535,0,78,2018-10-06T14:00:00Z,True,16,4,0,0,15,3,12,2,1,1,13,2
Gazzaniga,535,0,88,2018-10-20T14:00:00Z,False,16,18,0,0,18,6,12,7,4,3,11,8
Gazzaniga,535,0,98,2018-10-29T20:00:00Z,True,16,12,0,0,21,6,15,23,15,8,-2,-2
Gazzaniga,535,0,109,2018-11-03T19:45:00Z,False,16,19,0,0,21,6,15,15,8,7,6,7
Gazzaniga,535,0,113,2018-11-10T17:30:00Z,False,16,6,0,0,24,6,18,8,2,6,16,16
Gazzaniga,535,0,126,2018-11-24T17:30:00Z,True,16,5,0,0,27,6,21,28,15,13,-1,-7
Gazzaniga,535,0,130,2018-12-02T14:05:00Z,False,16,0,0,0,30,9,21,27,14,13,3,7
Gazzaniga,535,0,149,2018-12-05T20:00:00Z,True,16,15,0,0,30,9,21,9,5,4,21,5
Gazzaniga,535,0,156,2018-12-08T19:45:00Z,False,16,10,0,0,33,12,21,22,11,11,11,10
Gazzaniga,535,0,167,2018-12-15T15:00:00Z,True,16,3,0,0,36,12,24,12,7,5,24,7
Gazzaniga,535,0,174,2018-12-23T16:00:00Z,False,16,7,0,0,39,15,24,24,18,6,15,6
Gazzaniga,535,0,188,2018-12-26T15:00:00Z,True,16,1,0,0,42,15,27,26,17,9,16,6
Gazzaniga,535,0,198,2018-12-29T15:00:00Z,True,16,19,0,0,45,18,27,26,14,12,19,6
Gazzaniga,535,0,202,2019-01-01T17:30:00Z,False,16,4,0,0,45,18,27,18,13,5,27,14
Gazzaniga,535,0,218,2019-01-13T16:30:00Z,True,16,13,0,0,48,18,30,38,21,17,10,1
Gazzaniga,535,0,222,2019-01-20T16:00:00Z,False,16,8,0,0,48,18,30,14,12,2,34,18
Gazzaniga,535,0,239,2019-01-30T20:00:00Z,True,16,17,0,0,51,18,33,33,17,16,18,2
Gazzaniga,535,0,248,2019-02-02T12:30:00Z,True,16,14,0,0,54,21,33,24,13,11,30,10
Gazzaniga,535,0,257,2019-02-10T13:30:00Z,True,16,10,0,0,57,24,33,32,14,18,25,6
Gazzaniga,535,0,262,2019-02-23T12:30:00Z,False,16,3,0,0,60,27,33,27,14,13,33,19
Gazzaniga,535,0,275,2019-02-27T20:00:00Z,False,16,5,0,0,60,27,33,50,28,22,10,5
Gazzaniga,535,0,286,2019-03-02T12:30:00Z,True,16,0,0,0,60,27,33,56,38,18,4,9
Gazzaniga,535,0,299,2019-03-09T15:00:00Z,False,16,15,0,0,61,28,33,27,15,12,34,18
Gazzaniga,535,0,317,2019-03-31T15:30:00Z,False,16,11,0,0,61,28,33,76,41,35,-15,-8
Gazzaniga,535,0,306,2019-04-03T18:45:00Z,True,16,6,0,0,61,28,33,36,16,20,25,8
Gazzaniga,535,0,338,2019-04-13T11:30:00Z,True,16,9,0,0,64,31,33,14,8,6,50,25
Gazzaniga,535,0,346,2019-04-20T11:30:00Z,False,16,12,90,3,67,34,33,83,48,35,-16,-15
Gazzaniga,535,0,327,2019-04-23T18:45:00Z,True,16,2,0,0,67,34,33,34,22,12,33,22
Gazzaniga,535,0,358,2019-04-27T11:30:00Z,True,16,18,0,0,70,37,33,43,28,15,27,22
Gazzaniga,535,0,361,2019-05-04T11:30:00Z,False,16,1,0,0,70,37,33,42,26,16,28,7
Gazzaniga,535,0,378,2019-05-12T14:00:00Z,True,16,7,0,0,70,37,33,53,34,19,17,18
Brian Murphy,536,0,32,2018-09-02T12:30:00Z,True,4,0,0,0,2,1,1,3,3,0,-1,1
Brian Murphy,536,0,41,2018-09-15T14:00:00Z,False,4,5,0,0,2,1,1,12,6,6,-10,-5
Brian Murphy,536,0,53,2018-09-22T14:00:00Z,True,4,12,0,0,2,1,1,13,9,4,-11,-3
Brian Murphy,536,0,62,2018-09-30T15:00:00Z,True,4,3,0,0,2,1,1,4,3,1,-2,0
Brian Murphy,536,0,78,2018-10-06T14:00:00Z,False,4,16,0,0,2,1,1,15,3,12,-13,-2
Brian Murphy,536,0,82,2018-10-20T14:00:00Z,True,4,8,0,0,2,1,1,5,4,1,-3,0
Brian Murphy,536,0,95,2018-10-27T14:00:00Z,False,4,11,0,0,5,4,1,23,10,13,-18,-9
Brian Murphy,536,0,102,2018-11-03T15:00:00Z,True,4,10,0,0,5,4,1,13,7,6,-8,-2
Brian Murphy,536,0,111,2018-11-10T12:30:00Z,True,4,2,0,0,5,4,1,14,10,4,-9,0
Brian Murphy,536,0,123,2018-11-24T15:00:00Z,False,4,7,0,0,8,7,1,19,13,6,-11,-12
Brian Murphy,536,0,131,2018-11-30T20:00:00Z,True,4,19,0,0,8,7,1,16,8,8,-8,-1
Brian Murphy,536,0,146,2018-12-04T19:45:00Z,False,4,18,0,0,11,10,1,15,7,8,-4,-6
Brian Murphy,536,0,153,2018-12-08T15:00:00Z,True,4,15,0,0,11,10,1,9,5,4,2,6
Brian Murphy,536,0,168,2018-12-15T15:00:00Z,False,4,17,0,0,14,13,1,21,12,9,-7,-11
Brian Murphy,536,0,172,2018-12-22T17:30:00Z,True,4,13,0,0,14,13,1,26,15,11,-12,2
Brian Murphy,536,0,182,2018-12-26T15:00:00Z,False,4,6,0,0,14,13,1,18,8,10,-4,-7
Brian Murphy,536,0,194,2018-12-29T15:00:00Z,False,4,10,0,0,15,13,2,28,14,14,-13,-12
Brian Murphy,536,0,202,2019-01-01T17:30:00Z,True,4,16,0,0,18,13,5,45,18,27,-27,-14
Brian Murphy,536,0,212,2019-01-12T15:00:00Z,True,4,9,0,0,18,13,5,10,5,5,8,8
Brian Murphy,536,0,226,2019-01-19T15:00:00Z,False,4,14,0,0,19,14,5,18,7,11,1,-2
Brian Murphy,536,0,230,2019-01-29T19:45:00Z,False,4,0,0,0,19,14,5,44,29,15,-25,-24
Brian Murphy,536,0,242,2019-02-02T17:30:00Z,True,4,1,0,0,19,14,5,33,24,9,-14,5
Brian Murphy,536,0,256,2019-02-09T15:00:00Z,False,4,15,0,0,22,17,5,24,12,12,-2,-7
Brian Murphy,536,0,263,2019-02-22T19:45:00Z,True,4,17,0,0,25,17,8,37,20,17,-12,0
Brian Murphy,536,0,271,2019-02-26T19:45:00Z,True,4,7,0,0,25,17,8,33,21,12,-8,5
Brian Murphy,536,0,289,2019-03-02T15:00:00Z,False,4,19,0,0,25,17,8,40,21,19,-15,-13
Brian Murphy,536,0,291,2019-03-09T15:00:00Z,True,4,18,0,0,25,17,8,39,24,15,-14,2
Brian Murphy,536,0,313,2019-03-31T13:05:00Z,True,4,5,0,0,28,20,8,57,32,25,-29,-5
Brian Murphy,536,0,324,2019-04-03T18:45:00Z,False,4,12,0,0,28,20,8,77,45,32,-49,-37
Brian Murphy,536,0,331,2019-04-13T14:00:00Z,False,4,3,0,0,28,20,8,36,20,16,-8,-12
Brian Murphy,536,0,301,2019-04-16T18:45:00Z,False,4,2,0,0,28,20,8,33,22,11,-5,-14
Brian Murphy,536,0,342,2019-04-21T15:00:00Z,True,4,11,0,0,31,20,11,85,47,38,-54,-18
Brian Murphy,536,0,353,2019-04-27T14:00:00Z,False,4,8,0,0,31,20,11,23,18,5,8,-7
Brian Murphy,536,0,362,2019-05-04T16:30:00Z,True,4,6,0,0,31,20,11,43,17,26,-12,-6
Brian Murphy,536,0,376,2019-05-12T14:00:00Z,False,4,13,0,0,31,20,11,66,36,30,-35,-25
Whiteman,537,0,51,2018-09-22T16:30:00Z,False,16,2,0,0,9,3,6,5,4,1,4,2
Whiteman,537,0,65,2018-09-29T14:00:00Z,False,16,9,0,0,12,3,9,2,1,1,10,8
Whiteman,537,0,78,2018-10-06T14:00:00Z,True,16,4,0,0,15,3,12,2,1,1,13,2
Whiteman,537,0,88,2018-10-20T14:00:00Z,False,16,18,0,0,18,6,12,7,4,3,11,8
Whiteman,537,0,98,2018-10-29T20:00:00Z,True,16,12,0,0,21,6,15,23,15,8,-2,-2
Whiteman,537,0,109,2018-11-03T19:45:00Z,False,16,19,0,0,21,6,15,15,8,7,6,7
Whiteman,537,0,113,2018-11-10T17:30:00Z,False,16,6,0,0,24,6,18,8,2,6,16,16
Whiteman,537,0,126,2018-11-24T17:30:00Z,True,16,5,0,0,27,6,21,28,15,13,-1,-7
Whiteman,537,0,130,2018-12-02T14:05:00Z,False,16,0,0,0,30,9,21,27,14,13,3,7
Whiteman,537,0,149,2018-12-05T20:00:00Z,True,16,15,0,0,30,9,21,9,5,4,21,5
Whiteman,537,0,156,2018-12-08T19:45:00Z,False,16,10,0,0,33,12,21,22,11,11,11,10
Whiteman,537,0,167,2018-12-15T15:00:00Z,True,16,3,0,0,36,12,24,12,7,5,24,7
Whiteman,537,0,174,2018-12-23T16:00:00Z,False,16,7,0,0,39,15,24,24,18,6,15,6
Whiteman,537,0,188,2018-12-26T15:00:00Z,True,16,1,0,0,42,15,27,26,17,9,16,6
Whiteman,537,0,198,2018-12-29T15:00:00Z,True,16,19,0,0,45,18,27,26,14,12,19,6
Whiteman,537,0,202,2019-01-01T17:30:00Z,False,16,4,0,0,45,18,27,18,13,5,27,14
Whiteman,537,0,218,2019-01-13T16:30:00Z,True,16,13,0,0,48,18,30,38,21,17,10,1
Whiteman,537,0,222,2019-01-20T16:00:00Z,False,16,8,0,0,48,18,30,14,12,2,34,18
Whiteman,537,0,239,2019-01-30T20:00:00Z,True,16,17,0,0,51,18,33,33,17,16,18,2
Whiteman,537,0,248,2019-02-02T12:30:00Z,True,16,14,0,0,54,21,33,24,13,11,30,10
Whiteman,537,0,257,2019-02-10T13:30:00Z,True,16,10,0,0,57,24,33,32,14,18,25,6
Whiteman,537,0,262,2019-02-23T12:30:00Z,False,16,3,0,0,60,27,33,27,14,13,33,19
Whiteman,537,0,275,2019-02-27T20:00:00Z,False,16,5,0,0,60,27,33,50,28,22,10,5
Whiteman,537,0,286,2019-03-02T12:30:00Z,True,16,0,0,0,60,27,33,56,38,18,4,9
Whiteman,537,0,299,2019-03-09T15:00:00Z,False,16,15,0,0,61,28,33,27,15,12,34,18
Whiteman,537,0,317,2019-03-31T15:30:00Z,False,16,11,0,0,61,28,33,76,41,35,-15,-8
Whiteman,537,0,306,2019-04-03T18:45:00Z,True,16,6,0,0,61,28,33,36,16,20,25,8
Whiteman,537,0,338,2019-04-13T11:30:00Z,True,16,9,0,0,64,31,33,14,8,6,50,25
Whiteman,537,0,346,2019-04-20T11:30:00Z,False,16,12,0,0,67,34,33,83,48,35,-16,-15
Whiteman,537,0,327,2019-04-23T18:45:00Z,True,16,2,0,0,67,34,33,34,22,12,33,22
Whiteman,537,0,358,2019-04-27T11:30:00Z,True,16,18,0,0,70,37,33,43,28,15,27,22
Whiteman,537,0,361,2019-05-04T11:30:00Z,False,16,1,0,0,70,37,33,42,26,16,28,7
Whiteman,537,0,378,2019-05-12T14:00:00Z,True,16,7,0,0,70,37,33,53,34,19,17,18
Diangana,538,2,68,2018-09-29T11:30:00Z,True,18,13,1,1,4,1,3,10,4,6,-6,-5
Diangana,538,2,70,2018-10-05T19:00:00Z,False,18,2,0,0,7,4,3,5,4,1,2,-1
Diangana,538,2,88,2018-10-20T14:00:00Z,True,18,16,50,1,7,4,3,18,6,12,-11,-8
Diangana,538,2,94,2018-10-27T16:30:00Z,False,18,10,74,3,7,4,3,12,6,6,-5,-3
Diangana,538,2,108,2018-11-03T15:00:00Z,True,18,3,85,5,8,4,4,8,4,4,0,0
Diangana,538,2,114,2018-11-10T15:00:00Z,False,18,9,45,1,11,7,4,6,4,2,5,0
Diangana,538,2,128,2018-11-24T15:00:00Z,True,18,12,54,1,12,7,5,32,21,11,-20,-4
Diangana,538,2,138,2018-12-01T15:00:00Z,False,18,14,0,0,12,7,5,12,6,6,0,-1
Diangana,538,2,146,2018-12-04T19:45:00Z,True,18,4,14,1,15,7,8,11,10,1,4,6
Diangana,538,2,159,2018-12-08T15:00:00Z,True,18,6,15,1,18,10,8,12,5,7,6,3
Diangana,538,2,162,2018-12-15T17:30:00Z,False,18,8,5,1,21,13,8,9,8,1,12,0
Diangana,538,2,178,2018-12-22T15:00:00Z,True,18,17,15,1,24,13,11,24,15,9,0,4
Diangana,538,2,187,2018-12-27T19:45:00Z,False,18,15,54,1,24,13,11,15,8,7,9,3
Diangana,538,2,191,2018-12-30T14:15:00Z,False,18,3,45,1,27,13,14,12,7,5,15,7
Diangana,538,2,208,2019-01-02T19:45:00Z,True,18,2,0,0,27,13,14,25,18,7,2,6
Diangana,538,2,219,2019-01-12T12:30:00Z,True,18,0,0,0,28,14,14,41,26,15,-13,-1
Diangana,538,2,221,2019-01-19T15:00:00Z,False,18,1,11,1,31,17,14,27,18,9,4,-4
Diangana,538,2,235,2019-01-29T19:45:00Z,False,18,19,0,0,31,17,14,32,17,15,-1,-3
Diangana,538,2,249,2019-02-04T20:00:00Z,True,18,11,0,0,31,17,14,61,32,29,-30,-12
Diangana,538,2,251,2019-02-09T15:00:00Z,False,18,6,0,0,32,18,14,26,12,14,6,2
Diangana,538,2,269,2019-02-22T19:45:00Z,True,18,8,0,0,33,18,15,17,15,2,16,16
Diangana,538,2,277,2019-02-27T20:00:00Z,False,18,12,14,1,36,21,15,65,39,26,-29,-24
Diangana,538,2,288,2019-03-02T17:30:00Z,True,18,14,0,0,36,21,15,31,19,12,5,9
Diangana,538,2,291,2019-03-09T15:00:00Z,False,18,4,0,0,39,24,15,25,17,8,14,-2
Diangana,538,2,308,2019-03-16T15:00:00Z,True,18,9,0,0,39,24,15,14,8,6,25,18
Diangana,538,2,319,2019-03-30T17:30:00Z,True,18,7,23,1,42,27,15,40,25,15,2,12
Diangana,538,2,321,2019-04-08T19:00:00Z,False,18,5,0,0,42,27,15,63,35,28,-21,-20
Diangana,538,2,336,2019-04-13T16:30:00Z,False,18,13,28,1,42,27,15,61,32,29,-19,-17
Diangana,538,2,348,2019-04-20T14:00:00Z,True,18,10,0,0,42,27,15,47,23,24,-5,3
Diangana,538,2,358,2019-04-27T11:30:00Z,False,18,16,0,0,43,28,15,70,37,33,-27,-22
Diangana,538,2,368,2019-05-04T14:00:00Z,True,18,15,67,3,46,28,18,38,22,16,8,12
Diangana,538,2,379,2019-05-12T14:00:00Z,False,18,17,0,0,49,31,18,50,27,23,-1,-9
Skipp,539,2,78,2018-10-06T14:00:00Z,True,16,4,0,0,15,3,12,2,1,1,13,2
Skipp,539,2,88,2018-10-20T14:00:00Z,False,16,18,0,0,18,6,12,7,4,3,11,8
Skipp,539,2,98,2018-10-29T20:00:00Z,True,16,12,0,0,21,6,15,23,15,8,-2,-2
Skipp,539,2,109,2018-11-03T19:45:00Z,False,16,19,0,0,21,6,15,15,8,7,6,7
Skipp,539,2,113,2018-11-10T17:30:00Z,False,16,6,0,0,24,6,18,8,2,6,16,16
Skipp,539,2,126,2018-11-24T17:30:00Z,True,16,5,0,0,27,6,21,28,15,13,-1,-7
Skipp,539,2,130,2018-12-02T14:05:00Z,False,16,0,0,0,30,9,21,27,14,13,3,7
Skipp,539,2,149,2018-12-05T20:00:00Z,True,16,15,3,1,30,9,21,9,5,4,21,5
Skipp,539,2,156,2018-12-08T19:45:00Z,False,16,10,0,0,33,12,21,22,11,11,11,10
Skipp,539,2,167,2018-12-15T15:00:00Z,True,16,3,74,3,36,12,24,12,7,5,24,7
Skipp,539,2,174,2018-12-23T16:00:00Z,False,16,7,11,1,39,15,24,24,18,6,15,6
Skipp,539,2,188,2018-12-26T15:00:00Z,True,16,1,13,1,42,15,27,26,17,9,16,6
Skipp,539,2,198,2018-12-29T15:00:00Z,True,16,19,0,0,45,18,27,26,14,12,19,6
Skipp,539,2,202,2019-01-01T17:30:00Z,False,16,4,14,1,45,18,27,18,13,5,27,14
Skipp,539,2,218,2019-01-13T16:30:00Z,True,16,13,0,0,48,18,30,38,21,17,10,1
Skipp,539,2,222,2019-01-20T16:00:00Z,False,16,8,0,0,48,18,30,14,12,2,34,18
Skipp,539,2,239,2019-01-30T20:00:00Z,True,16,17,0,0,51,18,33,33,17,16,18,2
Skipp,539,2,248,2019-02-02T12:30:00Z,True,16,14,0,0,54,21,33,24,13,11,30,10
Skipp,539,2,257,2019-02-10T13:30:00Z,True,16,10,70,3,57,24,33,32,14,18,25,6
Skipp,539,2,262,2019-02-23T12:30:00Z,False,16,3,0,0,60,27,33,27,14,13,33,19
Skipp,539,2,275,2019-02-27T20:00:00Z,False,16,5,0,0,60,27,33,50,28,22,10,5
Skipp,539,2,286,2019-03-02T12:30:00Z,True,16,0,0,0,60,27,33,56,38,18,4,9
Skipp,539,2,299,2019-03-09T15:00:00Z,False,16,15,0,0,61,28,33,27,15,12,34,18
Skipp,539,2,317,2019-03-31T15:30:00Z,False,16,11,0,0,61,28,33,76,41,35,-15,-8
Skipp,539,2,306,2019-04-03T18:45:00Z,True,16,6,0,0,61,28,33,36,16,20,25,8
Skipp,539,2,338,2019-04-13T11:30:00Z,True,16,9,16,1,64,31,33,14,8,6,50,25
Skipp,539,2,346,2019-04-20T11:30:00Z,False,16,12,0,0,67,34,33,83,48,35,-16,-15
Skipp,539,2,327,2019-04-23T18:45:00Z,True,16,2,0,0,67,34,33,34,22,12,33,22
Skipp,539,2,358,2019-04-27T11:30:00Z,True,16,18,0,0,70,37,33,43,28,15,27,22
Skipp,539,2,361,2019-05-04T11:30:00Z,False,16,1,0,0,70,37,33,42,26,16,28,7
Skipp,539,2,378,2019-05-12T14:00:00Z,True,16,7,13,1,70,37,33,53,34,19,17,18
Steven Sessegnon,540,1,73,2018-10-07T11:00:00Z,True,8,0,0,0,5,4,1,15,9,6,-10,-2
Steven Sessegnon,540,1,82,2018-10-20T14:00:00Z,False,8,4,0,0,5,4,1,2,1,1,3,0
Steven Sessegnon,540,1,93,2018-10-27T14:00:00Z,True,8,1,0,0,5,4,1,17,11,6,-12,-2
Steven Sessegnon,540,1,105,2018-11-05T20:00:00Z,False,8,9,0,0,5,4,1,3,1,2,2,0
Steven Sessegnon,540,1,116,2018-11-11T12:00:00Z,False,8,11,0,0,5,4,1,27,13,14,-22,-12
Steven Sessegnon,540,1,124,2018-11-24T15:00:00Z,True,8,15,0,0,5,4,1,8,4,4,-3,0
Steven Sessegnon,540,1,132,2018-12-02T12:00:00Z,False,8,5,0,0,8,7,1,28,15,13,-20,-14
Steven Sessegnon,540,1,143,2018-12-05T19:45:00Z,True,8,10,0,0,8,7,1,21,11,10,-13,-3
Steven Sessegnon,540,1,157,2018-12-08T15:00:00Z,False,8,13,0,0,9,8,1,23,12,11,-14,-11
Steven Sessegnon,540,1,162,2018-12-15T17:30:00Z,True,8,18,0,0,9,8,1,21,13,8,-12,0
Steven Sessegnon,540,1,177,2018-12-22T15:00:00Z,False,8,14,0,0,9,8,1,16,6,10,-7,-5
Steven Sessegnon,540,1,183,2018-12-26T12:30:00Z,True,8,19,0,0,10,8,2,25,14,11,-15,-3
Steven Sessegnon,540,1,193,2018-12-29T15:00:00Z,True,8,9,0,0,11,9,2,10,5,5,1,4
Steven Sessegnon,540,1,200,2019-01-01T15:00:00Z,False,8,0,0,0,14,12,2,38,23,15,-24,-21
Steven Sessegnon,540,1,211,2019-01-12T15:00:00Z,False,8,3,0,0,14,12,2,18,10,8,-4,-8
Steven Sessegnon,540,1,222,2019-01-20T16:00:00Z,True,8,16,0,0,14,12,2,48,18,30,-34,-18
Steven Sessegnon,540,1,232,2019-01-29T19:45:00Z,True,8,2,0,0,14,12,2,26,18,8,-12,4
Steven Sessegnon,540,1,244,2019-02-02T15:00:00Z,False,8,6,0,0,17,15,2,23,9,14,-6,-7
Steven Sessegnon,540,1,252,2019-02-09T12:30:00Z,True,8,13,0,0,17,15,2,48,25,23,-31,-8
Steven Sessegnon,540,1,269,2019-02-22T19:45:00Z,False,8,18,0,0,17,15,2,33,18,15,-16,-16
Steven Sessegnon,540,1,279,2019-02-27T19:45:00Z,False,8,15,0,0,17,15,2,24,12,12,-7,-10
Steven Sessegnon,540,1,284,2019-03-03T14:05:00Z,True,8,5,0,0,17,15,2,53,31,22,-36,-7
Steven Sessegnon,540,1,295,2019-03-09T15:00:00Z,False,8,10,0,0,17,15,2,35,17,18,-18,-15
Steven Sessegnon,540,1,304,2019-03-17T14:15:00Z,True,8,11,0,0,17,15,2,73,41,32,-56,-17
Steven Sessegnon,540,1,315,2019-03-30T12:30:00Z,True,8,12,0,0,17,15,2,74,45,29,-57,-14
Steven Sessegnon,540,1,328,2019-04-02T18:45:00Z,False,8,17,0,0,17,15,2,43,23,20,-26,-21
Steven Sessegnon,540,1,333,2019-04-13T14:00:00Z,True,8,7,0,0,17,15,2,46,28,18,-29,-3
Steven Sessegnon,540,1,341,2019-04-20T14:00:00Z,False,8,1,0,0,20,18,2,41,26,15,-21,-24
Steven Sessegnon,540,1,353,2019-04-27T14:00:00Z,True,8,4,0,0,23,18,5,31,20,11,-8,7
Steven Sessegnon,540,1,369,2019-05-04T14:00:00Z,False,8,19,0,0,26,21,5,54,31,23,-28,-26
Steven Sessegnon,540,1,373,2019-05-12T14:00:00Z,True,8,14,0,0,26,21,5,42,25,17,-16,4
Martinez,541,0,73,2018-10-07T11:00:00Z,False,0,8,0,0,15,9,6,5,4,1,10,2
Martinez,541,0,80,2018-10-22T19:00:00Z,True,0,10,0,0,18,9,9,12,6,6,6,3
Martinez,541,0,92,2018-10-28T13:30:00Z,False,0,6,0,0,21,12,9,7,1,6,14,8
Martinez,541,0,100,2018-11-03T17:30:00Z,True,0,11,0,0,22,12,10,26,13,13,-4,-1
Martinez,541,0,110,2018-11-11T16:30:00Z,True,0,19,0,0,23,13,10,15,8,7,8,6
Martinez,541,0,120,2018-11-25T13:30:00Z,False,0,1,0,0,24,14,10,20,11,9,4,-1
Martinez,541,0,130,2018-12-02T14:05:00Z,True,0,16,0,0,27,14,13,30,9,21,-3,-7
Martinez,541,0,144,2018-12-05T20:00:00Z,False,0,13,0,0,30,17,13,22,11,11,8,2
Martinez,541,0,150,2018-12-08T15:00:00Z,True,0,9,0,0,31,17,14,10,5,5,21,12
Martinez,541,0,166,2018-12-16T13:30:00Z,False,0,15,0,0,34,20,14,9,5,4,25,9
Martinez,541,0,170,2018-12-22T12:30:00Z,True,0,3,0,0,34,20,14,12,7,5,22,15
Martinez,541,0,180,2018-12-26T17:15:00Z,False,0,2,0,0,37,23,14,21,14,7,16,0
Martinez,541,0,195,2018-12-29T17:30:00Z,False,0,11,0,0,38,23,15,51,25,26,-13,-10
Martinez,541,0,200,2019-01-01T15:00:00Z,True,0,8,0,0,38,23,15,14,12,2,24,21
Martinez,541,0,219,2019-01-12T12:30:00Z,False,0,18,0,0,41,26,15,28,14,14,13,1
Martinez,541,0,220,2019-01-19T17:30:00Z,True,0,5,0,0,41,26,15,47,25,22,-6,4
Martinez,541,0,230,2019-01-29T19:45:00Z,True,0,4,0,0,44,29,15,19,14,5,25,24
Martinez,541,0,247,2019-02-03T16:30:00Z,False,0,12,0,0,47,32,15,56,33,23,-9,-18
Martinez,541,0,253,2019-02-09T15:00:00Z,False,0,9,0,0,47,32,15,11,5,6,36,10
Martinez,541,0,260,2019-02-24T14:05:00Z,True,0,15,0,0,50,32,18,24,12,12,26,20
Martinez,541,0,270,2019-02-27T19:45:00Z,True,0,1,0,0,53,35,18,34,25,9,19,26
Martinez,541,0,286,2019-03-02T12:30:00Z,False,0,16,0,0,56,38,18,60,27,33,-4,-9
Martinez,541,0,290,2019-03-10T16:30:00Z,True,0,13,0,0,57,38,19,58,29,29,-1,9
Martinez,541,0,310,2019-04-01T19:00:00Z,True,0,14,0,0,60,41,19,35,22,13,25,28
Martinez,541,0,322,2019-04-07T13:05:00Z,False,0,7,0,0,63,44,19,43,25,18,20,-6
Martinez,541,0,339,2019-04-15T19:00:00Z,False,0,17,0,0,63,44,19,46,26,20,17,-7
Martinez,541,0,340,2019-04-21T15:00:00Z,True,0,6,0,0,66,44,22,39,16,23,27,21
Martinez,541,0,309,2019-04-24T18:45:00Z,False,0,19,0,0,66,44,22,48,28,20,18,-6
Martinez,541,0,354,2019-04-28T11:00:00Z,False,0,10,0,0,66,44,22,48,23,25,18,-1
Martinez,541,0,360,2019-05-05T15:30:00Z,True,0,2,0,0,66,44,22,35,23,12,31,32
Martinez,541,0,371,2019-05-12T14:00:00Z,False,0,3,0,0,67,45,22,40,23,17,27,-1
Origi,542,3,85,2018-10-20T16:30:00Z,False,11,9,0,0,20,10,10,3,1,2,17,9
Origi,542,3,95,2018-10-27T14:00:00Z,True,11,4,0,0,23,10,13,5,4,1,18,9
Origi,542,3,100,2018-11-03T17:30:00Z,False,11,0,0,0,26,13,13,22,12,10,4,1
Origi,542,3,116,2018-11-11T12:00:00Z,True,11,8,0,0,27,13,14,5,4,1,22,12
Origi,542,3,127,2018-11-24T15:00:00Z,False,11,17,0,0,30,16,14,20,12,8,10,2
Origi,542,3,136,2018-12-02T16:15:00Z,True,11,7,6,6,33,16,17,22,16,6,11,10
Origi,542,3,142,2018-12-05T19:45:00Z,False,11,3,65,5,36,19,17,9,4,5,27,13
Origi,542,3,151,2018-12-08T12:30:00Z,False,11,1,0,0,39,19,20,23,14,9,16,6
Origi,542,3,164,2018-12-16T16:00:00Z,True,11,13,0,0,42,19,23,26,15,11,16,8
Origi,542,3,179,2018-12-21T20:00:00Z,False,11,19,0,0,45,22,23,25,14,11,20,9
Origi,542,3,185,2018-12-26T15:00:00Z,True,11,14,0,0,48,22,26,17,7,10,31,12
Origi,542,3,195,2018-12-29T17:30:00Z,True,11,0,0,0,51,25,26,38,23,15,13,10
Origi,542,3,206,2019-01-03T20:00:00Z,False,11,12,0,0,54,28,26,47,27,20,7,-1
Origi,542,3,210,2019-01-12T15:00:00Z,False,11,2,1,1,54,28,26,26,18,8,28,8
Origi,542,3,224,2019-01-19T15:00:00Z,True,11,6,0,0,57,28,29,22,9,13,35,15
Origi,542,3,236,2019-01-30T20:00:00Z,True,11,10,0,0,60,31,29,31,14,17,29,14
Origi,542,3,249,2019-02-04T20:00:00Z,False,11,18,15,1,61,32,29,31,17,14,30,12
Origi,542,3,254,2019-02-09T15:00:00Z,True,11,1,3,1,62,32,30,33,24,9,29,23
Origi,542,3,267,2019-02-24T14:05:00Z,False,11,13,11,1,65,35,30,51,25,26,14,5
Origi,542,3,276,2019-02-27T20:00:00Z,True,11,17,90,6,66,35,31,40,20,20,26,15
Origi,542,3,283,2019-03-03T16:15:00Z,False,11,7,62,2,69,38,31,36,21,15,33,10
Origi,542,3,296,2019-03-10T12:00:00Z,True,11,3,0,0,70,38,32,30,17,13,40,25
Origi,542,3,304,2019-03-17T14:15:00Z,False,11,8,18,1,73,41,32,17,15,2,56,17
Origi,542,3,317,2019-03-31T15:30:00Z,True,11,16,13,1,76,41,35,61,28,33,15,8
Origi,542,3,326,2019-04-05T19:00:00Z,False,11,15,0,0,79,44,35,33,18,15,46,17
Origi,542,3,335,2019-04-14T15:30:00Z,True,11,5,0,0,82,44,38,66,38,28,16,16
Origi,542,3,342,2019-04-21T15:00:00Z,False,11,4,0,0,85,47,38,31,20,11,54,18
Origi,542,3,355,2019-04-26T19:00:00Z,True,11,9,0,0,88,47,41,14,8,6,74,41
Origi,542,3,367,2019-05-04T18:45:00Z,False,11,14,17,5,91,50,41,42,25,17,49,16
Origi,542,3,375,2019-05-12T14:00:00Z,True,11,19,63,2,94,50,44,57,34,23,37,27
Wilmot,543,1,89,2018-10-20T14:00:00Z,False,17,19,2,1,13,9,4,15,8,7,-2,-4
Wilmot,543,1,99,2018-10-27T14:00:00Z,True,17,9,0,0,16,9,7,3,1,2,13,7
Wilmot,543,1,107,2018-11-03T15:00:00Z,False,17,14,0,0,19,12,7,3,0,3,16,7
Wilmot,543,1,119,2018-11-10T15:00:00Z,False,17,15,0,0,19,12,7,7,3,4,12,4
Wilmot,543,1,127,2018-11-24T15:00:00Z,True,17,11,0,0,20,12,8,30,16,14,-10,-2
Wilmot,543,1,135,2018-12-01T15:00:00Z,False,17,10,0,0,20,12,8,18,8,10,2,0
Wilmot,543,1,145,2018-12-04T20:00:00Z,True,17,12,0,0,20,12,8,38,24,14,-18,-2
Wilmot,543,1,155,2018-12-10T20:00:00Z,False,17,7,0,0,20,12,8,23,17,6,-3,-9
Wilmot,543,1,168,2018-12-15T15:00:00Z,True,17,4,0,0,21,12,9,14,13,1,7,11
Wilmot,543,1,178,2018-12-22T15:00:00Z,False,17,18,0,0,24,15,9,24,13,11,0,-4
Wilmot,543,1,189,2018-12-26T19:30:00Z,True,17,5,0,0,27,15,12,37,21,16,-10,-1
Wilmot,543,1,199,2018-12-29T15:00:00Z,True,17,14,0,0,27,15,12,17,7,10,10,5
Wilmot,543,1,201,2019-01-02T19:45:00Z,False,17,1,0,0,28,16,12,26,17,9,2,-5
Wilmot,543,1,214,2019-01-12T15:00:00Z,False,17,6,0,0,29,16,13,22,9,13,7,4
Wilmot,543,1,228,2019-01-19T15:00:00Z,True,17,3,0,0,32,16,16,21,13,8,11,8
Wilmot,543,1,239,2019-01-30T20:00:00Z,False,17,16,24,0,33,17,16,51,18,33,-18,-2
Wilmot,543,1,240,2019-02-02T15:00:00Z,False,17,2,0,0,33,17,16,26,18,8,7,-2
Wilmot,543,1,258,2019-02-09T15:00:00Z,True,17,7,0,0,34,17,17,33,21,12,1,5
Wilmot,543,1,263,2019-02-22T19:45:00Z,False,17,4,0,0,37,20,17,25,17,8,12,0
Wilmot,543,1,276,2019-02-27T20:00:00Z,False,17,11,0,0,40,20,20,66,35,31,-26,-15
Wilmot,543,1,287,2019-03-03T12:00:00Z,True,17,10,0,0,40,20,20,35,17,18,5,2
Wilmot,543,1,297,2019-03-09T17:30:00Z,False,17,12,0,0,43,23,20,71,42,29,-28,-22
Wilmot,543,1,318,2019-03-30T15:00:00Z,False,17,13,0,0,43,23,20,58,29,29,-15,-9
Wilmot,543,1,328,2019-04-02T18:45:00Z,True,17,8,0,0,43,23,20,17,15,2,26,21
Wilmot,543,1,339,2019-04-15T19:00:00Z,True,17,0,0,0,46,26,20,63,44,19,-17,7
Wilmot,543,1,345,2019-04-20T14:00:00Z,False,17,9,0,0,46,26,20,14,8,6,32,12
Wilmot,543,1,307,2019-04-23T18:45:00Z,True,17,15,0,0,49,26,23,36,21,15,13,11
Wilmot,543,1,359,2019-04-27T14:00:00Z,True,17,19,0,0,50,27,23,51,31,20,-1,7
Wilmot,543,1,363,2019-05-05T13:00:00Z,False,17,5,0,0,50,27,23,68,39,29,-18,-16
Wilmot,543,1,379,2019-05-12T14:00:00Z,True,17,18,0,0,50,27,23,49,31,18,1,9
Smith-Rowe,544,2,80,2018-10-22T19:00:00Z,True,0,10,0,0,18,9,9,12,6,6,6,3
Smith-Rowe,544,2,92,2018-10-28T13:30:00Z,False,0,6,0,0,21,12,9,7,1,6,14,8
Smith-Rowe,544,2,100,2018-11-03T17:30:00Z,True,0,11,0,0,22,12,10,26,13,13,-4,-1
Smith-Rowe,544,2,110,2018-11-11T16:30:00Z,True,0,19,0,0,23,13,10,15,8,7,8,6
Smith-Rowe,544,2,120,2018-11-25T13:30:00Z,False,0,1,0,0,24,14,10,20,11,9,4,-1
Smith-Rowe,544,2,130,2018-12-02T14:05:00Z,True,0,16,0,0,27,14,13,30,9,21,-3,-7
Smith-Rowe,544,2,144,2018-12-05T20:00:00Z,False,0,13,0,0,30,17,13,22,11,11,8,2
Smith-Rowe,544,2,150,2018-12-08T15:00:00Z,True,0,9,0,0,31,17,14,10,5,5,21,12
Smith-Rowe,544,2,166,2018-12-16T13:30:00Z,False,0,15,0,0,34,20,14,9,5,4,25,9
Smith-Rowe,544,2,170,2018-12-22T12:30:00Z,True,0,3,0,0,34,20,14,12,7,5,22,15
Smith-Rowe,544,2,180,2018-12-26T17:15:00Z,False,0,2,0,0,37,23,14,21,14,7,16,0
Smith-Rowe,544,2,195,2018-12-29T17:30:00Z,False,0,11,0,0,38,23,15,51,25,26,-13,-10
Smith-Rowe,544,2,200,2019-01-01T15:00:00Z,True,0,8,0,0,38,23,15,14,12,2,24,21
Smith-Rowe,544,2,219,2019-01-12T12:30:00Z,False,0,18,0,0,41,26,15,28,14,14,13,1
Smith-Rowe,544,2,220,2019-01-19T17:30:00Z,True,0,5,0,0,41,26,15,47,25,22,-6,4
Smith-Rowe,544,2,230,2019-01-29T19:45:00Z,True,0,4,0,0,44,29,15,19,14,5,25,24
Smith-Rowe,544,2,247,2019-02-03T16:30:00Z,False,0,12,0,0,47,32,15,56,33,23,-9,-18
Smith-Rowe,544,2,253,2019-02-09T15:00:00Z,False,0,9,0,0,47,32,15,11,5,6,36,10
Smith-Rowe,544,2,260,2019-02-24T14:05:00Z,True,0,15,0,0,50,32,18,24,12,12,26,20
Smith-Rowe,544,2,270,2019-02-27T19:45:00Z,True,0,1,0,0,53,35,18,34,25,9,19,26
Smith-Rowe,544,2,286,2019-03-02T12:30:00Z,False,0,16,0,0,56,38,18,60,27,33,-4,-9
Smith-Rowe,544,2,290,2019-03-10T16:30:00Z,True,0,13,0,0,57,38,19,58,29,29,-1,9
Smith-Rowe,544,2,310,2019-04-01T19:00:00Z,True,0,14,0,0,60,41,19,35,22,13,25,28
Smith-Rowe,544,2,322,2019-04-07T13:05:00Z,False,0,7,0,0,63,44,19,43,25,18,20,-6
Smith-Rowe,544,2,339,2019-04-15T19:00:00Z,False,0,17,0,0,63,44,19,46,26,20,17,-7
Smith-Rowe,544,2,340,2019-04-21T15:00:00Z,True,0,6,0,0,66,44,22,39,16,23,27,21
Smith-Rowe,544,2,309,2019-04-24T18:45:00Z,False,0,19,0,0,66,44,22,48,28,20,18,-6
Smith-Rowe,544,2,354,2019-04-28T11:00:00Z,False,0,10,0,0,66,44,22,48,23,25,18,-1
Smith-Rowe,544,2,360,2019-05-05T15:30:00Z,True,0,2,0,0,66,44,22,35,23,12,31,32
Smith-Rowe,544,2,371,2019-05-12T14:00:00Z,False,0,3,0,0,67,45,22,40,23,17,27,-1
Medley,545,1,80,2018-10-22T19:00:00Z,True,0,10,0,0,18,9,9,12,6,6,6,3
Medley,545,1,92,2018-10-28T13:30:00Z,False,0,6,0,0,21,12,9,7,1,6,14,8
Medley,545,1,100,2018-11-03T17:30:00Z,True,0,11,0,0,22,12,10,26,13,13,-4,-1
Medley,545,1,110,2018-11-11T16:30:00Z,True,0,19,0,0,23,13,10,15,8,7,8,6
Medley,545,1,120,2018-11-25T13:30:00Z,False,0,1,0,0,24,14,10,20,11,9,4,-1
Medley,545,1,130,2018-12-02T14:05:00Z,True,0,16,0,0,27,14,13,30,9,21,-3,-7
Medley,545,1,144,2018-12-05T20:00:00Z,False,0,13,0,0,30,17,13,22,11,11,8,2
Medley,545,1,150,2018-12-08T15:00:00Z,True,0,9,0,0,31,17,14,10,5,5,21,12
Medley,545,1,166,2018-12-16T13:30:00Z,False,0,15,0,0,34,20,14,9,5,4,25,9
Medley,545,1,170,2018-12-22T12:30:00Z,True,0,3,0,0,34,20,14,12,7,5,22,15
Medley,545,1,180,2018-12-26T17:15:00Z,False,0,2,0,0,37,23,14,21,14,7,16,0
Medley,545,1,195,2018-12-29T17:30:00Z,False,0,11,0,0,38,23,15,51,25,26,-13,-10
Medley,545,1,200,2019-01-01T15:00:00Z,True,0,8,0,0,38,23,15,14,12,2,24,21
Medley,545,1,219,2019-01-12T12:30:00Z,False,0,18,0,0,41,26,15,28,14,14,13,1
Medley,545,1,220,2019-01-19T17:30:00Z,True,0,5,0,0,41,26,15,47,25,22,-6,4
Medley,545,1,230,2019-01-29T19:45:00Z,True,0,4,0,0,44,29,15,19,14,5,25,24
Medley,545,1,247,2019-02-03T16:30:00Z,False,0,12,0,0,47,32,15,56,33,23,-9,-18
Medley,545,1,253,2019-02-09T15:00:00Z,False,0,9,0,0,47,32,15,11,5,6,36,10
Medley,545,1,260,2019-02-24T14:05:00Z,True,0,15,0,0,50,32,18,24,12,12,26,20
Medley,545,1,270,2019-02-27T19:45:00Z,True,0,1,0,0,53,35,18,34,25,9,19,26
Medley,545,1,286,2019-03-02T12:30:00Z,False,0,16,0,0,56,38,18,60,27,33,-4,-9
Medley,545,1,290,2019-03-10T16:30:00Z,True,0,13,0,0,57,38,19,58,29,29,-1,9
Medley,545,1,310,2019-04-01T19:00:00Z,True,0,14,0,0,60,41,19,35,22,13,25,28
Medley,545,1,322,2019-04-07T13:05:00Z,False,0,7,0,0,63,44,19,43,25,18,20,-6
Medley,545,1,339,2019-04-15T19:00:00Z,False,0,17,0,0,63,44,19,46,26,20,17,-7
Medley,545,1,340,2019-04-21T15:00:00Z,True,0,6,0,0,66,44,22,39,16,23,27,21
Medley,545,1,309,2019-04-24T18:45:00Z,False,0,19,0,0,66,44,22,48,28,20,18,-6
Medley,545,1,354,2019-04-28T11:00:00Z,False,0,10,0,0,66,44,22,48,23,25,18,-1
Medley,545,1,360,2019-05-05T15:30:00Z,True,0,2,0,0,66,44,22,35,23,12,31,32
Medley,545,1,371,2019-05-12T14:00:00Z,False,0,3,0,0,67,45,22,40,23,17,27,-1
Powell,546,2,94,2018-10-27T16:30:00Z,False,18,10,0,0,7,4,3,12,6,6,-5,-3
Powell,546,2,108,2018-11-03T15:00:00Z,True,18,3,0,0,8,4,4,8,4,4,0,0
Powell,546,2,114,2018-11-10T15:00:00Z,False,18,9,0,0,11,7,4,6,4,2,5,0
Powell,546,2,128,2018-11-24T15:00:00Z,True,18,12,0,0,12,7,5,32,21,11,-20,-4
Powell,546,2,138,2018-12-01T15:00:00Z,False,18,14,0,0,12,7,5,12,6,6,0,-1
Powell,546,2,146,2018-12-04T19:45:00Z,True,18,4,0,0,15,7,8,11,10,1,4,6
Powell,546,2,159,2018-12-08T15:00:00Z,True,18,6,0,0,18,10,8,12,5,7,6,3
Powell,546,2,162,2018-12-15T17:30:00Z,False,18,8,0,0,21,13,8,9,8,1,12,0
Powell,546,2,178,2018-12-22T15:00:00Z,True,18,17,0,0,24,13,11,24,15,9,0,4
Powell,546,2,187,2018-12-27T19:45:00Z,False,18,15,0,0,24,13,11,15,8,7,9,3
Powell,546,2,191,2018-12-30T14:15:00Z,False,18,3,0,0,27,13,14,12,7,5,15,7
Powell,546,2,208,2019-01-02T19:45:00Z,True,18,2,0,0,27,13,14,25,18,7,2,6
Powell,546,2,219,2019-01-12T12:30:00Z,True,18,0,0,0,28,14,14,41,26,15,-13,-1
Powell,546,2,221,2019-01-19T15:00:00Z,False,18,1,0,0,31,17,14,27,18,9,4,-4
Powell,546,2,235,2019-01-29T19:45:00Z,False,18,19,0,0,31,17,14,32,17,15,-1,-3
Powell,546,2,249,2019-02-04T20:00:00Z,True,18,11,0,0,31,17,14,61,32,29,-30,-12
Powell,546,2,251,2019-02-09T15:00:00Z,False,18,6,0,0,32,18,14,26,12,14,6,2
Powell,546,2,269,2019-02-22T19:45:00Z,True,18,8,0,0,33,18,15,17,15,2,16,16
Powell,546,2,277,2019-02-27T20:00:00Z,False,18,12,0,0,36,21,15,65,39,26,-29,-24
Powell,546,2,288,2019-03-02T17:30:00Z,True,18,14,0,0,36,21,15,31,19,12,5,9
Powell,546,2,291,2019-03-09T15:00:00Z,False,18,4,0,0,39,24,15,25,17,8,14,-2
Powell,546,2,308,2019-03-16T15:00:00Z,True,18,9,0,0,39,24,15,14,8,6,25,18
Powell,546,2,319,2019-03-30T17:30:00Z,True,18,7,0,0,42,27,15,40,25,15,2,12
Powell,546,2,321,2019-04-08T19:00:00Z,False,18,5,0,0,42,27,15,63,35,28,-21,-20
Powell,546,2,336,2019-04-13T16:30:00Z,False,18,13,0,0,42,27,15,61,32,29,-19,-17
Powell,546,2,348,2019-04-20T14:00:00Z,True,18,10,0,0,42,27,15,47,23,24,-5,3
Powell,546,2,358,2019-04-27T11:30:00Z,False,18,16,0,0,43,28,15,70,37,33,-27,-22
Powell,546,2,368,2019-05-04T14:00:00Z,True,18,15,0,0,46,28,18,38,22,16,8,12
Powell,546,2,379,2019-05-12T14:00:00Z,False,18,17,0,0,49,31,18,50,27,23,-1,-9
Coventry,547,2,94,2018-10-27T16:30:00Z,False,18,10,0,0,7,4,3,12,6,6,-5,-3
Coventry,547,2,108,2018-11-03T15:00:00Z,True,18,3,0,0,8,4,4,8,4,4,0,0
Coventry,547,2,114,2018-11-10T15:00:00Z,False,18,9,0,0,11,7,4,6,4,2,5,0
Coventry,547,2,128,2018-11-24T15:00:00Z,True,18,12,0,0,12,7,5,32,21,11,-20,-4
Coventry,547,2,138,2018-12-01T15:00:00Z,False,18,14,0,0,12,7,5,12,6,6,0,-1
Coventry,547,2,146,2018-12-04T19:45:00Z,True,18,4,0,0,15,7,8,11,10,1,4,6
Coventry,547,2,159,2018-12-08T15:00:00Z,True,18,6,0,0,18,10,8,12,5,7,6,3
Coventry,547,2,162,2018-12-15T17:30:00Z,False,18,8,0,0,21,13,8,9,8,1,12,0
Coventry,547,2,178,2018-12-22T15:00:00Z,True,18,17,0,0,24,13,11,24,15,9,0,4
Coventry,547,2,187,2018-12-27T19:45:00Z,False,18,15,0,0,24,13,11,15,8,7,9,3
Coventry,547,2,191,2018-12-30T14:15:00Z,False,18,3,0,0,27,13,14,12,7,5,15,7
Coventry,547,2,208,2019-01-02T19:45:00Z,True,18,2,0,0,27,13,14,25,18,7,2,6
Coventry,547,2,219,2019-01-12T12:30:00Z,True,18,0,0,0,28,14,14,41,26,15,-13,-1
Coventry,547,2,221,2019-01-19T15:00:00Z,False,18,1,0,0,31,17,14,27,18,9,4,-4
Coventry,547,2,235,2019-01-29T19:45:00Z,False,18,19,0,0,31,17,14,32,17,15,-1,-3
Coventry,547,2,249,2019-02-04T20:00:00Z,True,18,11,0,0,31,17,14,61,32,29,-30,-12
Coventry,547,2,251,2019-02-09T15:00:00Z,False,18,6,0,0,32,18,14,26,12,14,6,2
Coventry,547,2,269,2019-02-22T19:45:00Z,True,18,8,0,0,33,18,15,17,15,2,16,16
Coventry,547,2,277,2019-02-27T20:00:00Z,False,18,12,0,0,36,21,15,65,39,26,-29,-24
Coventry,547,2,288,2019-03-02T17:30:00Z,True,18,14,0,0,36,21,15,31,19,12,5,9
Coventry,547,2,291,2019-03-09T15:00:00Z,False,18,4,0,0,39,24,15,25,17,8,14,-2
Coventry,547,2,308,2019-03-16T15:00:00Z,True,18,9,0,0,39,24,15,14,8,6,25,18
Coventry,547,2,319,2019-03-30T17:30:00Z,True,18,7,0,0,42,27,15,40,25,15,2,12
Coventry,547,2,321,2019-04-08T19:00:00Z,False,18,5,0,0,42,27,15,63,35,28,-21,-20
Coventry,547,2,336,2019-04-13T16:30:00Z,False,18,13,0,0,42,27,15,61,32,29,-19,-17
Coventry,547,2,348,2019-04-20T14:00:00Z,True,18,10,0,0,42,27,15,47,23,24,-5,3
Coventry,547,2,358,2019-04-27T11:30:00Z,False,18,16,0,0,43,28,15,70,37,33,-27,-22
Coventry,547,2,368,2019-05-04T14:00:00Z,True,18,15,0,0,46,28,18,38,22,16,8,12
Coventry,547,2,379,2019-05-12T14:00:00Z,False,18,17,0,0,49,31,18,50,27,23,-1,-9
Foyth,548,1,109,2018-11-03T19:45:00Z,False,16,19,90,0,21,6,15,15,8,7,6,7
Foyth,548,1,113,2018-11-10T17:30:00Z,False,16,6,90,15,24,6,18,8,2,6,16,16
Foyth,548,1,126,2018-11-24T17:30:00Z,True,16,5,90,2,27,6,21,28,15,13,-1,-7
Foyth,548,1,130,2018-12-02T14:05:00Z,False,16,0,90,0,30,9,21,27,14,13,3,7
Foyth,548,1,149,2018-12-05T20:00:00Z,True,16,15,90,2,30,9,21,9,5,4,21,5
Foyth,548,1,156,2018-12-08T19:45:00Z,False,16,10,0,0,33,12,21,22,11,11,11,10
Foyth,548,1,167,2018-12-15T15:00:00Z,True,16,3,0,0,36,12,24,12,7,5,24,7
Foyth,548,1,174,2018-12-23T16:00:00Z,False,16,7,0,0,39,15,24,24,18,6,15,6
Foyth,548,1,188,2018-12-26T15:00:00Z,True,16,1,90,6,42,15,27,26,17,9,16,6
Foyth,548,1,198,2018-12-29T15:00:00Z,True,16,19,0,0,45,18,27,26,14,12,19,6
Foyth,548,1,202,2019-01-01T17:30:00Z,False,16,4,0,0,45,18,27,18,13,5,27,14
Foyth,548,1,218,2019-01-13T16:30:00Z,True,16,13,0,0,48,18,30,38,21,17,10,1
Foyth,548,1,222,2019-01-20T16:00:00Z,False,16,8,0,0,48,18,30,14,12,2,34,18
Foyth,548,1,239,2019-01-30T20:00:00Z,True,16,17,0,0,51,18,33,33,17,16,18,2
Foyth,548,1,248,2019-02-02T12:30:00Z,True,16,14,0,0,54,21,33,24,13,11,30,10
Foyth,548,1,257,2019-02-10T13:30:00Z,True,16,10,0,0,57,24,33,32,14,18,25,6
Foyth,548,1,262,2019-02-23T12:30:00Z,False,16,3,75,1,60,27,33,27,14,13,33,19
Foyth,548,1,275,2019-02-27T20:00:00Z,False,16,5,0,0,60,27,33,50,28,22,10,5
Foyth,548,1,286,2019-03-02T12:30:00Z,True,16,0,0,0,60,27,33,56,38,18,4,9
Foyth,548,1,299,2019-03-09T15:00:00Z,False,16,15,0,0,61,28,33,27,15,12,34,18
Foyth,548,1,317,2019-03-31T15:30:00Z,False,16,11,0,0,61,28,33,76,41,35,-15,-8
Foyth,548,1,306,2019-04-03T18:45:00Z,True,16,6,0,0,61,28,33,36,16,20,25,8
Foyth,548,1,338,2019-04-13T11:30:00Z,True,16,9,90,5,64,31,33,14,8,6,50,25
Foyth,548,1,346,2019-04-20T11:30:00Z,False,16,12,90,2,67,34,33,83,48,35,-16,-15
Foyth,548,1,327,2019-04-23T18:45:00Z,True,16,2,1,1,67,34,33,34,22,12,33,22
Foyth,548,1,358,2019-04-27T11:30:00Z,True,16,18,90,3,70,37,33,43,28,15,27,22
Foyth,548,1,361,2019-05-04T11:30:00Z,False,16,1,2,-2,70,37,33,42,26,16,28,7
Foyth,548,1,378,2019-05-12T14:00:00Z,True,16,7,0,0,70,37,33,53,34,19,17,18
Obafemi,549,3,106,2018-11-04T15:00:00Z,False,15,12,17,1,7,3,4,26,15,11,-19,-11
Obafemi,549,3,119,2018-11-10T15:00:00Z,True,15,17,1,1,7,3,4,19,12,7,-12,-4
Obafemi,549,3,124,2018-11-24T15:00:00Z,False,15,8,9,0,8,4,4,5,4,1,3,0
Obafemi,549,3,139,2018-12-01T17:30:00Z,True,15,13,63,5,8,4,4,21,11,10,-13,-6
Obafemi,549,3,149,2018-12-05T20:00:00Z,False,15,16,0,0,9,5,4,30,9,21,-21,-5
Obafemi,549,3,153,2018-12-08T15:00:00Z,False,15,4,0,0,9,5,4,11,10,1,-2,-6
Obafemi,549,3,166,2018-12-16T13:30:00Z,True,15,0,0,0,9,5,4,34,20,14,-25,-9
Obafemi,549,3,175,2018-12-22T15:00:00Z,False,15,9,25,5,12,8,4,10,5,5,2,-1
Obafemi,549,3,187,2018-12-27T19:45:00Z,True,15,18,0,0,15,8,7,24,13,11,-9,-3
Obafemi,549,3,197,2018-12-30T14:15:00Z,True,15,12,0,0,15,8,7,44,27,17,-29,-9
Obafemi,549,3,203,2019-01-02T19:45:00Z,False,15,5,0,0,15,8,7,43,21,22,-28,-14
Obafemi,549,3,216,2019-01-12T15:00:00Z,False,15,10,0,0,16,8,8,31,14,17,-15,-6
Obafemi,549,3,227,2019-01-19T15:00:00Z,True,15,7,0,0,19,8,11,30,21,9,-11,-1
Obafemi,549,3,238,2019-01-30T19:45:00Z,True,15,6,0,0,22,11,11,22,9,13,0,-2
Obafemi,549,3,241,2019-02-02T15:00:00Z,False,15,3,0,0,23,12,11,23,13,10,0,-2
Obafemi,549,3,256,2019-02-09T15:00:00Z,True,15,4,0,0,24,12,12,22,17,5,2,7
Obafemi,549,3,260,2019-02-24T14:05:00Z,False,15,0,19,1,24,12,12,50,32,18,-26,-20
Obafemi,549,3,279,2019-02-27T19:45:00Z,True,15,8,0,0,24,12,12,17,15,2,7,10
Obafemi,549,3,285,2019-03-02T15:00:00Z,False,15,13,0,0,27,15,12,55,26,29,-28,-14
Obafemi,549,3,299,2019-03-09T15:00:00Z,True,15,16,0,0,27,15,12,61,28,33,-34,-18
Obafemi,549,3,311,2019-03-30T15:00:00Z,False,15,2,0,0,30,18,12,33,22,11,-3,-10
Obafemi,549,3,326,2019-04-05T19:00:00Z,True,15,11,0,0,33,18,15,79,44,35,-46,-17
Obafemi,549,3,337,2019-04-13T14:00:00Z,True,15,19,0,0,33,18,15,47,27,20,-14,-2
Obafemi,549,3,347,2019-04-20T16:30:00Z,False,15,14,0,0,36,21,15,38,22,16,-2,-7
Obafemi,549,3,307,2019-04-23T18:45:00Z,False,15,17,0,0,36,21,15,49,26,23,-13,-11
Obafemi,549,3,357,2019-04-27T14:00:00Z,True,15,1,0,0,37,21,16,41,26,15,-4,6
Obafemi,549,3,368,2019-05-04T14:00:00Z,False,15,18,0,0,38,22,16,46,28,18,-8,-12
Obafemi,549,3,377,2019-05-12T14:00:00Z,True,15,9,0,0,38,22,16,15,9,6,23,16
Gyokeres,550,3,111,2018-11-10T12:30:00Z,False,2,4,0,0,14,10,4,5,4,1,9,0
Gyokeres,550,3,121,2018-11-24T15:00:00Z,True,2,10,0,0,14,10,4,17,8,9,-3,1
Gyokeres,550,3,134,2018-12-01T15:00:00Z,False,2,9,0,0,15,11,4,10,5,5,5,-1
Gyokeres,550,3,141,2018-12-04T19:45:00Z,True,2,6,0,0,18,11,7,12,5,7,6,4
Gyokeres,550,3,152,2018-12-08T15:00:00Z,False,2,3,0,0,21,14,7,9,4,5,12,3
Gyokeres,550,3,160,2018-12-16T13:30:00Z,True,2,5,0,0,21,14,7,34,21,13,-13,1
Gyokeres,550,3,171,2018-12-22T15:00:00Z,False,2,1,0,0,21,14,7,23,14,9,-2,-7
Gyokeres,550,3,180,2018-12-26T17:15:00Z,True,2,0,0,0,21,14,7,37,23,14,-16,0
Gyokeres,550,3,190,2018-12-29T15:00:00Z,True,2,7,0,0,22,15,7,27,18,9,-5,6
Gyokeres,550,3,208,2019-01-02T19:45:00Z,False,2,18,0,0,25,18,7,27,13,14,-2,-6
Gyokeres,550,3,210,2019-01-12T15:00:00Z,True,2,11,0,0,26,18,8,54,28,26,-28,-8
Gyokeres,550,3,225,2019-01-19T15:00:00Z,False,2,13,0,0,26,18,8,41,21,20,-15,-13
Gyokeres,550,3,232,2019-01-29T19:45:00Z,False,2,8,0,0,26,18,8,14,12,2,12,-4
Gyokeres,550,3,240,2019-02-02T15:00:00Z,True,2,17,0,0,26,18,8,33,17,16,-7,2
Gyokeres,550,3,250,2019-02-09T17:30:00Z,True,2,3,0,0,27,19,8,24,14,10,3,9
Gyokeres,550,3,274,2019-02-26T19:45:00Z,False,2,10,0,0,27,19,8,32,14,18,-5,-6
Gyokeres,550,3,281,2019-03-02T15:00:00Z,True,2,9,0,0,27,19,8,14,8,6,13,13
Gyokeres,550,3,293,2019-03-09T12:30:00Z,False,2,6,0,0,30,22,8,33,13,20,-3,-5
Gyokeres,550,3,311,2019-03-30T15:00:00Z,True,2,15,0,0,33,22,11,30,18,12,3,10
Gyokeres,550,3,264,2019-04-03T18:45:00Z,False,2,5,0,0,33,22,11,60,32,28,-27,-21
Gyokeres,550,3,330,2019-04-13T14:00:00Z,True,2,1,0,0,33,22,11,38,26,12,-5,10
Gyokeres,550,3,301,2019-04-16T18:45:00Z,True,2,4,0,0,33,22,11,28,20,8,5,14
Gyokeres,550,3,349,2019-04-20T14:00:00Z,False,2,19,0,0,33,22,11,47,27,20,-14,-16
Gyokeres,550,3,327,2019-04-23T18:45:00Z,False,2,16,0,0,34,22,12,67,34,33,-33,-22
Gyokeres,550,3,350,2019-04-27T16:30:00Z,True,2,14,0,0,34,22,12,41,25,16,-7,6
Gyokeres,550,3,360,2019-05-05T15:30:00Z,False,2,0,0,0,35,23,12,66,44,22,-31,-32
Gyokeres,550,3,370,2019-05-12T14:00:00Z,True,2,12,0,0,36,23,13,95,54,41,-59,-18
Nketiah,551,3,110,2018-11-11T16:30:00Z,True,0,19,0,0,23,13,10,15,8,7,8,6
Nketiah,551,3,120,2018-11-25T13:30:00Z,False,0,1,1,1,24,14,10,20,11,9,4,-1
Nketiah,551,3,130,2018-12-02T14:05:00Z,True,0,16,0,0,27,14,13,30,9,21,-3,-7
Nketiah,551,3,144,2018-12-05T20:00:00Z,False,0,13,0,0,30,17,13,22,11,11,8,2
Nketiah,551,3,150,2018-12-08T15:00:00Z,True,0,9,0,0,31,17,14,10,5,5,21,12
Nketiah,551,3,166,2018-12-16T13:30:00Z,False,0,15,0,0,34,20,14,9,5,4,25,9
Nketiah,551,3,170,2018-12-22T12:30:00Z,True,0,3,0,0,34,20,14,12,7,5,22,15
Nketiah,551,3,180,2018-12-26T17:15:00Z,False,0,2,0,0,37,23,14,21,14,7,16,0
Nketiah,551,3,195,2018-12-29T17:30:00Z,False,0,11,0,0,38,23,15,51,25,26,-13,-10
Nketiah,551,3,200,2019-01-01T15:00:00Z,True,0,8,0,0,38,23,15,14,12,2,24,21
Nketiah,551,3,219,2019-01-12T12:30:00Z,False,0,18,0,0,41,26,15,28,14,14,13,1
Nketiah,551,3,220,2019-01-19T17:30:00Z,True,0,5,0,0,41,26,15,47,25,22,-6,4
Nketiah,551,3,230,2019-01-29T19:45:00Z,True,0,4,0,0,44,29,15,19,14,5,25,24
Nketiah,551,3,247,2019-02-03T16:30:00Z,False,0,12,0,0,47,32,15,56,33,23,-9,-18
Nketiah,551,3,253,2019-02-09T15:00:00Z,False,0,9,0,0,47,32,15,11,5,6,36,10
Nketiah,551,3,260,2019-02-24T14:05:00Z,True,0,15,0,0,50,32,18,24,12,12,26,20
Nketiah,551,3,270,2019-02-27T19:45:00Z,True,0,1,0,0,53,35,18,34,25,9,19,26
Nketiah,551,3,286,2019-03-02T12:30:00Z,False,0,16,0,0,56,38,18,60,27,33,-4,-9
Nketiah,551,3,290,2019-03-10T16:30:00Z,True,0,13,4,1,57,38,19,58,29,29,-1,9
Nketiah,551,3,310,2019-04-01T19:00:00Z,True,0,14,0,0,60,41,19,35,22,13,25,28
Nketiah,551,3,322,2019-04-07T13:05:00Z,False,0,7,0,0,63,44,19,43,25,18,20,-6
Nketiah,551,3,339,2019-04-15T19:00:00Z,False,0,17,0,0,63,44,19,46,26,20,17,-7
Nketiah,551,3,340,2019-04-21T15:00:00Z,True,0,6,0,0,66,44,22,39,16,23,27,21
Nketiah,551,3,309,2019-04-24T18:45:00Z,False,0,19,19,1,66,44,22,48,28,20,18,-6
Nketiah,551,3,354,2019-04-28T11:00:00Z,False,0,10,11,1,66,44,22,48,23,25,18,-1
Nketiah,551,3,360,2019-05-05T15:30:00Z,True,0,2,0,0,66,44,22,35,23,12,31,32
Nketiah,551,3,371,2019-05-12T14:00:00Z,False,0,3,28,6,67,45,22,40,23,17,27,-1
Woodman,552,0,122,2018-11-26T20:30:00Z,False,14,3,0,0,9,6,3,9,4,5,0,-1
Woodman,552,0,138,2018-12-01T15:00:00Z,True,14,18,0,0,12,6,6,12,7,5,0,1
Woodman,552,0,148,2018-12-05T19:45:00Z,False,14,7,0,0,12,6,6,22,16,6,-10,-10
Woodman,552,0,158,2018-12-09T16:00:00Z,True,14,19,0,0,13,6,7,19,11,8,-6,-2
Woodman,552,0,163,2018-12-15T15:00:00Z,False,14,9,0,0,13,6,7,10,5,5,3,2
Woodman,552,0,177,2018-12-22T15:00:00Z,True,14,8,0,0,16,6,10,9,8,1,7,5
Woodman,552,0,185,2018-12-26T15:00:00Z,False,14,11,0,0,17,7,10,48,22,26,-31,-12
Woodman,552,0,199,2018-12-29T15:00:00Z,False,14,17,0,0,17,7,10,27,15,12,-10,-5
Woodman,552,0,207,2019-01-02T20:00:00Z,True,14,13,0,0,18,7,11,35,21,14,-17,-7
Woodman,552,0,213,2019-01-12T17:30:00Z,False,14,5,0,0,18,7,11,44,22,22,-26,-11
Woodman,552,0,226,2019-01-19T15:00:00Z,True,14,4,0,0,18,7,11,19,14,5,-1,2
Woodman,552,0,237,2019-01-29T20:00:00Z,True,14,12,0,0,21,10,11,56,33,23,-35,-13
Woodman,552,0,248,2019-02-02T12:30:00Z,False,14,16,0,0,24,13,11,54,21,33,-30,-10
Woodman,552,0,259,2019-02-11T20:00:00Z,False,14,19,0,0,24,13,11,38,20,18,-14,-9
Woodman,552,0,268,2019-02-23T15:00:00Z,True,14,9,0,0,25,13,12,11,5,6,14,7
Woodman,552,0,278,2019-02-26T20:00:00Z,True,14,3,0,0,28,16,12,30,17,13,-2,3
Woodman,552,0,288,2019-03-02T17:30:00Z,False,14,18,0,0,31,19,12,36,21,15,-5,-9
Woodman,552,0,298,2019-03-09T15:00:00Z,True,14,7,0,0,31,19,12,37,22,15,-6,4
Woodman,552,0,300,2019-03-16T15:00:00Z,False,14,1,0,0,34,22,12,37,25,12,-3,-13
Woodman,552,0,310,2019-04-01T19:00:00Z,False,14,0,0,0,35,22,13,60,41,19,-25,-28
Woodman,552,0,325,2019-04-06T14:00:00Z,True,14,6,0,0,35,22,13,36,16,20,-1,2
Woodman,552,0,334,2019-04-12T19:00:00Z,False,14,10,0,0,35,22,13,47,23,24,-12,-10
Woodman,552,0,347,2019-04-20T16:30:00Z,True,14,15,0,0,38,22,16,36,21,15,2,7
Woodman,552,0,350,2019-04-27T16:30:00Z,False,14,2,0,0,41,25,16,34,22,12,7,-6
Woodman,552,0,367,2019-05-04T18:45:00Z,True,14,11,0,0,42,25,17,91,50,41,-49,-16
Woodman,552,0,373,2019-05-12T14:00:00Z,False,14,8,0,0,42,25,17,26,21,5,16,-4
Penaranda,553,3,135,2018-12-01T15:00:00Z,False,17,10,0,0,20,12,8,18,8,10,2,0
Penaranda,553,3,145,2018-12-04T20:00:00Z,True,17,12,0,0,20,12,8,38,24,14,-18,-2
Penaranda,553,3,155,2018-12-10T20:00:00Z,False,17,7,0,0,20,12,8,23,17,6,-3,-9
Penaranda,553,3,168,2018-12-15T15:00:00Z,True,17,4,0,0,21,12,9,14,13,1,7,11
Penaranda,553,3,178,2018-12-22T15:00:00Z,False,17,18,0,0,24,15,9,24,13,11,0,-4
Penaranda,553,3,189,2018-12-26T19:30:00Z,True,17,5,0,0,27,15,12,37,21,16,-10,-1
Penaranda,553,3,199,2018-12-29T15:00:00Z,True,17,14,0,0,27,15,12,17,7,10,10,5
Penaranda,553,3,201,2019-01-02T19:45:00Z,False,17,1,0,0,28,16,12,26,17,9,2,-5
Penaranda,553,3,214,2019-01-12T15:00:00Z,False,17,6,0,0,29,16,13,22,9,13,7,4
Penaranda,553,3,228,2019-01-19T15:00:00Z,True,17,3,0,0,32,16,16,21,13,8,11,8
Penaranda,553,3,239,2019-01-30T20:00:00Z,False,17,16,0,0,33,17,16,51,18,33,-18,-2
Penaranda,553,3,240,2019-02-02T15:00:00Z,False,17,2,0,0,33,17,16,26,18,8,7,-2
Penaranda,553,3,258,2019-02-09T15:00:00Z,True,17,7,0,0,34,17,17,33,21,12,1,5
Penaranda,553,3,263,2019-02-22T19:45:00Z,False,17,4,0,0,37,20,17,25,17,8,12,0
Penaranda,553,3,276,2019-02-27T20:00:00Z,False,17,11,0,0,40,20,20,66,35,31,-26,-15
Penaranda,553,3,287,2019-03-03T12:00:00Z,True,17,10,0,0,40,20,20,35,17,18,5,2
Penaranda,553,3,297,2019-03-09T17:30:00Z,False,17,12,0,0,43,23,20,71,42,29,-28,-22
Penaranda,553,3,318,2019-03-30T15:00:00Z,False,17,13,0,0,43,23,20,58,29,29,-15,-9
Penaranda,553,3,328,2019-04-02T18:45:00Z,True,17,8,0,0,43,23,20,17,15,2,26,21
Penaranda,553,3,339,2019-04-15T19:00:00Z,True,17,0,0,0,46,26,20,63,44,19,-17,7
Penaranda,553,3,345,2019-04-20T14:00:00Z,False,17,9,0,0,46,26,20,14,8,6,32,12
Penaranda,553,3,307,2019-04-23T18:45:00Z,True,17,15,0,0,49,26,23,36,21,15,13,11
Penaranda,553,3,359,2019-04-27T14:00:00Z,True,17,19,0,0,50,27,23,51,31,20,-1,7
Penaranda,553,3,363,2019-05-05T13:00:00Z,False,17,5,0,0,50,27,23,68,39,29,-18,-16
Penaranda,553,3,379,2019-05-12T14:00:00Z,True,17,18,0,0,50,27,23,49,31,18,1,9
Giles,554,2,131,2018-11-30T20:00:00Z,False,19,4,0,0,16,8,8,8,7,1,8,1
Giles,554,2,147,2018-12-05T19:45:00Z,True,19,5,0,0,16,8,8,31,18,13,-15,-5
Giles,554,2,158,2018-12-09T16:00:00Z,False,19,14,0,0,19,11,8,13,6,7,6,2
Giles,554,2,169,2018-12-15T15:00:00Z,True,19,1,0,0,22,11,11,23,14,9,-1,2
Giles,554,2,179,2018-12-21T20:00:00Z,True,19,11,0,0,25,14,11,45,22,23,-20,-9
Giles,554,2,183,2018-12-26T12:30:00Z,False,19,8,0,0,25,14,11,10,8,2,15,3
Giles,554,2,198,2018-12-29T15:00:00Z,False,19,16,0,0,26,14,12,45,18,27,-19,-6
Giles,554,2,209,2019-01-02T19:45:00Z,True,19,6,0,0,29,14,15,19,9,10,10,4
Giles,554,2,217,2019-01-14T20:00:00Z,False,19,12,0,0,29,14,15,50,30,20,-21,-15
Giles,554,2,229,2019-01-19T12:30:00Z,True,19,10,0,0,29,14,15,31,14,17,-2,-3
Giles,554,2,235,2019-01-29T19:45:00Z,True,19,18,0,0,32,17,15,31,17,14,1,3
Giles,554,2,245,2019-02-02T15:00:00Z,False,19,7,0,0,35,20,15,33,21,12,2,-6
Giles,554,2,259,2019-02-11T20:00:00Z,True,19,14,0,0,38,20,18,24,13,11,14,9
Giles,554,2,261,2019-02-23T15:00:00Z,False,19,1,0,0,39,21,18,33,24,9,6,-6
Giles,554,2,273,2019-02-26T19:45:00Z,False,19,9,0,0,40,21,19,11,5,6,29,14
Giles,554,2,289,2019-03-02T15:00:00Z,True,19,4,0,0,40,21,19,25,17,8,15,13
Giles,554,2,292,2019-03-10T14:05:00Z,False,19,5,0,0,43,24,19,56,31,25,-13,-12
Giles,554,2,312,2019-03-30T15:00:00Z,False,19,3,0,0,44,24,20,30,17,13,14,3
Giles,554,2,329,2019-04-02T18:45:00Z,True,19,13,0,0,44,24,20,61,32,29,-17,-5
Giles,554,2,337,2019-04-13T14:00:00Z,False,19,15,0,0,47,27,20,33,18,15,14,2
Giles,554,2,349,2019-04-20T14:00:00Z,True,19,2,0,0,47,27,20,33,22,11,14,16
Giles,554,2,309,2019-04-24T18:45:00Z,True,19,0,0,0,48,28,20,66,44,22,-18,6
Giles,554,2,359,2019-04-27T14:00:00Z,False,19,17,0,0,51,31,20,50,27,23,1,-7
Giles,554,2,369,2019-05-04T14:00:00Z,True,19,8,0,0,54,31,23,26,21,5,28,26
Giles,554,2,375,2019-05-12T14:00:00Z,False,19,11,0,0,57,34,23,94,50,44,-37,-27
Valery,555,1,139,2018-12-01T17:30:00Z,True,15,13,90,1,8,4,4,21,11,10,-13,-6
Valery,555,1,149,2018-12-05T20:00:00Z,False,15,16,0,0,9,5,4,30,9,21,-21,-5
Valery,555,1,153,2018-12-08T15:00:00Z,False,15,4,45,0,9,5,4,11,10,1,-2,-6
Valery,555,1,166,2018-12-16T13:30:00Z,True,15,0,90,1,9,5,4,34,20,14,-25,-9
Valery,555,1,175,2018-12-22T15:00:00Z,False,15,9,78,1,12,8,4,10,5,5,2,-1
Valery,555,1,187,2018-12-27T19:45:00Z,True,15,18,90,1,15,8,7,24,13,11,-9,-3
Valery,555,1,197,2018-12-30T14:15:00Z,True,15,12,31,1,15,8,7,44,27,17,-29,-9
Valery,555,1,203,2019-01-02T19:45:00Z,False,15,5,90,6,15,8,7,43,21,22,-28,-14
Valery,555,1,216,2019-01-12T15:00:00Z,False,15,10,44,-2,16,8,8,31,14,17,-15,-6
Valery,555,1,227,2019-01-19T15:00:00Z,True,15,7,90,2,19,8,11,30,21,9,-11,-1
Valery,555,1,238,2019-01-30T19:45:00Z,True,15,6,61,2,22,11,11,22,9,13,0,-2
Valery,555,1,241,2019-02-02T15:00:00Z,False,15,3,13,1,23,12,11,23,13,10,0,-2
Valery,555,1,256,2019-02-09T15:00:00Z,True,15,4,82,2,24,12,12,22,17,5,2,7
Valery,555,1,260,2019-02-24T14:05:00Z,False,15,0,90,1,24,12,12,50,32,18,-26,-20
Valery,555,1,279,2019-02-27T19:45:00Z,True,15,8,90,6,24,12,12,17,15,2,7,10
Valery,555,1,285,2019-03-02T15:00:00Z,False,15,13,90,7,27,15,12,55,26,29,-28,-14
Valery,555,1,299,2019-03-09T15:00:00Z,True,15,16,90,7,27,15,12,61,28,33,-34,-18
Valery,555,1,311,2019-03-30T15:00:00Z,False,15,2,90,6,30,18,12,33,22,11,-3,-10
Valery,555,1,326,2019-04-05T19:00:00Z,True,15,11,90,1,33,18,15,79,44,35,-46,-17
Valery,555,1,337,2019-04-13T14:00:00Z,True,15,19,83,2,33,18,15,47,27,20,-14,-2
Valery,555,1,347,2019-04-20T16:30:00Z,False,15,14,0,0,36,21,15,38,22,16,-2,-7
Valery,555,1,307,2019-04-23T18:45:00Z,False,15,17,12,1,36,21,15,49,26,23,-13,-11
Valery,555,1,357,2019-04-27T14:00:00Z,True,15,1,90,4,37,21,16,41,26,15,-4,6
Valery,555,1,368,2019-05-04T14:00:00Z,False,15,18,90,1,38,22,16,46,28,18,-8,-12
Valery,555,1,377,2019-05-12T14:00:00Z,True,15,9,90,2,38,22,16,15,9,6,23,16
Camacho,556,2,142,2018-12-05T19:45:00Z,False,11,3,0,0,36,19,17,9,4,5,27,13
Camacho,556,2,151,2018-12-08T12:30:00Z,False,11,1,0,0,39,19,20,23,14,9,16,6
Camacho,556,2,164,2018-12-16T16:00:00Z,True,11,13,0,0,42,19,23,26,15,11,16,8
Camacho,556,2,179,2018-12-21T20:00:00Z,False,11,19,0,0,45,22,23,25,14,11,20,9
Camacho,556,2,185,2018-12-26T15:00:00Z,True,11,14,0,0,48,22,26,17,7,10,31,12
Camacho,556,2,195,2018-12-29T17:30:00Z,True,11,0,0,0,51,25,26,38,23,15,13,10
Camacho,556,2,206,2019-01-03T20:00:00Z,False,11,12,0,0,54,28,26,47,27,20,7,-1
Camacho,556,2,210,2019-01-12T15:00:00Z,False,11,2,0,0,54,28,26,26,18,8,28,8
Camacho,556,2,224,2019-01-19T15:00:00Z,True,11,6,1,1,57,28,29,22,9,13,35,15
Camacho,556,2,236,2019-01-30T20:00:00Z,True,11,10,0,0,60,31,29,31,14,17,29,14
Camacho,556,2,249,2019-02-04T20:00:00Z,False,11,18,0,0,61,32,29,31,17,14,30,12
Camacho,556,2,254,2019-02-09T15:00:00Z,True,11,1,0,0,62,32,30,33,24,9,29,23
Camacho,556,2,267,2019-02-24T14:05:00Z,False,11,13,0,0,65,35,30,51,25,26,14,5
Camacho,556,2,276,2019-02-27T20:00:00Z,True,11,17,0,0,66,35,31,40,20,20,26,15
Camacho,556,2,283,2019-03-03T16:15:00Z,False,11,7,0,0,69,38,31,36,21,15,33,10
Camacho,556,2,296,2019-03-10T12:00:00Z,True,11,3,0,0,70,38,32,30,17,13,40,25
Camacho,556,2,304,2019-03-17T14:15:00Z,False,11,8,0,0,73,41,32,17,15,2,56,17
Camacho,556,2,317,2019-03-31T15:30:00Z,True,11,16,0,0,76,41,35,61,28,33,15,8
Camacho,556,2,326,2019-04-05T19:00:00Z,False,11,15,0,0,79,44,35,33,18,15,46,17
Camacho,556,2,335,2019-04-14T15:30:00Z,True,11,5,0,0,82,44,38,66,38,28,16,16
Camacho,556,2,342,2019-04-21T15:00:00Z,False,11,4,0,0,85,47,38,31,20,11,54,18
Camacho,556,2,355,2019-04-26T19:00:00Z,True,11,9,0,0,88,47,41,14,8,6,74,41
Camacho,556,2,367,2019-05-04T18:45:00Z,False,11,14,0,0,91,50,41,42,25,17,49,16
Camacho,556,2,375,2019-05-12T14:00:00Z,True,11,19,0,0,94,50,44,57,34,23,37,27
Knight,557,1,143,2018-12-05T19:45:00Z,False,10,8,0,0,21,11,10,8,7,1,13,3
Knight,557,1,156,2018-12-08T19:45:00Z,True,10,16,0,0,22,11,11,33,12,21,-11,-10
Knight,557,1,161,2018-12-15T15:00:00Z,False,10,6,0,0,22,11,11,12,5,7,10,6
Knight,557,1,173,2018-12-22T15:00:00Z,False,10,5,0,0,22,11,11,37,21,16,-15,-10
Knight,557,1,184,2018-12-26T15:00:00Z,True,10,12,0,0,25,11,14,44,27,17,-19,-6
Knight,557,1,194,2018-12-29T15:00:00Z,True,10,4,0,0,28,14,14,15,13,2,13,12
Knight,557,1,204,2019-01-01T12:30:00Z,False,10,7,0,0,28,14,14,27,18,9,1,-4
Knight,557,1,216,2019-01-12T15:00:00Z,True,10,15,0,0,31,14,17,16,8,8,15,6
Knight,557,1,229,2019-01-19T12:30:00Z,False,10,19,0,0,31,14,17,29,14,15,2,3
Knight,557,1,236,2019-01-30T20:00:00Z,False,10,11,0,0,31,14,17,60,31,29,-29,-14
Knight,557,1,246,2019-02-03T14:05:00Z,True,10,13,0,0,32,14,18,45,25,20,-13,-6
Knight,557,1,257,2019-02-10T13:30:00Z,False,10,16,0,0,32,14,18,57,24,33,-25,-6
Knight,557,1,266,2019-02-23T17:30:00Z,True,10,6,0,0,32,14,18,27,13,14,5,0
Knight,557,1,274,2019-02-26T19:45:00Z,True,10,2,0,0,32,14,18,27,19,8,5,6
Knight,557,1,287,2019-03-03T12:00:00Z,False,10,17,0,0,35,17,18,40,20,20,-5,-2
Knight,557,1,295,2019-03-09T15:00:00Z,True,10,8,0,0,35,17,18,17,15,2,18,15
Knight,557,1,302,2019-03-16T15:00:00Z,False,10,3,0,0,38,20,18,30,17,13,8,1
Knight,557,1,316,2019-03-30T15:00:00Z,True,10,1,0,0,41,20,21,38,26,12,3,8
Knight,557,1,323,2019-04-06T14:00:00Z,False,10,9,0,0,44,23,21,14,8,6,30,13
Knight,557,1,334,2019-04-12T19:00:00Z,True,10,14,0,0,47,23,24,35,22,13,12,10
Knight,557,1,348,2019-04-20T14:00:00Z,False,10,18,0,0,47,23,24,42,27,15,5,-3
Knight,557,1,354,2019-04-28T11:00:00Z,True,10,0,0,0,48,23,25,66,44,22,-18,1
Knight,557,1,366,2019-05-06T19:00:00Z,False,10,12,0,0,51,26,25,92,51,41,-41,-26
Knight,557,1,374,2019-05-12T14:00:00Z,True,10,5,0,0,51,26,25,71,42,29,-20,-3
White,558,1,152,2018-12-08T15:00:00Z,False,2,3,0,0,21,14,7,9,4,5,12,3
White,558,1,160,2018-12-16T13:30:00Z,True,2,5,0,0,21,14,7,34,21,13,-13,1
White,558,1,171,2018-12-22T15:00:00Z,False,2,1,0,0,21,14,7,23,14,9,-2,-7
White,558,1,180,2018-12-26T17:15:00Z,True,2,0,0,0,21,14,7,37,23,14,-16,0
White,558,1,190,2018-12-29T15:00:00Z,True,2,7,0,0,22,15,7,27,18,9,-5,6
White,558,1,208,2019-01-02T19:45:00Z,False,2,18,0,0,25,18,7,27,13,14,-2,-6
White,558,1,210,2019-01-12T15:00:00Z,True,2,11,0,0,26,18,8,54,28,26,-28,-8
White,558,1,225,2019-01-19T15:00:00Z,False,2,13,0,0,26,18,8,41,21,20,-15,-13
White,558,1,232,2019-01-29T19:45:00Z,False,2,8,0,0,26,18,8,14,12,2,12,-4
White,558,1,240,2019-02-02T15:00:00Z,True,2,17,0,0,26,18,8,33,17,16,-7,2
White,558,1,250,2019-02-09T17:30:00Z,True,2,3,0,0,27,19,8,24,14,10,3,9
White,558,1,274,2019-02-26T19:45:00Z,False,2,10,0,0,27,19,8,32,14,18,-5,-6
White,558,1,281,2019-03-02T15:00:00Z,True,2,9,0,0,27,19,8,14,8,6,13,13
White,558,1,293,2019-03-09T12:30:00Z,False,2,6,0,0,30,22,8,33,13,20,-3,-5
White,558,1,311,2019-03-30T15:00:00Z,True,2,15,0,0,33,22,11,30,18,12,3,10
White,558,1,264,2019-04-03T18:45:00Z,False,2,5,0,0,33,22,11,60,32,28,-27,-21
White,558,1,330,2019-04-13T14:00:00Z,True,2,1,0,0,33,22,11,38,26,12,-5,10
White,558,1,301,2019-04-16T18:45:00Z,True,2,4,0,0,33,22,11,28,20,8,5,14
White,558,1,349,2019-04-20T14:00:00Z,False,2,19,0,0,33,22,11,47,27,20,-14,-16
White,558,1,327,2019-04-23T18:45:00Z,False,2,16,0,0,34,22,12,67,34,33,-33,-22
White,558,1,350,2019-04-27T16:30:00Z,True,2,14,0,0,34,22,12,41,25,16,-7,6
White,558,1,360,2019-05-05T15:30:00Z,False,2,0,0,0,35,23,12,66,44,22,-31,-32
White,558,1,370,2019-05-12T14:00:00Z,True,2,12,0,0,36,23,13,95,54,41,-59,-18
Xande Silva,559,3,162,2018-12-15T17:30:00Z,False,18,8,0,0,21,13,8,9,8,1,12,0
Xande Silva,559,3,178,2018-12-22T15:00:00Z,True,18,17,0,0,24,13,11,24,15,9,0,4
Xande Silva,559,3,187,2018-12-27T19:45:00Z,False,18,15,0,0,24,13,11,15,8,7,9,3
Xande Silva,559,3,191,2018-12-30T14:15:00Z,False,18,3,17,1,27,13,14,12,7,5,15,7
Xande Silva,559,3,208,2019-01-02T19:45:00Z,True,18,2,0,0,27,13,14,25,18,7,2,6
Xande Silva,559,3,219,2019-01-12T12:30:00Z,True,18,0,0,0,28,14,14,41,26,15,-13,-1
Xande Silva,559,3,221,2019-01-19T15:00:00Z,False,18,1,0,0,31,17,14,27,18,9,4,-4
Xande Silva,559,3,235,2019-01-29T19:45:00Z,False,18,19,0,0,31,17,14,32,17,15,-1,-3
Xande Silva,559,3,249,2019-02-04T20:00:00Z,True,18,11,0,0,31,17,14,61,32,29,-30,-12
Xande Silva,559,3,251,2019-02-09T15:00:00Z,False,18,6,0,0,32,18,14,26,12,14,6,2
Xande Silva,559,3,269,2019-02-22T19:45:00Z,True,18,8,0,0,33,18,15,17,15,2,16,16
Xande Silva,559,3,277,2019-02-27T20:00:00Z,False,18,12,0,0,36,21,15,65,39,26,-29,-24
Xande Silva,559,3,288,2019-03-02T17:30:00Z,True,18,14,0,0,36,21,15,31,19,12,5,9
Xande Silva,559,3,291,2019-03-09T15:00:00Z,False,18,4,0,0,39,24,15,25,17,8,14,-2
Xande Silva,559,3,308,2019-03-16T15:00:00Z,True,18,9,0,0,39,24,15,14,8,6,25,18
Xande Silva,559,3,319,2019-03-30T17:30:00Z,True,18,7,0,0,42,27,15,40,25,15,2,12
Xande Silva,559,3,321,2019-04-08T19:00:00Z,False,18,5,0,0,42,27,15,63,35,28,-21,-20
Xande Silva,559,3,336,2019-04-13T16:30:00Z,False,18,13,0,0,42,27,15,61,32,29,-19,-17
Xande Silva,559,3,348,2019-04-20T14:00:00Z,True,18,10,0,0,42,27,15,47,23,24,-5,3
Xande Silva,559,3,358,2019-04-27T11:30:00Z,False,18,16,0,0,43,28,15,70,37,33,-27,-22
Xande Silva,559,3,368,2019-05-04T14:00:00Z,True,18,15,0,0,46,28,18,38,22,16,8,12
Xande Silva,559,3,379,2019-05-12T14:00:00Z,False,18,17,0,0,49,31,18,50,27,23,-1,-9
Eyoma,560,1,167,2018-12-15T15:00:00Z,True,16,3,0,0,36,12,24,12,7,5,24,7
Eyoma,560,1,174,2018-12-23T16:00:00Z,False,16,7,0,0,39,15,24,24,18,6,15,6
Eyoma,560,1,188,2018-12-26T15:00:00Z,True,16,1,0,0,42,15,27,26,17,9,16,6
Eyoma,560,1,198,2018-12-29T15:00:00Z,True,16,19,0,0,45,18,27,26,14,12,19,6
Eyoma,560,1,202,2019-01-01T17:30:00Z,False,16,4,0,0,45,18,27,18,13,5,27,14
Eyoma,560,1,218,2019-01-13T16:30:00Z,True,16,13,0,0,48,18,30,38,21,17,10,1
Eyoma,560,1,222,2019-01-20T16:00:00Z,False,16,8,0,0,48,18,30,14,12,2,34,18
Eyoma,560,1,239,2019-01-30T20:00:00Z,True,16,17,0,0,51,18,33,33,17,16,18,2
Eyoma,560,1,248,2019-02-02T12:30:00Z,True,16,14,0,0,54,21,33,24,13,11,30,10
Eyoma,560,1,257,2019-02-10T13:30:00Z,True,16,10,0,0,57,24,33,32,14,18,25,6
Eyoma,560,1,262,2019-02-23T12:30:00Z,False,16,3,0,0,60,27,33,27,14,13,33,19
Eyoma,560,1,275,2019-02-27T20:00:00Z,False,16,5,0,0,60,27,33,50,28,22,10,5
Eyoma,560,1,286,2019-03-02T12:30:00Z,True,16,0,0,0,60,27,33,56,38,18,4,9
Eyoma,560,1,299,2019-03-09T15:00:00Z,False,16,15,0,0,61,28,33,27,15,12,34,18
Eyoma,560,1,317,2019-03-31T15:30:00Z,False,16,11,0,0,61,28,33,76,41,35,-15,-8
Eyoma,560,1,306,2019-04-03T18:45:00Z,True,16,6,0,0,61,28,33,36,16,20,25,8
Eyoma,560,1,338,2019-04-13T11:30:00Z,True,16,9,0,0,64,31,33,14,8,6,50,25
Eyoma,560,1,346,2019-04-20T11:30:00Z,False,16,12,0,0,67,34,33,83,48,35,-16,-15
Eyoma,560,1,327,2019-04-23T18:45:00Z,True,16,2,0,0,67,34,33,34,22,12,33,22
Eyoma,560,1,358,2019-04-27T11:30:00Z,True,16,18,0,0,70,37,33,43,28,15,27,22
Eyoma,560,1,361,2019-05-04T11:30:00Z,False,16,1,0,0,70,37,33,42,26,16,28,7
Eyoma,560,1,378,2019-05-12T14:00:00Z,True,16,7,0,0,70,37,33,53,34,19,17,18
Johnson,561,2,166,2018-12-16T13:30:00Z,True,15,0,1,1,9,5,4,34,20,14,-25,-9
Johnson,561,2,175,2018-12-22T15:00:00Z,False,15,9,0,0,12,8,4,10,5,5,2,-1
Johnson,561,2,187,2018-12-27T19:45:00Z,True,15,18,0,0,15,8,7,24,13,11,-9,-3
Johnson,561,2,197,2018-12-30T14:15:00Z,True,15,12,0,0,15,8,7,44,27,17,-29,-9
Johnson,561,2,203,2019-01-02T19:45:00Z,False,15,5,0,0,15,8,7,43,21,22,-28,-14
Johnson,561,2,216,2019-01-12T15:00:00Z,False,15,10,0,0,16,8,8,31,14,17,-15,-6
Johnson,561,2,227,2019-01-19T15:00:00Z,True,15,7,0,0,19,8,11,30,21,9,-11,-1
Johnson,561,2,238,2019-01-30T19:45:00Z,True,15,6,0,0,22,11,11,22,9,13,0,-2
Johnson,561,2,241,2019-02-02T15:00:00Z,False,15,3,0,0,23,12,11,23,13,10,0,-2
Johnson,561,2,256,2019-02-09T15:00:00Z,True,15,4,0,0,24,12,12,22,17,5,2,7
Johnson,561,2,260,2019-02-24T14:05:00Z,False,15,0,0,0,24,12,12,50,32,18,-26,-20
Johnson,561,2,279,2019-02-27T19:45:00Z,True,15,8,0,0,24,12,12,17,15,2,7,10
Johnson,561,2,285,2019-03-02T15:00:00Z,False,15,13,0,0,27,15,12,55,26,29,-28,-14
Johnson,561,2,299,2019-03-09T15:00:00Z,True,15,16,0,0,27,15,12,61,28,33,-34,-18
Johnson,561,2,311,2019-03-30T15:00:00Z,False,15,2,0,0,30,18,12,33,22,11,-3,-10
Johnson,561,2,326,2019-04-05T19:00:00Z,True,15,11,0,0,33,18,15,79,44,35,-46,-17
Johnson,561,2,337,2019-04-13T14:00:00Z,True,15,19,0,0,33,18,15,47,27,20,-14,-2
Johnson,561,2,347,2019-04-20T16:30:00Z,False,15,14,0,0,36,21,15,38,22,16,-2,-7
Johnson,561,2,307,2019-04-23T18:45:00Z,False,15,17,0,0,36,21,15,49,26,23,-13,-11
Johnson,561,2,357,2019-04-27T14:00:00Z,True,15,1,0,0,37,21,16,41,26,15,-4,6
Johnson,561,2,368,2019-05-04T14:00:00Z,False,15,18,0,0,38,22,16,46,28,18,-8,-12
Johnson,561,2,377,2019-05-12T14:00:00Z,True,15,9,0,0,38,22,16,15,9,6,23,16
Saka,562,2,170,2018-12-22T12:30:00Z,True,0,3,0,0,34,20,14,12,7,5,22,15
Saka,562,2,180,2018-12-26T17:15:00Z,False,0,2,0,0,37,23,14,21,14,7,16,0
Saka,562,2,195,2018-12-29T17:30:00Z,False,0,11,0,0,38,23,15,51,25,26,-13,-10
Saka,562,2,200,2019-01-01T15:00:00Z,True,0,8,7,1,38,23,15,14,12,2,24,21
Saka,562,2,219,2019-01-12T12:30:00Z,False,0,18,0,0,41,26,15,28,14,14,13,1
Saka,562,2,220,2019-01-19T17:30:00Z,True,0,5,0,0,41,26,15,47,25,22,-6,4
Saka,562,2,230,2019-01-29T19:45:00Z,True,0,4,0,0,44,29,15,19,14,5,25,24
Saka,562,2,247,2019-02-03T16:30:00Z,False,0,12,0,0,47,32,15,56,33,23,-9,-18
Saka,562,2,253,2019-02-09T15:00:00Z,False,0,9,0,0,47,32,15,11,5,6,36,10
Saka,562,2,260,2019-02-24T14:05:00Z,True,0,15,0,0,50,32,18,24,12,12,26,20
Saka,562,2,270,2019-02-27T19:45:00Z,True,0,1,0,0,53,35,18,34,25,9,19,26
Saka,562,2,286,2019-03-02T12:30:00Z,False,0,16,0,0,56,38,18,60,27,33,-4,-9
Saka,562,2,290,2019-03-10T16:30:00Z,True,0,13,0,0,57,38,19,58,29,29,-1,9
Saka,562,2,310,2019-04-01T19:00:00Z,True,0,14,0,0,60,41,19,35,22,13,25,28
Saka,562,2,322,2019-04-07T13:05:00Z,False,0,7,0,0,63,44,19,43,25,18,20,-6
Saka,562,2,339,2019-04-15T19:00:00Z,False,0,17,0,0,63,44,19,46,26,20,17,-7
Saka,562,2,340,2019-04-21T15:00:00Z,True,0,6,0,0,66,44,22,39,16,23,27,21
Saka,562,2,309,2019-04-24T18:45:00Z,False,0,19,0,0,66,44,22,48,28,20,18,-6
Saka,562,2,354,2019-04-28T11:00:00Z,False,0,10,0,0,66,44,22,48,23,25,18,-1
Saka,562,2,360,2019-05-05T15:30:00Z,True,0,2,0,0,66,44,22,35,23,12,31,32
Saka,562,2,371,2019-05-12T14:00:00Z,False,0,3,0,0,67,45,22,40,23,17,27,-1
Koiki,563,1,170,2018-12-22T12:30:00Z,False,3,0,0,0,12,7,5,34,20,14,-22,-15
Koiki,563,1,181,2018-12-26T15:00:00Z,True,3,7,0,0,12,7,5,24,18,6,-12,1
Koiki,563,1,191,2018-12-30T14:15:00Z,True,3,18,0,0,12,7,5,27,13,14,-15,-7
Koiki,563,1,205,2019-01-02T19:45:00Z,False,3,9,0,0,15,10,5,10,5,5,5,0
Koiki,563,1,211,2019-01-12T15:00:00Z,True,3,8,0,0,18,10,8,14,12,2,4,8
Koiki,563,1,228,2019-01-19T15:00:00Z,False,3,17,0,0,21,13,8,32,16,16,-11,-8
Koiki,563,1,234,2019-01-29T20:00:00Z,False,3,13,0,0,22,13,9,44,24,20,-22,-15
Koiki,563,1,241,2019-02-02T15:00:00Z,True,3,15,0,0,23,13,10,23,12,11,0,2
Koiki,563,1,250,2019-02-09T17:30:00Z,False,3,2,0,0,24,14,10,27,19,8,-3,-9
Koiki,563,1,262,2019-02-23T12:30:00Z,True,3,16,0,0,27,14,13,60,27,33,-33,-19
Koiki,563,1,278,2019-02-26T20:00:00Z,False,3,14,0,0,30,17,13,28,16,12,2,-3
Koiki,563,1,282,2019-03-02T15:00:00Z,True,3,6,0,0,30,17,13,30,13,17,0,0
Koiki,563,1,296,2019-03-10T12:00:00Z,False,3,11,0,0,30,17,13,70,38,32,-40,-25
Koiki,563,1,302,2019-03-16T15:00:00Z,True,3,10,0,0,30,17,13,38,20,18,-8,-1
Koiki,563,1,312,2019-03-30T15:00:00Z,True,3,19,0,0,30,17,13,44,24,20,-14,-3
Koiki,563,1,320,2019-04-06T14:00:00Z,False,3,1,0,0,33,20,13,38,26,12,-5,-13
Koiki,563,1,331,2019-04-13T14:00:00Z,True,3,4,0,0,36,20,16,28,20,8,8,12
Koiki,563,1,343,2019-04-22T19:00:00Z,False,3,5,0,0,39,23,16,66,38,28,-27,-22
Koiki,563,1,351,2019-04-28T13:05:00Z,True,3,12,0,0,40,23,17,89,51,38,-49,-15
Koiki,563,1,364,2019-05-03T19:00:00Z,False,3,7,0,0,40,23,17,50,31,19,-10,-14
Koiki,563,1,371,2019-05-12T14:00:00Z,True,3,0,0,0,40,23,17,67,45,22,-27,1
Ramsay,564,1,175,2018-12-22T15:00:00Z,False,15,9,0,0,12,8,4,10,5,5,2,-1
Ramsay,564,1,187,2018-12-27T19:45:00Z,True,15,18,0,0,15,8,7,24,13,11,-9,-3
Ramsay,564,1,197,2018-12-30T14:15:00Z,True,15,12,90,1,15,8,7,44,27,17,-29,-9
Ramsay,564,1,203,2019-01-02T19:45:00Z,False,15,5,0,0,15,8,7,43,21,22,-28,-14
Ramsay,564,1,216,2019-01-12T15:00:00Z,False,15,10,0,0,16,8,8,31,14,17,-15,-6
Ramsay,564,1,227,2019-01-19T15:00:00Z,True,15,7,0,0,19,8,11,30,21,9,-11,-1
Ramsay,564,1,238,2019-01-30T19:45:00Z,True,15,6,0,0,22,11,11,22,9,13,0,-2
Ramsay,564,1,241,2019-02-02T15:00:00Z,False,15,3,0,0,23,12,11,23,13,10,0,-2
Ramsay,564,1,256,2019-02-09T15:00:00Z,True,15,4,0,0,24,12,12,22,17,5,2,7
Ramsay,564,1,260,2019-02-24T14:05:00Z,False,15,0,0,0,24,12,12,50,32,18,-26,-20
Ramsay,564,1,279,2019-02-27T19:45:00Z,True,15,8,0,0,24,12,12,17,15,2,7,10
Ramsay,564,1,285,2019-03-02T15:00:00Z,False,15,13,0,0,27,15,12,55,26,29,-28,-14
Ramsay,564,1,299,2019-03-09T15:00:00Z,True,15,16,0,0,27,15,12,61,28,33,-34,-18
Ramsay,564,1,311,2019-03-30T15:00:00Z,False,15,2,0,0,30,18,12,33,22,11,-3,-10
Ramsay,564,1,326,2019-04-05T19:00:00Z,True,15,11,0,0,33,18,15,79,44,35,-46,-17
Ramsay,564,1,337,2019-04-13T14:00:00Z,True,15,19,0,0,33,18,15,47,27,20,-14,-2
Ramsay,564,1,347,2019-04-20T16:30:00Z,False,15,14,0,0,36,21,15,38,22,16,-2,-7
Ramsay,564,1,307,2019-04-23T18:45:00Z,False,15,17,0,0,36,21,15,49,26,23,-13,-11
Ramsay,564,1,357,2019-04-27T14:00:00Z,True,15,1,0,0,37,21,16,41,26,15,-4,6
Ramsay,564,1,368,2019-05-04T14:00:00Z,False,15,18,0,0,38,22,16,46,28,18,-8,-12
Ramsay,564,1,377,2019-05-12T14:00:00Z,True,15,9,0,0,38,22,16,15,9,6,23,16
Willock,565,2,180,2018-12-26T17:15:00Z,False,0,2,0,0,37,23,14,21,14,7,16,0
Willock,565,2,195,2018-12-29T17:30:00Z,False,0,11,0,0,38,23,15,51,25,26,-13,-10
Willock,565,2,200,2019-01-01T15:00:00Z,True,0,8,0,0,38,23,15,14,12,2,24,21
Willock,565,2,219,2019-01-12T12:30:00Z,False,0,18,0,0,41,26,15,28,14,14,13,1
Willock,565,2,220,2019-01-19T17:30:00Z,True,0,5,0,0,41,26,15,47,25,22,-6,4
Willock,565,2,230,2019-01-29T19:45:00Z,True,0,4,0,0,44,29,15,19,14,5,25,24
Willock,565,2,247,2019-02-03T16:30:00Z,False,0,12,0,0,47,32,15,56,33,23,-9,-18
Willock,565,2,253,2019-02-09T15:00:00Z,False,0,9,2,1,47,32,15,11,5,6,36,10
Willock,565,2,260,2019-02-24T14:05:00Z,True,0,15,0,0,50,32,18,24,12,12,26,20
Willock,565,2,270,2019-02-27T19:45:00Z,True,0,1,0,0,53,35,18,34,25,9,19,26
Willock,565,2,286,2019-03-02T12:30:00Z,False,0,16,0,0,56,38,18,60,27,33,-4,-9
Willock,565,2,290,2019-03-10T16:30:00Z,True,0,13,0,0,57,38,19,58,29,29,-1,9
Willock,565,2,310,2019-04-01T19:00:00Z,True,0,14,0,0,60,41,19,35,22,13,25,28
Willock,565,2,322,2019-04-07T13:05:00Z,False,0,7,0,0,63,44,19,43,25,18,20,-6
Willock,565,2,339,2019-04-15T19:00:00Z,False,0,17,0,0,63,44,19,46,26,20,17,-7
Willock,565,2,340,2019-04-21T15:00:00Z,True,0,6,0,0,66,44,22,39,16,23,27,21
Willock,565,2,309,2019-04-24T18:45:00Z,False,0,19,0,0,66,44,22,48,28,20,18,-6
Willock,565,2,354,2019-04-28T11:00:00Z,False,0,10,0,0,66,44,22,48,23,25,18,-1
Willock,565,2,360,2019-05-05T15:30:00Z,True,0,2,0,0,66,44,22,35,23,12,31,32
Willock,565,2,371,2019-05-12T14:00:00Z,False,0,3,61,3,67,45,22,40,23,17,27,-1
Kilman,566,1,183,2018-12-26T12:30:00Z,False,19,8,0,0,25,14,11,10,8,2,15,3
Kilman,566,1,198,2018-12-29T15:00:00Z,False,19,16,0,0,26,14,12,45,18,27,-19,-6
Kilman,566,1,209,2019-01-02T19:45:00Z,True,19,6,0,0,29,14,15,19,9,10,10,4
Kilman,566,1,217,2019-01-14T20:00:00Z,False,19,12,0,0,29,14,15,50,30,20,-21,-15
Kilman,566,1,229,2019-01-19T12:30:00Z,True,19,10,0,0,29,14,15,31,14,17,-2,-3
Kilman,566,1,235,2019-01-29T19:45:00Z,True,19,18,0,0,32,17,15,31,17,14,1,3
Kilman,566,1,245,2019-02-02T15:00:00Z,False,19,7,0,0,35,20,15,33,21,12,2,-6
Kilman,566,1,259,2019-02-11T20:00:00Z,True,19,14,0,0,38,20,18,24,13,11,14,9
Kilman,566,1,261,2019-02-23T15:00:00Z,False,19,1,0,0,39,21,18,33,24,9,6,-6
Kilman,566,1,273,2019-02-26T19:45:00Z,False,19,9,0,0,40,21,19,11,5,6,29,14
Kilman,566,1,289,2019-03-02T15:00:00Z,True,19,4,0,0,40,21,19,25,17,8,15,13
Kilman,566,1,292,2019-03-10T14:05:00Z,False,19,5,0,0,43,24,19,56,31,25,-13,-12
Kilman,566,1,312,2019-03-30T15:00:00Z,False,19,3,0,0,44,24,20,30,17,13,14,3
Kilman,566,1,329,2019-04-02T18:45:00Z,True,19,13,0,0,44,24,20,61,32,29,-17,-5
Kilman,566,1,337,2019-04-13T14:00:00Z,False,19,15,0,0,47,27,20,33,18,15,14,2
Kilman,566,1,349,2019-04-20T14:00:00Z,True,19,2,0,0,47,27,20,33,22,11,14,16
Kilman,566,1,309,2019-04-24T18:45:00Z,True,19,0,0,0,48,28,20,66,44,22,-18,6
Kilman,566,1,359,2019-04-27T14:00:00Z,False,19,17,0,0,51,31,20,50,27,23,1,-7
Kilman,566,1,369,2019-05-04T14:00:00Z,True,19,8,1,1,54,31,23,26,21,5,28,26
Kilman,566,1,375,2019-05-12T14:00:00Z,False,19,11,0,0,57,34,23,94,50,44,-37,-27
Gomes,567,2,186,2018-12-26T15:00:00Z,True,13,9,9,1,29,15,14,10,5,5,19,10
Gomes,567,2,196,2018-12-30T16:30:00Z,True,13,1,0,0,32,18,14,26,17,9,6,9
Gomes,567,2,207,2019-01-02T20:00:00Z,False,13,14,0,0,35,21,14,18,7,11,17,7
Gomes,567,2,218,2019-01-13T16:30:00Z,False,13,16,0,0,38,21,17,48,18,30,-10,-1
Gomes,567,2,225,2019-01-19T15:00:00Z,True,13,2,0,0,41,21,20,26,18,8,15,13
Gomes,567,2,234,2019-01-29T20:00:00Z,True,13,3,0,0,44,24,20,22,13,9,22,15
Gomes,567,2,246,2019-02-03T14:05:00Z,False,13,10,0,0,45,25,20,32,14,18,13,6
Gomes,567,2,252,2019-02-09T12:30:00Z,False,13,8,0,0,48,25,23,17,15,2,31,8
Gomes,567,2,267,2019-02-24T14:05:00Z,True,13,11,0,0,51,25,26,65,35,30,-14,-5
Gomes,567,2,272,2019-02-27T20:00:00Z,False,13,6,0,0,52,26,26,30,13,17,22,13
Gomes,567,2,285,2019-03-02T15:00:00Z,True,13,15,0,0,55,26,29,27,15,12,28,14
Gomes,567,2,290,2019-03-10T16:30:00Z,False,13,0,0,0,58,29,29,57,38,19,1,-9
Gomes,567,2,318,2019-03-30T15:00:00Z,True,13,17,0,0,58,29,29,43,23,20,15,9
Gomes,567,2,329,2019-04-02T18:45:00Z,False,13,19,0,0,61,32,29,44,24,20,17,5
Gomes,567,2,336,2019-04-13T16:30:00Z,True,13,18,0,0,61,32,29,42,27,15,19,17
Gomes,567,2,344,2019-04-21T12:30:00Z,False,13,7,0,0,64,35,29,46,28,18,18,1
Gomes,567,2,305,2019-04-24T19:00:00Z,True,13,12,0,0,64,35,29,86,51,35,-22,0
Gomes,567,2,356,2019-04-28T15:30:00Z,True,13,5,0,0,64,35,29,67,39,28,-3,7
Gomes,567,2,365,2019-05-05T13:00:00Z,False,13,9,0,0,65,36,29,14,8,6,51,21
Gomes,567,2,376,2019-05-12T14:00:00Z,True,13,4,16,1,66,36,30,31,20,11,35,25
Nasri,568,2,208,2019-01-02T19:45:00Z,True,18,2,0,0,27,13,14,25,18,7,2,6
Nasri,568,2,219,2019-01-12T12:30:00Z,True,18,0,70,6,28,14,14,41,26,15,-13,-1
Nasri,568,2,221,2019-01-19T15:00:00Z,False,18,1,65,2,31,17,14,27,18,9,4,-4
Nasri,568,2,235,2019-01-29T19:45:00Z,False,18,19,0,0,31,17,14,32,17,15,-1,-3
Nasri,568,2,249,2019-02-04T20:00:00Z,True,18,11,0,0,31,17,14,61,32,29,-30,-12
Nasri,568,2,251,2019-02-09T15:00:00Z,False,18,6,0,0,32,18,14,26,12,14,6,2
Nasri,568,2,269,2019-02-22T19:45:00Z,True,18,8,0,0,33,18,15,17,15,2,16,16
Nasri,568,2,277,2019-02-27T20:00:00Z,False,18,12,45,1,36,21,15,65,39,26,-29,-24
Nasri,568,2,288,2019-03-02T17:30:00Z,True,18,14,0,0,36,21,15,31,19,12,5,9
Nasri,568,2,291,2019-03-09T15:00:00Z,False,18,4,32,1,39,24,15,25,17,8,14,-2
Nasri,568,2,308,2019-03-16T15:00:00Z,True,18,9,31,4,39,24,15,14,8,6,25,18
Nasri,568,2,319,2019-03-30T17:30:00Z,True,18,7,0,0,42,27,15,40,25,15,2,12
Nasri,568,2,321,2019-04-08T19:00:00Z,False,18,5,0,0,42,27,15,63,35,28,-21,-20
Nasri,568,2,336,2019-04-13T16:30:00Z,False,18,13,0,0,42,27,15,61,32,29,-19,-17
Nasri,568,2,348,2019-04-20T14:00:00Z,True,18,10,0,0,42,27,15,47,23,24,-5,3
Nasri,568,2,358,2019-04-27T11:30:00Z,False,18,16,0,0,43,28,15,70,37,33,-27,-22
Nasri,568,2,368,2019-05-04T14:00:00Z,True,18,15,0,0,46,28,18,38,22,16,8,12
Nasri,568,2,379,2019-05-12T14:00:00Z,False,18,17,0,0,49,31,18,50,27,23,-1,-9
Slattery,569,2,203,2019-01-02T19:45:00Z,False,15,5,0,0,15,8,7,43,21,22,-28,-14
Slattery,569,2,216,2019-01-12T15:00:00Z,False,15,10,14,1,16,8,8,31,14,17,-15,-6
Slattery,569,2,227,2019-01-19T15:00:00Z,True,15,7,0,0,19,8,11,30,21,9,-11,-1
Slattery,569,2,238,2019-01-30T19:45:00Z,True,15,6,6,1,22,11,11,22,9,13,0,-2
Slattery,569,2,241,2019-02-02T15:00:00Z,False,15,3,90,2,23,12,11,23,13,10,0,-2
Slattery,569,2,256,2019-02-09T15:00:00Z,True,15,4,0,0,24,12,12,22,17,5,2,7
Slattery,569,2,260,2019-02-24T14:05:00Z,False,15,0,0,0,24,12,12,50,32,18,-26,-20
Slattery,569,2,279,2019-02-27T19:45:00Z,True,15,8,0,0,24,12,12,17,15,2,7,10
Slattery,569,2,285,2019-03-02T15:00:00Z,False,15,13,0,0,27,15,12,55,26,29,-28,-14
Slattery,569,2,299,2019-03-09T15:00:00Z,True,15,16,0,0,27,15,12,61,28,33,-34,-18
Slattery,569,2,311,2019-03-30T15:00:00Z,False,15,2,0,0,30,18,12,33,22,11,-3,-10
Slattery,569,2,326,2019-04-05T19:00:00Z,True,15,11,0,0,33,18,15,79,44,35,-46,-17
Slattery,569,2,337,2019-04-13T14:00:00Z,True,15,19,0,0,33,18,15,47,27,20,-14,-2
Slattery,569,2,347,2019-04-20T16:30:00Z,False,15,14,0,0,36,21,15,38,22,16,-2,-7
Slattery,569,2,307,2019-04-23T18:45:00Z,False,15,17,0,0,36,21,15,49,26,23,-13,-11
Slattery,569,2,357,2019-04-27T14:00:00Z,True,15,1,0,0,37,21,16,41,26,15,-4,6
Slattery,569,2,368,2019-05-04T14:00:00Z,False,15,18,0,0,38,22,16,46,28,18,-8,-12
Slattery,569,2,377,2019-05-12T14:00:00Z,True,15,9,0,0,38,22,16,15,9,6,23,16
Barnes,570,2,216,2019-01-12T15:00:00Z,True,10,15,45,1,31,14,17,16,8,8,15,6
Barnes,570,2,229,2019-01-19T12:30:00Z,False,10,19,72,5,31,14,17,29,14,15,2,3
Barnes,570,2,236,2019-01-30T20:00:00Z,False,10,11,0,0,31,14,17,60,31,29,-29,-14
Barnes,570,2,246,2019-02-03T14:05:00Z,True,10,13,90,2,32,14,18,45,25,20,-13,-6
Barnes,570,2,257,2019-02-10T13:30:00Z,False,10,16,87,2,32,14,18,57,24,33,-25,-6
Barnes,570,2,266,2019-02-23T17:30:00Z,True,10,6,84,5,32,14,18,27,13,14,5,0
Barnes,570,2,274,2019-02-26T19:45:00Z,True,10,2,90,2,32,14,18,27,19,8,5,6
Barnes,570,2,287,2019-03-03T12:00:00Z,False,10,17,65,2,35,17,18,40,20,20,-5,-2
Barnes,570,2,295,2019-03-09T15:00:00Z,True,10,8,90,5,35,17,18,17,15,2,18,15
Barnes,570,2,302,2019-03-16T15:00:00Z,False,10,3,76,2,38,20,18,30,17,13,8,1
Barnes,570,2,316,2019-03-30T15:00:00Z,True,10,1,71,3,41,20,21,38,26,12,3,8
Barnes,570,2,323,2019-04-06T14:00:00Z,False,10,9,60,2,44,23,21,14,8,6,30,13
Barnes,570,2,334,2019-04-12T19:00:00Z,True,10,14,79,2,47,23,24,35,22,13,12,10
Barnes,570,2,348,2019-04-20T14:00:00Z,False,10,18,26,7,47,23,24,42,27,15,5,-3
Barnes,570,2,354,2019-04-28T11:00:00Z,True,10,0,45,1,48,23,25,66,44,22,-18,1
Barnes,570,2,366,2019-05-06T19:00:00Z,False,10,12,15,1,51,26,25,92,51,41,-41,-26
Barnes,570,2,374,2019-05-12T14:00:00Z,True,10,5,6,1,51,26,25,71,42,29,-20,-3
Sanders,571,2,210,2019-01-12T15:00:00Z,True,2,11,0,0,26,18,8,54,28,26,-28,-8
Sanders,571,2,225,2019-01-19T15:00:00Z,False,2,13,0,0,26,18,8,41,21,20,-15,-13
Sanders,571,2,232,2019-01-29T19:45:00Z,False,2,8,0,0,26,18,8,14,12,2,12,-4
Sanders,571,2,240,2019-02-02T15:00:00Z,True,2,17,0,0,26,18,8,33,17,16,-7,2
Sanders,571,2,250,2019-02-09T17:30:00Z,True,2,3,0,0,27,19,8,24,14,10,3,9
Sanders,571,2,274,2019-02-26T19:45:00Z,False,2,10,0,0,27,19,8,32,14,18,-5,-6
Sanders,571,2,281,2019-03-02T15:00:00Z,True,2,9,0,0,27,19,8,14,8,6,13,13
Sanders,571,2,293,2019-03-09T12:30:00Z,False,2,6,0,0,30,22,8,33,13,20,-3,-5
Sanders,571,2,311,2019-03-30T15:00:00Z,True,2,15,0,0,33,22,11,30,18,12,3,10
Sanders,571,2,264,2019-04-03T18:45:00Z,False,2,5,0,0,33,22,11,60,32,28,-27,-21
Sanders,571,2,330,2019-04-13T14:00:00Z,True,2,1,0,0,33,22,11,38,26,12,-5,10
Sanders,571,2,301,2019-04-16T18:45:00Z,True,2,4,0,0,33,22,11,28,20,8,5,14
Sanders,571,2,349,2019-04-20T14:00:00Z,False,2,19,0,0,33,22,11,47,27,20,-14,-16
Sanders,571,2,327,2019-04-23T18:45:00Z,False,2,16,0,0,34,22,12,67,34,33,-33,-22
Sanders,571,2,350,2019-04-27T16:30:00Z,True,2,14,0,0,34,22,12,41,25,16,-7,6
Sanders,571,2,360,2019-05-05T15:30:00Z,False,2,0,0,0,35,23,12,66,44,22,-31,-32
Sanders,571,2,370,2019-05-12T14:00:00Z,True,2,12,0,0,36,23,13,95,54,41,-59,-18
Healey,572,3,212,2019-01-12T15:00:00Z,True,4,9,17,1,18,13,5,10,5,5,8,8
Healey,572,3,226,2019-01-19T15:00:00Z,False,4,14,0,0,19,14,5,18,7,11,1,-2
Healey,572,3,230,2019-01-29T19:45:00Z,False,4,0,0,0,19,14,5,44,29,15,-25,-24
Healey,572,3,242,2019-02-02T17:30:00Z,True,4,1,0,0,19,14,5,33,24,9,-14,5
Healey,572,3,256,2019-02-09T15:00:00Z,False,4,15,0,0,22,17,5,24,12,12,-2,-7
Healey,572,3,263,2019-02-22T19:45:00Z,True,4,17,0,0,25,17,8,37,20,17,-12,0
Healey,572,3,271,2019-02-26T19:45:00Z,True,4,7,0,0,25,17,8,33,21,12,-8,5
Healey,572,3,289,2019-03-02T15:00:00Z,False,4,19,14,1,25,17,8,40,21,19,-15,-13
Healey,572,3,291,2019-03-09T15:00:00Z,True,4,18,0,0,25,17,8,39,24,15,-14,2
Healey,572,3,313,2019-03-31T13:05:00Z,True,4,5,0,0,28,20,8,57,32,25,-29,-5
Healey,572,3,324,2019-04-03T18:45:00Z,False,4,12,0,0,28,20,8,77,45,32,-49,-37
Healey,572,3,331,2019-04-13T14:00:00Z,False,4,3,0,0,28,20,8,36,20,16,-8,-12
Healey,572,3,301,2019-04-16T18:45:00Z,False,4,2,0,0,28,20,8,33,22,11,-5,-14
Healey,572,3,342,2019-04-21T15:00:00Z,True,4,11,0,0,31,20,11,85,47,38,-54,-18
Healey,572,3,353,2019-04-27T14:00:00Z,False,4,8,18,1,31,20,11,23,18,5,8,-7
Healey,572,3,362,2019-05-04T16:30:00Z,True,4,6,0,0,31,20,11,43,17,26,-12,-6
Healey,572,3,376,2019-05-12T14:00:00Z,False,4,13,0,0,31,20,11,66,36,30,-35,-25
Gallagher,573,3,216,2019-01-12T15:00:00Z,False,15,10,1,1,16,8,8,31,14,17,-15,-6
Gallagher,573,3,227,2019-01-19T15:00:00Z,True,15,7,0,0,19,8,11,30,21,9,-11,-1
Gallagher,573,3,238,2019-01-30T19:45:00Z,True,15,6,0,0,22,11,11,22,9,13,0,-2
Gallagher,573,3,241,2019-02-02T15:00:00Z,False,15,3,0,0,23,12,11,23,13,10,0,-2
Gallagher,573,3,256,2019-02-09T15:00:00Z,True,15,4,7,1,24,12,12,22,17,5,2,7
Gallagher,573,3,260,2019-02-24T14:05:00Z,False,15,0,0,0,24,12,12,50,32,18,-26,-20
Gallagher,573,3,279,2019-02-27T19:45:00Z,True,15,8,0,0,24,12,12,17,15,2,7,10
Gallagher,573,3,285,2019-03-02T15:00:00Z,False,15,13,1,1,27,15,12,55,26,29,-28,-14
Gallagher,573,3,299,2019-03-09T15:00:00Z,True,15,16,0,0,27,15,12,61,28,33,-34,-18
Gallagher,573,3,311,2019-03-30T15:00:00Z,False,15,2,23,1,30,18,12,33,22,11,-3,-10
Gallagher,573,3,326,2019-04-05T19:00:00Z,True,15,11,0,0,33,18,15,79,44,35,-46,-17
Gallagher,573,3,337,2019-04-13T14:00:00Z,True,15,19,0,0,33,18,15,47,27,20,-14,-2
Gallagher,573,3,347,2019-04-20T16:30:00Z,False,15,14,0,0,36,21,15,38,22,16,-2,-7
Gallagher,573,3,307,2019-04-23T18:45:00Z,False,15,17,0,0,36,21,15,49,26,23,-13,-11
Gallagher,573,3,357,2019-04-27T14:00:00Z,True,15,1,0,0,37,21,16,41,26,15,-4,6
Gallagher,573,3,368,2019-05-04T14:00:00Z,False,15,18,0,0,38,22,16,46,28,18,-8,-12
Gallagher,573,3,377,2019-05-12T14:00:00Z,True,15,9,0,0,38,22,16,15,9,6,23,16
Babel,574,2,222,2019-01-20T16:00:00Z,True,8,16,54,1,14,12,2,48,18,30,-34,-18
Babel,574,2,232,2019-01-29T19:45:00Z,True,8,2,90,7,14,12,2,26,18,8,-12,4
Babel,574,2,244,2019-02-02T15:00:00Z,False,8,6,87,1,17,15,2,23,9,14,-6,-7
Babel,574,2,252,2019-02-09T12:30:00Z,True,8,13,76,2,17,15,2,48,25,23,-31,-8
Babel,574,2,269,2019-02-22T19:45:00Z,False,8,18,90,7,17,15,2,33,18,15,-16,-16
Babel,574,2,279,2019-02-27T19:45:00Z,False,8,15,90,2,17,15,2,24,12,12,-7,-10
Babel,574,2,284,2019-03-03T14:05:00Z,True,8,5,70,5,17,15,2,53,31,22,-36,-7
Babel,574,2,295,2019-03-09T15:00:00Z,False,8,10,66,1,17,15,2,35,17,18,-18,-15
Babel,574,2,304,2019-03-17T14:15:00Z,True,8,11,90,9,17,15,2,73,41,32,-56,-17
Babel,574,2,315,2019-03-30T12:30:00Z,True,8,12,87,2,17,15,2,74,45,29,-57,-14
Babel,574,2,328,2019-04-02T18:45:00Z,False,8,17,80,9,17,15,2,43,23,20,-26,-21
Babel,574,2,333,2019-04-13T14:00:00Z,True,8,7,82,14,17,15,2,46,28,18,-29,-3
Babel,574,2,341,2019-04-20T14:00:00Z,False,8,1,85,3,20,18,2,41,26,15,-21,-24
Babel,574,2,353,2019-04-27T14:00:00Z,True,8,4,88,9,23,18,5,31,20,11,-8,7
Babel,574,2,369,2019-05-04T14:00:00Z,False,8,19,90,2,26,21,5,54,31,23,-28,-26
Babel,574,2,373,2019-05-12T14:00:00Z,True,8,14,25,1,26,21,5,42,25,17,-16,4
Tupper,575,0,224,2019-01-19T15:00:00Z,False,6,11,0,0,22,9,13,57,28,29,-35,-15
Tupper,575,0,238,2019-01-30T19:45:00Z,False,6,15,0,0,22,9,13,22,11,11,0,2
Tupper,575,0,244,2019-02-02T15:00:00Z,True,6,8,0,0,23,9,14,17,15,2,6,7
Tupper,575,0,251,2019-02-09T15:00:00Z,True,6,18,0,0,26,12,14,32,18,14,-6,-2
Tupper,575,0,266,2019-02-23T17:30:00Z,False,6,10,0,0,27,13,14,32,14,18,-5,0
Tupper,575,0,272,2019-02-27T20:00:00Z,True,6,13,0,0,30,13,17,52,26,26,-22,-13
Tupper,575,0,282,2019-03-02T15:00:00Z,False,6,3,0,0,30,13,17,30,17,13,0,0
Tupper,575,0,293,2019-03-09T12:30:00Z,True,6,2,0,0,33,13,20,30,22,8,3,5
Tupper,575,0,314,2019-03-30T15:00:00Z,True,6,9,0,0,33,13,20,14,8,6,19,7
Tupper,575,0,306,2019-04-03T18:45:00Z,False,6,16,0,0,36,16,20,61,28,33,-25,-8
Tupper,575,0,325,2019-04-06T14:00:00Z,False,6,14,0,0,36,16,20,35,22,13,1,-2
Tupper,575,0,332,2019-04-14T13:05:00Z,True,6,12,0,0,39,16,23,80,48,32,-41,-16
Tupper,575,0,340,2019-04-21T15:00:00Z,False,6,0,0,0,39,16,23,66,44,22,-27,-21
Tupper,575,0,352,2019-04-27T14:00:00Z,True,6,7,0,0,42,16,26,49,31,18,-7,-2
Tupper,575,0,362,2019-05-04T16:30:00Z,False,6,4,0,0,43,17,26,31,20,11,12,6
Tupper,575,0,372,2019-05-12T14:00:00Z,True,6,1,0,0,46,17,29,45,29,16,1,1
Roberts,576,2,226,2019-01-19T15:00:00Z,True,14,4,0,0,18,7,11,19,14,5,-1,2
Roberts,576,2,237,2019-01-29T20:00:00Z,True,14,12,0,0,21,10,11,56,33,23,-35,-13
Roberts,576,2,248,2019-02-02T12:30:00Z,False,14,16,0,0,24,13,11,54,21,33,-30,-10
Roberts,576,2,259,2019-02-11T20:00:00Z,False,14,19,0,0,24,13,11,38,20,18,-14,-9
Roberts,576,2,268,2019-02-23T15:00:00Z,True,14,9,0,0,25,13,12,11,5,6,14,7
Roberts,576,2,278,2019-02-26T20:00:00Z,True,14,3,0,0,28,16,12,30,17,13,-2,3
Roberts,576,2,288,2019-03-02T17:30:00Z,False,14,18,0,0,31,19,12,36,21,15,-5,-9
Roberts,576,2,298,2019-03-09T15:00:00Z,True,14,7,0,0,31,19,12,37,22,15,-6,4
Roberts,576,2,300,2019-03-16T15:00:00Z,False,14,1,0,0,34,22,12,37,25,12,-3,-13
Roberts,576,2,310,2019-04-01T19:00:00Z,False,14,0,0,0,35,22,13,60,41,19,-25,-28
Roberts,576,2,325,2019-04-06T14:00:00Z,True,14,6,0,0,35,22,13,36,16,20,-1,2
Roberts,576,2,334,2019-04-12T19:00:00Z,False,14,10,0,0,35,22,13,47,23,24,-12,-10
Roberts,576,2,347,2019-04-20T16:30:00Z,True,14,15,0,0,38,22,16,36,21,15,2,7
Roberts,576,2,350,2019-04-27T16:30:00Z,False,14,2,0,0,41,25,16,34,22,12,7,-6
Roberts,576,2,367,2019-05-04T18:45:00Z,True,14,11,0,0,42,25,17,91,50,41,-49,-16
Roberts,576,2,373,2019-05-12T14:00:00Z,False,14,8,0,0,42,25,17,26,21,5,16,-4
Sterling,577,3,222,2019-01-20T16:00:00Z,False,16,8,0,0,48,18,30,14,12,2,34,18
Sterling,577,3,239,2019-01-30T20:00:00Z,True,16,17,0,0,51,18,33,33,17,16,18,2
Sterling,577,3,248,2019-02-02T12:30:00Z,True,16,14,0,0,54,21,33,24,13,11,30,10
Sterling,577,3,257,2019-02-10T13:30:00Z,True,16,10,0,0,57,24,33,32,14,18,25,6
Sterling,577,3,262,2019-02-23T12:30:00Z,False,16,3,0,0,60,27,33,27,14,13,33,19
Sterling,577,3,275,2019-02-27T20:00:00Z,False,16,5,0,0,60,27,33,50,28,22,10,5
Sterling,577,3,286,2019-03-02T12:30:00Z,True,16,0,0,0,60,27,33,56,38,18,4,9
Sterling,577,3,299,2019-03-09T15:00:00Z,False,16,15,0,0,61,28,33,27,15,12,34,18
Sterling,577,3,317,2019-03-31T15:30:00Z,False,16,11,0,0,61,28,33,76,41,35,-15,-8
Sterling,577,3,306,2019-04-03T18:45:00Z,True,16,6,0,0,61,28,33,36,16,20,25,8
Sterling,577,3,338,2019-04-13T11:30:00Z,True,16,9,0,0,64,31,33,14,8,6,50,25
Sterling,577,3,346,2019-04-20T11:30:00Z,False,16,12,0,0,67,34,33,83,48,35,-16,-15
Sterling,577,3,327,2019-04-23T18:45:00Z,True,16,2,0,0,67,34,33,34,22,12,33,22
Sterling,577,3,358,2019-04-27T11:30:00Z,True,16,18,0,0,70,37,33,43,28,15,27,22
Sterling,577,3,361,2019-05-04T11:30:00Z,False,16,1,0,0,70,37,33,42,26,16,28,7
Sterling,577,3,378,2019-05-12T14:00:00Z,True,16,7,0,0,70,37,33,53,34,19,17,18
Higuain,578,3,231,2019-01-30T19:45:00Z,False,5,1,64,2,47,25,22,30,21,9,17,1
Higuain,578,3,243,2019-02-02T15:00:00Z,True,5,9,90,13,47,25,22,11,5,6,36,19
Higuain,578,3,255,2019-02-10T16:00:00Z,False,5,12,90,2,50,28,22,62,36,26,-12,-14
Higuain,578,3,275,2019-02-27T20:00:00Z,True,5,16,83,2,50,28,22,60,27,33,-10,-5
Higuain,578,3,284,2019-03-03T14:05:00Z,False,5,8,90,8,53,31,22,17,15,2,36,7
Higuain,578,3,292,2019-03-10T14:05:00Z,True,5,19,90,2,56,31,25,43,24,19,13,12
Higuain,578,3,303,2019-03-17T16:30:00Z,False,5,7,65,2,57,32,25,37,22,15,20,3
Higuain,578,3,313,2019-03-31T13:05:00Z,False,5,4,76,2,57,32,25,28,20,8,29,5
Higuain,578,3,264,2019-04-03T18:45:00Z,True,5,2,0,0,60,32,28,33,22,11,27,21
Higuain,578,3,321,2019-04-08T19:00:00Z,True,5,18,75,2,63,35,28,42,27,15,21,20
Higuain,578,3,335,2019-04-14T15:30:00Z,False,5,11,34,1,66,38,28,82,44,38,-16,-16
Higuain,578,3,343,2019-04-22T19:00:00Z,True,5,3,76,7,66,38,28,39,23,16,27,22
Higuain,578,3,356,2019-04-28T15:30:00Z,False,5,13,90,2,67,39,28,64,35,29,3,-7
Higuain,578,3,363,2019-05-05T13:00:00Z,True,5,17,78,6,68,39,29,50,27,23,18,16
Higuain,578,3,374,2019-05-12T14:00:00Z,False,5,10,83,2,71,42,29,51,26,25,20,3
Mepham,579,1,231,2019-01-30T19:45:00Z,True,1,5,1,1,30,21,9,47,25,22,-17,-1
Mepham,579,1,242,2019-02-02T17:30:00Z,False,1,4,0,0,33,24,9,19,14,5,14,-5
Mepham,579,1,254,2019-02-09T15:00:00Z,False,1,11,10,1,33,24,9,62,32,30,-29,-23
Mepham,579,1,261,2019-02-23T15:00:00Z,True,1,19,90,2,33,24,9,39,21,18,-6,6
Mepham,579,1,270,2019-02-27T19:45:00Z,False,1,0,90,0,34,25,9,53,35,18,-19,-26
Mepham,579,1,280,2019-03-02T15:00:00Z,True,1,12,90,2,34,25,9,68,42,26,-34,-1
Mepham,579,1,294,2019-03-09T15:00:00Z,False,1,9,90,6,34,25,9,14,8,6,20,1
Mepham,579,1,300,2019-03-16T15:00:00Z,True,1,14,90,1,37,25,12,34,22,12,3,13
Mepham,579,1,316,2019-03-30T15:00:00Z,False,1,10,90,1,38,26,12,41,20,21,-3,-8
Mepham,579,1,320,2019-04-06T14:00:00Z,True,1,3,90,1,38,26,12,33,20,13,5,13
Mepham,579,1,330,2019-04-13T14:00:00Z,False,1,2,90,5,38,26,12,33,22,11,5,-10
Mepham,579,1,341,2019-04-20T14:00:00Z,True,1,8,75,2,41,26,15,20,18,2,21,24
Mepham,579,1,357,2019-04-27T14:00:00Z,False,1,15,22,1,41,26,15,37,21,16,4,-6
Mepham,579,1,361,2019-05-04T11:30:00Z,True,1,16,0,0,42,26,16,70,37,33,-28,-7
Mepham,579,1,372,2019-05-12T14:00:00Z,False,1,6,20,4,45,29,16,46,17,29,-1,-1
Jenkinson,580,1,230,2019-01-29T19:45:00Z,True,0,4,30,1,44,29,15,19,14,5,25,24
Jenkinson,580,1,247,2019-02-03T16:30:00Z,False,0,12,0,0,47,32,15,56,33,23,-9,-18
Jenkinson,580,1,253,2019-02-09T15:00:00Z,False,0,9,0,0,47,32,15,11,5,6,36,10
Jenkinson,580,1,260,2019-02-24T14:05:00Z,True,0,15,0,0,50,32,18,24,12,12,26,20
Jenkinson,580,1,270,2019-02-27T19:45:00Z,True,0,1,90,2,53,35,18,34,25,9,19,26
Jenkinson,580,1,286,2019-03-02T12:30:00Z,False,0,16,0,0,56,38,18,60,27,33,-4,-9
Jenkinson,580,1,290,2019-03-10T16:30:00Z,True,0,13,0,0,57,38,19,58,29,29,-1,9
Jenkinson,580,1,310,2019-04-01T19:00:00Z,True,0,14,0,0,60,41,19,35,22,13,25,28
Jenkinson,580,1,322,2019-04-07T13:05:00Z,False,0,7,0,0,63,44,19,43,25,18,20,-6
Jenkinson,580,1,339,2019-04-15T19:00:00Z,False,0,17,0,0,63,44,19,46,26,20,17,-7
Jenkinson,580,1,340,2019-04-21T15:00:00Z,True,0,6,45,1,66,44,22,39,16,23,27,21
Jenkinson,580,1,309,2019-04-24T18:45:00Z,False,0,19,0,0,66,44,22,48,28,20,18,-6
Jenkinson,580,1,354,2019-04-28T11:00:00Z,False,0,10,0,0,66,44,22,48,23,25,18,-1
Jenkinson,580,1,360,2019-05-05T15:30:00Z,True,0,2,0,0,66,44,22,35,23,12,31,32
Jenkinson,580,1,371,2019-05-12T14:00:00Z,False,0,3,0,0,67,45,22,40,23,17,27,-1
Burn,581,1,232,2019-01-29T19:45:00Z,False,2,8,0,0,26,18,8,14,12,2,12,-4
Burn,581,1,240,2019-02-02T15:00:00Z,True,2,17,0,0,26,18,8,33,17,16,-7,2
Burn,581,1,250,2019-02-09T17:30:00Z,True,2,3,0,0,27,19,8,24,14,10,3,9
Burn,581,1,274,2019-02-26T19:45:00Z,False,2,10,0,0,27,19,8,32,14,18,-5,-6
Burn,581,1,281,2019-03-02T15:00:00Z,True,2,9,0,0,27,19,8,14,8,6,13,13
Burn,581,1,293,2019-03-09T12:30:00Z,False,2,6,0,0,30,22,8,33,13,20,-3,-5
Burn,581,1,311,2019-03-30T15:00:00Z,True,2,15,0,0,33,22,11,30,18,12,3,10
Burn,581,1,264,2019-04-03T18:45:00Z,False,2,5,0,0,33,22,11,60,32,28,-27,-21
Burn,581,1,330,2019-04-13T14:00:00Z,True,2,1,0,0,33,22,11,38,26,12,-5,10
Burn,581,1,301,2019-04-16T18:45:00Z,True,2,4,0,0,33,22,11,28,20,8,5,14
Burn,581,1,349,2019-04-20T14:00:00Z,False,2,19,0,0,33,22,11,47,27,20,-14,-16
Burn,581,1,327,2019-04-23T18:45:00Z,False,2,16,0,0,34,22,12,67,34,33,-33,-22
Burn,581,1,350,2019-04-27T16:30:00Z,True,2,14,0,0,34,22,12,41,25,16,-7,6
Burn,581,1,360,2019-05-05T15:30:00Z,False,2,0,0,0,35,23,12,66,44,22,-31,-32
Burn,581,1,370,2019-05-12T14:00:00Z,True,2,12,0,0,36,23,13,95,54,41,-59,-18
Benson,582,2,234,2019-01-29T20:00:00Z,False,3,13,0,0,22,13,9,44,24,20,-22,-15
Benson,582,2,241,2019-02-02T15:00:00Z,True,3,15,0,0,23,13,10,23,12,11,0,2
Benson,582,2,250,2019-02-09T17:30:00Z,False,3,2,0,0,24,14,10,27,19,8,-3,-9
Benson,582,2,262,2019-02-23T12:30:00Z,True,3,16,0,0,27,14,13,60,27,33,-33,-19
Benson,582,2,278,2019-02-26T20:00:00Z,False,3,14,0,0,30,17,13,28,16,12,2,-3
Benson,582,2,282,2019-03-02T15:00:00Z,True,3,6,0,0,30,17,13,30,13,17,0,0
Benson,582,2,296,2019-03-10T12:00:00Z,False,3,11,0,0,30,17,13,70,38,32,-40,-25
Benson,582,2,302,2019-03-16T15:00:00Z,True,3,10,0,0,30,17,13,38,20,18,-8,-1
Benson,582,2,312,2019-03-30T15:00:00Z,True,3,19,0,0,30,17,13,44,24,20,-14,-3
Benson,582,2,320,2019-04-06T14:00:00Z,False,3,1,0,0,33,20,13,38,26,12,-5,-13
Benson,582,2,331,2019-04-13T14:00:00Z,True,3,4,0,0,36,20,16,28,20,8,8,12
Benson,582,2,343,2019-04-22T19:00:00Z,False,3,5,0,0,39,23,16,66,38,28,-27,-22
Benson,582,2,351,2019-04-28T13:05:00Z,True,3,12,0,0,40,23,17,89,51,38,-49,-15
Benson,582,2,364,2019-05-03T19:00:00Z,False,3,7,0,0,40,23,17,50,31,19,-10,-14
Benson,582,2,371,2019-05-12T14:00:00Z,True,3,0,0,0,40,23,17,67,45,22,-27,1
Perri,583,0,244,2019-02-02T15:00:00Z,True,6,8,0,0,23,9,14,17,15,2,6,7
Perri,583,0,251,2019-02-09T15:00:00Z,True,6,18,0,0,26,12,14,32,18,14,-6,-2
Perri,583,0,266,2019-02-23T17:30:00Z,False,6,10,0,0,27,13,14,32,14,18,-5,0
Perri,583,0,272,2019-02-27T20:00:00Z,True,6,13,0,0,30,13,17,52,26,26,-22,-13
Perri,583,0,282,2019-03-02T15:00:00Z,False,6,3,0,0,30,13,17,30,17,13,0,0
Perri,583,0,293,2019-03-09T12:30:00Z,True,6,2,0,0,33,13,20,30,22,8,3,5
Perri,583,0,314,2019-03-30T15:00:00Z,True,6,9,0,0,33,13,20,14,8,6,19,7
Perri,583,0,306,2019-04-03T18:45:00Z,False,6,16,0,0,36,16,20,61,28,33,-25,-8
Perri,583,0,325,2019-04-06T14:00:00Z,False,6,14,0,0,36,16,20,35,22,13,1,-2
Perri,583,0,332,2019-04-14T13:05:00Z,True,6,12,0,0,39,16,23,80,48,32,-41,-16
Perri,583,0,340,2019-04-21T15:00:00Z,False,6,0,0,0,39,16,23,66,44,22,-27,-21
Perri,583,0,352,2019-04-27T14:00:00Z,True,6,7,0,0,42,16,26,49,31,18,-7,-2
Perri,583,0,362,2019-05-04T16:30:00Z,False,6,4,0,0,43,17,26,31,20,11,12,6
Perri,583,0,372,2019-05-12T14:00:00Z,True,6,1,0,0,46,17,29,45,29,16,1,1
Grant,584,3,243,2019-02-02T15:00:00Z,False,9,5,23,1,11,5,6,47,25,22,-36,-19
Grant,584,3,253,2019-02-09T15:00:00Z,True,9,0,7,1,11,5,6,47,32,15,-36,-10
Grant,584,3,268,2019-02-23T15:00:00Z,False,9,14,0,0,11,5,6,25,13,12,-14,-7
Grant,584,3,273,2019-02-26T19:45:00Z,True,9,19,90,5,11,5,6,40,21,19,-29,-14
Grant,584,3,281,2019-03-02T15:00:00Z,False,9,2,90,2,14,8,6,27,19,8,-13,-13
Grant,584,3,294,2019-03-09T15:00:00Z,True,9,1,29,1,14,8,6,34,25,9,-20,-1
Grant,584,3,308,2019-03-16T15:00:00Z,False,9,18,69,13,14,8,6,39,24,15,-25,-18
Grant,584,3,314,2019-03-30T15:00:00Z,False,9,6,90,2,14,8,6,33,13,20,-19,-7
Grant,584,3,323,2019-04-06T14:00:00Z,True,9,10,90,5,14,8,6,44,23,21,-30,-13
Grant,584,3,338,2019-04-13T11:30:00Z,False,9,16,90,2,14,8,6,64,31,33,-50,-25
Grant,584,3,345,2019-04-20T14:00:00Z,True,9,17,25,7,14,8,6,46,26,20,-32,-12
Grant,584,3,355,2019-04-26T19:00:00Z,False,9,11,90,2,14,8,6,88,47,41,-74,-41
Grant,584,3,365,2019-05-05T13:00:00Z,True,9,13,90,2,14,8,6,65,36,29,-51,-21
Grant,584,3,377,2019-05-12T14:00:00Z,False,9,15,90,2,15,9,6,38,22,16,-23,-16
Suarez,585,2,247,2019-02-03T16:30:00Z,False,0,12,24,1,47,32,15,56,33,23,-9,-18
Suarez,585,2,253,2019-02-09T15:00:00Z,False,0,9,14,1,47,32,15,11,5,6,36,10
Suarez,585,2,260,2019-02-24T14:05:00Z,True,0,15,0,0,50,32,18,24,12,12,26,20
Suarez,585,2,270,2019-02-27T19:45:00Z,True,0,1,19,1,53,35,18,34,25,9,19,26
Suarez,585,2,286,2019-03-02T12:30:00Z,False,0,16,0,0,56,38,18,60,27,33,-4,-9
Suarez,585,2,290,2019-03-10T16:30:00Z,True,0,13,10,1,57,38,19,58,29,29,-1,9
Suarez,585,2,310,2019-04-01T19:00:00Z,True,0,14,0,0,60,41,19,35,22,13,25,28
Suarez,585,2,322,2019-04-07T13:05:00Z,False,0,7,0,0,63,44,19,43,25,18,20,-6
Suarez,585,2,339,2019-04-15T19:00:00Z,False,0,17,0,0,63,44,19,46,26,20,17,-7
Suarez,585,2,340,2019-04-21T15:00:00Z,True,0,6,0,0,66,44,22,39,16,23,27,21
Suarez,585,2,309,2019-04-24T18:45:00Z,False,0,19,0,0,66,44,22,48,28,20,18,-6
Suarez,585,2,354,2019-04-28T11:00:00Z,False,0,10,0,0,66,44,22,48,23,25,18,-1
Suarez,585,2,360,2019-05-05T15:30:00Z,True,0,2,0,0,66,44,22,35,23,12,31,32
Suarez,585,2,371,2019-05-12T14:00:00Z,False,0,3,0,0,67,45,22,40,23,17,27,-1
Almiron,586,2,248,2019-02-02T12:30:00Z,False,14,16,0,0,24,13,11,54,21,33,-30,-10
Almiron,586,2,259,2019-02-11T20:00:00Z,False,14,19,18,1,24,13,11,38,20,18,-14,-9
Almiron,586,2,268,2019-02-23T15:00:00Z,True,14,9,80,3,25,13,12,11,5,6,14,7
Almiron,586,2,278,2019-02-26T20:00:00Z,True,14,3,79,3,28,16,12,30,17,13,-2,3
Almiron,586,2,288,2019-03-02T17:30:00Z,False,14,18,90,2,31,19,12,36,21,15,-5,-9
Almiron,586,2,298,2019-03-09T15:00:00Z,True,14,7,90,5,31,19,12,37,22,15,-6,4
Almiron,586,2,300,2019-03-16T15:00:00Z,False,14,1,81,5,34,22,12,37,25,12,-3,-13
Almiron,586,2,310,2019-04-01T19:00:00Z,False,14,0,90,2,35,22,13,60,41,19,-25,-28
Almiron,586,2,325,2019-04-06T14:00:00Z,True,14,6,90,2,35,22,13,36,16,20,-1,2
Almiron,586,2,334,2019-04-12T19:00:00Z,False,14,10,77,3,35,22,13,47,23,24,-12,-10
Almiron,586,2,347,2019-04-20T16:30:00Z,True,14,15,63,2,38,22,16,36,21,15,2,7
Almiron,586,2,350,2019-04-27T16:30:00Z,False,14,2,0,0,41,25,16,34,22,12,7,-6
Almiron,586,2,367,2019-05-04T18:45:00Z,True,14,11,0,0,42,25,17,91,50,41,-49,-16
Almiron,586,2,373,2019-05-12T14:00:00Z,False,14,8,0,0,42,25,17,26,21,5,16,-4
Barreca,587,1,248,2019-02-02T12:30:00Z,False,14,16,4,1,24,13,11,54,21,33,-30,-10
Barreca,587,1,259,2019-02-11T20:00:00Z,False,14,19,0,0,24,13,11,38,20,18,-14,-9
Barreca,587,1,268,2019-02-23T15:00:00Z,True,14,9,0,0,25,13,12,11,5,6,14,7
Barreca,587,1,278,2019-02-26T20:00:00Z,True,14,3,0,0,28,16,12,30,17,13,-2,3
Barreca,587,1,288,2019-03-02T17:30:00Z,False,14,18,0,0,31,19,12,36,21,15,-5,-9
Barreca,587,1,298,2019-03-09T15:00:00Z,True,14,7,0,0,31,19,12,37,22,15,-6,4
Barreca,587,1,300,2019-03-16T15:00:00Z,False,14,1,0,0,34,22,12,37,25,12,-3,-13
Barreca,587,1,310,2019-04-01T19:00:00Z,False,14,0,0,0,35,22,13,60,41,19,-25,-28
Barreca,587,1,325,2019-04-06T14:00:00Z,True,14,6,0,0,35,22,13,36,16,20,-1,2
Barreca,587,1,334,2019-04-12T19:00:00Z,False,14,10,0,0,35,22,13,47,23,24,-12,-10
Barreca,587,1,347,2019-04-20T16:30:00Z,True,14,15,0,0,38,22,16,36,21,15,2,7
Barreca,587,1,350,2019-04-27T16:30:00Z,False,14,2,0,0,41,25,16,34,22,12,7,-6
Barreca,587,1,367,2019-05-04T18:45:00Z,True,14,11,0,0,42,25,17,91,50,41,-49,-16
Barreca,587,1,373,2019-05-12T14:00:00Z,False,14,8,0,0,42,25,17,26,21,5,16,-4
Bacuna,588,1,242,2019-02-02T17:30:00Z,True,4,1,4,1,19,14,5,33,24,9,-14,5
Bacuna,588,1,256,2019-02-09T15:00:00Z,False,4,15,28,1,22,17,5,24,12,12,-2,-7
Bacuna,588,1,263,2019-02-22T19:45:00Z,True,4,17,90,0,25,17,8,37,20,17,-12,0
Bacuna,588,1,271,2019-02-26T19:45:00Z,True,4,7,90,0,25,17,8,33,21,12,-8,5
Bacuna,588,1,289,2019-03-02T15:00:00Z,False,4,19,0,0,25,17,8,40,21,19,-15,-13
Bacuna,588,1,291,2019-03-09T15:00:00Z,True,4,18,28,1,25,17,8,39,24,15,-14,2
Bacuna,588,1,313,2019-03-31T13:05:00Z,True,4,5,0,0,28,20,8,57,32,25,-29,-5
Bacuna,588,1,324,2019-04-03T18:45:00Z,False,4,12,9,1,28,20,8,77,45,32,-49,-37
Bacuna,588,1,331,2019-04-13T14:00:00Z,False,4,3,0,0,28,20,8,36,20,16,-8,-12
Bacuna,588,1,301,2019-04-16T18:45:00Z,False,4,2,35,1,28,20,8,33,22,11,-5,-14
Bacuna,588,1,342,2019-04-21T15:00:00Z,True,4,11,11,1,31,20,11,85,47,38,-54,-18
Bacuna,588,1,353,2019-04-27T14:00:00Z,False,4,8,90,2,31,20,11,23,18,5,8,-7
Bacuna,588,1,362,2019-05-04T16:30:00Z,True,4,6,79,4,31,20,11,43,17,26,-12,-6
Bacuna,588,1,376,2019-05-12T14:00:00Z,False,4,13,90,5,31,20,11,66,36,30,-35,-25
Crouch,589,3,241,2019-02-02T15:00:00Z,True,3,15,14,4,23,13,10,23,12,11,0,2
Crouch,589,3,250,2019-02-09T17:30:00Z,False,3,2,0,0,24,14,10,27,19,8,-3,-9
Crouch,589,3,262,2019-02-23T12:30:00Z,True,3,16,0,0,27,14,13,60,27,33,-33,-19
Crouch,589,3,278,2019-02-26T20:00:00Z,False,3,14,19,0,30,17,13,28,16,12,2,-3
Crouch,589,3,282,2019-03-02T15:00:00Z,True,3,6,9,1,30,17,13,30,13,17,0,0
Crouch,589,3,296,2019-03-10T12:00:00Z,False,3,11,11,1,30,17,13,70,38,32,-40,-25
Crouch,589,3,302,2019-03-16T15:00:00Z,True,3,10,20,1,30,17,13,38,20,18,-8,-1
Crouch,589,3,312,2019-03-30T15:00:00Z,True,3,19,0,0,30,17,13,44,24,20,-14,-3
Crouch,589,3,320,2019-04-06T14:00:00Z,False,3,1,0,0,33,20,13,38,26,12,-5,-13
Crouch,589,3,331,2019-04-13T14:00:00Z,True,3,4,0,0,36,20,16,28,20,8,8,12
Crouch,589,3,343,2019-04-22T19:00:00Z,False,3,5,0,0,39,23,16,66,38,28,-27,-22
Crouch,589,3,351,2019-04-28T13:05:00Z,True,3,12,0,0,40,23,17,89,51,38,-49,-15
Crouch,589,3,364,2019-05-03T19:00:00Z,False,3,7,0,0,40,23,17,50,31,19,-10,-14
Crouch,589,3,371,2019-05-12T14:00:00Z,True,3,0,13,1,40,23,17,67,45,22,-27,1
Tielemans,590,2,246,2019-02-03T14:05:00Z,True,10,13,0,0,32,14,18,45,25,20,-13,-6
Tielemans,590,2,257,2019-02-10T13:30:00Z,False,10,16,90,1,32,14,18,57,24,33,-25,-6
Tielemans,590,2,266,2019-02-23T17:30:00Z,True,10,6,73,2,32,14,18,27,13,14,5,0
Tielemans,590,2,274,2019-02-26T19:45:00Z,True,10,2,68,5,32,14,18,27,19,8,5,6
Tielemans,590,2,287,2019-03-03T12:00:00Z,False,10,17,81,5,35,17,18,40,20,20,-5,-2
Tielemans,590,2,295,2019-03-09T15:00:00Z,True,10,8,71,9,35,17,18,17,15,2,18,15
Tielemans,590,2,302,2019-03-16T15:00:00Z,False,10,3,90,5,38,20,18,30,17,13,8,1
Tielemans,590,2,316,2019-03-30T15:00:00Z,True,10,1,90,7,41,20,21,38,26,12,3,8
Tielemans,590,2,323,2019-04-06T14:00:00Z,False,10,9,90,9,44,23,21,14,8,6,30,13
Tielemans,590,2,334,2019-04-12T19:00:00Z,True,10,14,90,1,47,23,24,35,22,13,12,10
Tielemans,590,2,348,2019-04-20T14:00:00Z,False,10,18,90,5,47,23,24,42,27,15,5,-3
Tielemans,590,2,354,2019-04-28T11:00:00Z,True,10,0,90,9,48,23,25,66,44,22,-18,1
Tielemans,590,2,366,2019-05-06T19:00:00Z,False,10,12,74,2,51,26,25,92,51,41,-41,-26
Tielemans,590,2,374,2019-05-12T14:00:00Z,True,10,5,90,3,51,26,25,71,42,29,-20,-3
Batshuayi,591,3,244,2019-02-02T15:00:00Z,True,6,8,8,4,23,9,14,17,15,2,6,7
Batshuayi,591,3,251,2019-02-09T15:00:00Z,True,6,18,30,1,26,12,14,32,18,14,-6,-2
Batshuayi,591,3,266,2019-02-23T17:30:00Z,False,6,10,85,7,27,13,14,32,14,18,-5,0
Batshuayi,591,3,272,2019-02-27T20:00:00Z,True,6,13,77,2,30,13,17,52,26,26,-22,-13
Batshuayi,591,3,282,2019-03-02T15:00:00Z,False,6,3,82,7,30,13,17,30,17,13,0,0
Batshuayi,591,3,293,2019-03-09T12:30:00Z,True,6,2,90,2,33,13,20,30,22,8,3,5
Batshuayi,591,3,314,2019-03-30T15:00:00Z,True,6,9,72,2,33,13,20,14,8,6,19,7
Batshuayi,591,3,306,2019-04-03T18:45:00Z,False,6,16,80,2,36,16,20,61,28,33,-25,-8
Batshuayi,591,3,325,2019-04-06T14:00:00Z,False,6,14,64,2,36,16,20,35,22,13,1,-2
Batshuayi,591,3,332,2019-04-14T13:05:00Z,True,6,12,0,0,39,16,23,80,48,32,-41,-16
Batshuayi,591,3,340,2019-04-21T15:00:00Z,False,6,0,0,0,39,16,23,66,44,22,-27,-21
Batshuayi,591,3,352,2019-04-27T14:00:00Z,True,6,7,0,0,42,16,26,49,31,18,-7,-2
Batshuayi,591,3,362,2019-05-04T16:30:00Z,False,6,4,72,6,43,17,26,31,20,11,12,6
Batshuayi,591,3,372,2019-05-12T14:00:00Z,True,6,1,88,13,46,17,29,45,29,16,1,1
Nordtveit,592,1,244,2019-02-02T15:00:00Z,False,8,6,0,0,17,15,2,23,9,14,-6,-7
Nordtveit,592,1,252,2019-02-09T12:30:00Z,True,8,13,0,0,17,15,2,48,25,23,-31,-8
Nordtveit,592,1,269,2019-02-22T19:45:00Z,False,8,18,90,1,17,15,2,33,18,15,-16,-16
Nordtveit,592,1,279,2019-02-27T19:45:00Z,False,8,15,90,1,17,15,2,24,12,12,-7,-10
Nordtveit,592,1,284,2019-03-03T14:05:00Z,True,8,5,90,1,17,15,2,53,31,22,-36,-7
Nordtveit,592,1,295,2019-03-09T15:00:00Z,False,8,10,90,4,17,15,2,35,17,18,-18,-15
Nordtveit,592,1,304,2019-03-17T14:15:00Z,True,8,11,0,0,17,15,2,73,41,32,-56,-17
Nordtveit,592,1,315,2019-03-30T12:30:00Z,True,8,12,0,0,17,15,2,74,45,29,-57,-14
Nordtveit,592,1,328,2019-04-02T18:45:00Z,False,8,17,0,0,17,15,2,43,23,20,-26,-21
Nordtveit,592,1,333,2019-04-13T14:00:00Z,True,8,7,0,0,17,15,2,46,28,18,-29,-3
Nordtveit,592,1,341,2019-04-20T14:00:00Z,False,8,1,1,1,20,18,2,41,26,15,-21,-24
Nordtveit,592,1,353,2019-04-27T14:00:00Z,True,8,4,0,0,23,18,5,31,20,11,-8,7
Nordtveit,592,1,369,2019-05-04T14:00:00Z,False,8,19,0,0,26,21,5,54,31,23,-28,-26
Nordtveit,592,1,373,2019-05-12T14:00:00Z,True,8,14,0,0,26,21,5,42,25,17,-16,4
Markovic,593,2,244,2019-02-02T15:00:00Z,False,8,6,0,0,17,15,2,23,9,14,-6,-7
Markovic,593,2,252,2019-02-09T12:30:00Z,True,8,13,0,0,17,15,2,48,25,23,-31,-8
Markovic,593,2,269,2019-02-22T19:45:00Z,False,8,18,45,1,17,15,2,33,18,15,-16,-16
Markovic,593,2,279,2019-02-27T19:45:00Z,False,8,15,0,0,17,15,2,24,12,12,-7,-10
Markovic,593,2,284,2019-03-03T14:05:00Z,True,8,5,0,0,17,15,2,53,31,22,-36,-7
Markovic,593,2,295,2019-03-09T15:00:00Z,False,8,10,0,0,17,15,2,35,17,18,-18,-15
Markovic,593,2,304,2019-03-17T14:15:00Z,True,8,11,0,0,17,15,2,73,41,32,-56,-17
Markovic,593,2,315,2019-03-30T12:30:00Z,True,8,12,0,0,17,15,2,74,45,29,-57,-14
Markovic,593,2,328,2019-04-02T18:45:00Z,False,8,17,0,0,17,15,2,43,23,20,-26,-21
Markovic,593,2,333,2019-04-13T14:00:00Z,True,8,7,0,0,17,15,2,46,28,18,-29,-3
Markovic,593,2,341,2019-04-20T14:00:00Z,False,8,1,0,0,20,18,2,41,26,15,-21,-24
Markovic,593,2,353,2019-04-27T14:00:00Z,True,8,4,0,0,23,18,5,31,20,11,-8,7
Markovic,593,2,369,2019-05-04T14:00:00Z,False,8,19,0,0,26,21,5,54,31,23,-28,-26
Markovic,593,2,373,2019-05-12T14:00:00Z,True,8,14,0,0,26,21,5,42,25,17,-16,4
Jones,594,1,241,2019-02-02T15:00:00Z,False,15,3,0,0,23,12,11,23,13,10,0,-2
Jones,594,1,256,2019-02-09T15:00:00Z,True,15,4,0,0,24,12,12,22,17,5,2,7
Jones,594,1,260,2019-02-24T14:05:00Z,False,15,0,0,0,24,12,12,50,32,18,-26,-20
Jones,594,1,279,2019-02-27T19:45:00Z,True,15,8,0,0,24,12,12,17,15,2,7,10
Jones,594,1,285,2019-03-02T15:00:00Z,False,15,13,0,0,27,15,12,55,26,29,-28,-14
Jones,594,1,299,2019-03-09T15:00:00Z,True,15,16,0,0,27,15,12,61,28,33,-34,-18
Jones,594,1,311,2019-03-30T15:00:00Z,False,15,2,0,0,30,18,12,33,22,11,-3,-10
Jones,594,1,326,2019-04-05T19:00:00Z,True,15,11,0,0,33,18,15,79,44,35,-46,-17
Jones,594,1,337,2019-04-13T14:00:00Z,True,15,19,0,0,33,18,15,47,27,20,-14,-2
Jones,594,1,347,2019-04-20T16:30:00Z,False,15,14,0,0,36,21,15,38,22,16,-2,-7
Jones,594,1,307,2019-04-23T18:45:00Z,False,15,17,0,0,36,21,15,49,26,23,-13,-11
Jones,594,1,357,2019-04-27T14:00:00Z,True,15,1,0,0,37,21,16,41,26,15,-4,6
Jones,594,1,368,2019-05-04T14:00:00Z,False,15,18,0,0,38,22,16,46,28,18,-8,-12
Jones,594,1,377,2019-05-12T14:00:00Z,True,15,9,0,0,38,22,16,15,9,6,23,16
John,595,1,245,2019-02-02T15:00:00Z,False,19,7,0,0,35,20,15,33,21,12,2,-6
John,595,1,259,2019-02-11T20:00:00Z,True,19,14,0,0,38,20,18,24,13,11,14,9
John,595,1,261,2019-02-23T15:00:00Z,False,19,1,0,0,39,21,18,33,24,9,6,-6
John,595,1,273,2019-02-26T19:45:00Z,False,19,9,0,0,40,21,19,11,5,6,29,14
John,595,1,289,2019-03-02T15:00:00Z,True,19,4,0,0,40,21,19,25,17,8,15,13
John,595,1,292,2019-03-10T14:05:00Z,False,19,5,0,0,43,24,19,56,31,25,-13,-12
John,595,1,312,2019-03-30T15:00:00Z,False,19,3,0,0,44,24,20,30,17,13,14,3
John,595,1,329,2019-04-02T18:45:00Z,True,19,13,0,0,44,24,20,61,32,29,-17,-5
John,595,1,337,2019-04-13T14:00:00Z,False,19,15,0,0,47,27,20,33,18,15,14,2
John,595,1,349,2019-04-20T14:00:00Z,True,19,2,0,0,47,27,20,33,22,11,14,16
John,595,1,309,2019-04-24T18:45:00Z,True,19,0,0,0,48,28,20,66,44,22,-18,6
John,595,1,359,2019-04-27T14:00:00Z,False,19,17,0,0,51,31,20,50,27,23,1,-7
John,595,1,369,2019-05-04T14:00:00Z,True,19,8,0,0,54,31,23,26,21,5,28,26
John,595,1,375,2019-05-12T14:00:00Z,False,19,11,0,0,57,34,23,94,50,44,-37,-27
Jones,596,2,249,2019-02-04T20:00:00Z,False,11,18,0,0,61,32,29,31,17,14,30,12
Jones,596,2,254,2019-02-09T15:00:00Z,True,11,1,0,0,62,32,30,33,24,9,29,23
Jones,596,2,267,2019-02-24T14:05:00Z,False,11,13,0,0,65,35,30,51,25,26,14,5
Jones,596,2,276,2019-02-27T20:00:00Z,True,11,17,0,0,66,35,31,40,20,20,26,15
Jones,596,2,283,2019-03-03T16:15:00Z,False,11,7,0,0,69,38,31,36,21,15,33,10
Jones,596,2,296,2019-03-10T12:00:00Z,True,11,3,0,0,70,38,32,30,17,13,40,25
Jones,596,2,304,2019-03-17T14:15:00Z,False,11,8,0,0,73,41,32,17,15,2,56,17
Jones,596,2,317,2019-03-31T15:30:00Z,True,11,16,0,0,76,41,35,61,28,33,15,8
Jones,596,2,326,2019-04-05T19:00:00Z,False,11,15,0,0,79,44,35,33,18,15,46,17
Jones,596,2,335,2019-04-14T15:30:00Z,True,11,5,0,0,82,44,38,66,38,28,16,16
Jones,596,2,342,2019-04-21T15:00:00Z,False,11,4,0,0,85,47,38,31,20,11,54,18
Jones,596,2,355,2019-04-26T19:00:00Z,True,11,9,0,0,88,47,41,14,8,6,74,41
Jones,596,2,367,2019-05-04T18:45:00Z,False,11,14,0,0,91,50,41,42,25,17,49,16
Jones,596,2,375,2019-05-12T14:00:00Z,True,11,19,0,0,94,50,44,57,34,23,37,27
Coleman,597,0,253,2019-02-09T15:00:00Z,True,9,0,0,0,11,5,6,47,32,15,-36,-10
Coleman,597,0,268,2019-02-23T15:00:00Z,False,9,14,0,0,11,5,6,25,13,12,-14,-7
Coleman,597,0,273,2019-02-26T19:45:00Z,True,9,19,0,0,11,5,6,40,21,19,-29,-14
Coleman,597,0,281,2019-03-02T15:00:00Z,False,9,2,0,0,14,8,6,27,19,8,-13,-13
Coleman,597,0,294,2019-03-09T15:00:00Z,True,9,1,0,0,14,8,6,34,25,9,-20,-1
Coleman,597,0,308,2019-03-16T15:00:00Z,False,9,18,0,0,14,8,6,39,24,15,-25,-18
Coleman,597,0,314,2019-03-30T15:00:00Z,False,9,6,0,0,14,8,6,33,13,20,-19,-7
Coleman,597,0,323,2019-04-06T14:00:00Z,True,9,10,0,0,14,8,6,44,23,21,-30,-13
Coleman,597,0,338,2019-04-13T11:30:00Z,False,9,16,0,0,14,8,6,64,31,33,-50,-25
Coleman,597,0,345,2019-04-20T14:00:00Z,True,9,17,0,0,14,8,6,46,26,20,-32,-12
Coleman,597,0,355,2019-04-26T19:00:00Z,False,9,11,0,0,14,8,6,88,47,41,-74,-41
Coleman,597,0,365,2019-05-05T13:00:00Z,True,9,13,0,0,14,8,6,65,36,29,-51,-21
Coleman,597,0,377,2019-05-12T14:00:00Z,False,9,15,90,2,15,9,6,38,22,16,-23,-16
Surridge,598,3,254,2019-02-09T15:00:00Z,False,1,11,0,0,33,24,9,62,32,30,-29,-23
Surridge,598,3,261,2019-02-23T15:00:00Z,True,1,19,0,0,33,24,9,39,21,18,-6,6
Surridge,598,3,270,2019-02-27T19:45:00Z,False,1,0,10,1,34,25,9,53,35,18,-19,-26
Surridge,598,3,280,2019-03-02T15:00:00Z,True,1,12,0,0,34,25,9,68,42,26,-34,-1
Surridge,598,3,294,2019-03-09T15:00:00Z,False,1,9,0,0,34,25,9,14,8,6,20,1
Surridge,598,3,300,2019-03-16T15:00:00Z,True,1,14,0,0,37,25,12,34,22,12,3,13
Surridge,598,3,316,2019-03-30T15:00:00Z,False,1,10,0,0,38,26,12,41,20,21,-3,-8
Surridge,598,3,320,2019-04-06T14:00:00Z,True,1,3,0,0,38,26,12,33,20,13,5,13
Surridge,598,3,330,2019-04-13T14:00:00Z,False,1,2,0,0,38,26,12,33,22,11,5,-10
Surridge,598,3,341,2019-04-20T14:00:00Z,True,1,8,0,0,41,26,15,20,18,2,21,24
Surridge,598,3,357,2019-04-27T14:00:00Z,False,1,15,0,0,41,26,15,37,21,16,4,-6
Surridge,598,3,361,2019-05-04T11:30:00Z,True,1,16,0,0,42,26,16,70,37,33,-28,-7
Surridge,598,3,372,2019-05-12T14:00:00Z,False,1,6,1,1,45,29,16,46,17,29,-1,-1
Taylor,599,2,254,2019-02-09T15:00:00Z,False,1,11,0,0,33,24,9,62,32,30,-29,-23
Taylor,599,2,261,2019-02-23T15:00:00Z,True,1,19,0,0,33,24,9,39,21,18,-6,6
Taylor,599,2,270,2019-02-27T19:45:00Z,False,1,0,0,0,34,25,9,53,35,18,-19,-26
Taylor,599,2,280,2019-03-02T15:00:00Z,True,1,12,0,0,34,25,9,68,42,26,-34,-1
Taylor,599,2,294,2019-03-09T15:00:00Z,False,1,9,0,0,34,25,9,14,8,6,20,1
Taylor,599,2,300,2019-03-16T15:00:00Z,True,1,14,0,0,37,25,12,34,22,12,3,13
Taylor,599,2,316,2019-03-30T15:00:00Z,False,1,10,0,0,38,26,12,41,20,21,-3,-8
Taylor,599,2,320,2019-04-06T14:00:00Z,True,1,3,0,0,38,26,12,33,20,13,5,13
Taylor,599,2,330,2019-04-13T14:00:00Z,False,1,2,0,0,38,26,12,33,22,11,5,-10
Taylor,599,2,341,2019-04-20T14:00:00Z,True,1,8,0,0,41,26,15,20,18,2,21,24
Taylor,599,2,357,2019-04-27T14:00:00Z,False,1,15,0,0,41,26,15,37,21,16,4,-6
Taylor,599,2,361,2019-05-04T11:30:00Z,True,1,16,0,0,42,26,16,70,37,33,-28,-7
Taylor,599,2,372,2019-05-12T14:00:00Z,False,1,6,0,0,45,29,16,46,17,29,-1,-1
Duhaney,600,1,273,2019-02-26T19:45:00Z,True,9,19,45,1,11,5,6,40,21,19,-29,-14
Duhaney,600,1,281,2019-03-02T15:00:00Z,False,9,2,0,0,14,8,6,27,19,8,-13,-13
Duhaney,600,1,294,2019-03-09T15:00:00Z,True,9,1,0,0,14,8,6,34,25,9,-20,-1
Duhaney,600,1,308,2019-03-16T15:00:00Z,False,9,18,0,0,14,8,6,39,24,15,-25,-18
Duhaney,600,1,314,2019-03-30T15:00:00Z,False,9,6,0,0,14,8,6,33,13,20,-19,-7
Duhaney,600,1,323,2019-04-06T14:00:00Z,True,9,10,0,0,14,8,6,44,23,21,-30,-13
Duhaney,600,1,338,2019-04-13T11:30:00Z,False,9,16,0,0,14,8,6,64,31,33,-50,-25
Duhaney,600,1,345,2019-04-20T14:00:00Z,True,9,17,0,0,14,8,6,46,26,20,-32,-12
Duhaney,600,1,355,2019-04-26T19:00:00Z,False,9,11,0,0,14,8,6,88,47,41,-74,-41
Duhaney,600,1,365,2019-05-05T13:00:00Z,True,9,13,0,0,14,8,6,65,36,29,-51,-21
Duhaney,600,1,377,2019-05-12T14:00:00Z,False,9,15,0,0,15,9,6,38,22,16,-23,-16
Garner,601,2,272,2019-02-27T20:00:00Z,False,13,6,1,1,52,26,26,30,13,17,22,13
Garner,601,2,285,2019-03-02T15:00:00Z,True,13,15,0,0,55,26,29,27,15,12,28,14
Garner,601,2,290,2019-03-10T16:30:00Z,False,13,0,0,0,58,29,29,57,38,19,1,-9
Garner,601,2,318,2019-03-30T15:00:00Z,True,13,17,0,0,58,29,29,43,23,20,15,9
Garner,601,2,329,2019-04-02T18:45:00Z,False,13,19,0,0,61,32,29,44,24,20,17,5
Garner,601,2,336,2019-04-13T16:30:00Z,True,13,18,0,0,61,32,29,42,27,15,19,17
Garner,601,2,344,2019-04-21T12:30:00Z,False,13,7,0,0,64,35,29,46,28,18,18,1
Garner,601,2,305,2019-04-24T19:00:00Z,True,13,12,0,0,64,35,29,86,51,35,-22,0
Garner,601,2,356,2019-04-28T15:30:00Z,True,13,5,0,0,64,35,29,67,39,28,-3,7
Garner,601,2,365,2019-05-05T13:00:00Z,False,13,9,0,0,65,36,29,14,8,6,51,21
Garner,601,2,376,2019-05-12T14:00:00Z,True,13,4,0,0,66,36,30,31,20,11,35,25
Chong,602,2,272,2019-02-27T20:00:00Z,False,13,6,0,0,52,26,26,30,13,17,22,13
Chong,602,2,285,2019-03-02T15:00:00Z,True,13,15,1,1,55,26,29,27,15,12,28,14
Chong,602,2,290,2019-03-10T16:30:00Z,False,13,0,0,0,58,29,29,57,38,19,1,-9
Chong,602,2,318,2019-03-30T15:00:00Z,True,13,17,0,0,58,29,29,43,23,20,15,9
Chong,602,2,329,2019-04-02T18:45:00Z,False,13,19,0,0,61,32,29,44,24,20,17,5
Chong,602,2,336,2019-04-13T16:30:00Z,True,13,18,0,0,61,32,29,42,27,15,19,17
Chong,602,2,344,2019-04-21T12:30:00Z,False,13,7,0,0,64,35,29,46,28,18,18,1
Chong,602,2,305,2019-04-24T19:00:00Z,True,13,12,0,0,64,35,29,86,51,35,-22,0
Chong,602,2,356,2019-04-28T15:30:00Z,True,13,5,0,0,64,35,29,67,39,28,-3,7
Chong,602,2,365,2019-05-05T13:00:00Z,False,13,9,36,1,65,36,29,14,8,6,51,21
Chong,602,2,376,2019-05-12T14:00:00Z,True,13,4,0,0,66,36,30,31,20,11,35,25
Sandler,603,1,277,2019-02-27T20:00:00Z,True,12,18,0,0,65,39,26,36,21,15,29,24
Sandler,603,1,280,2019-03-02T15:00:00Z,False,12,1,0,0,68,42,26,34,25,9,34,1
Sandler,603,1,297,2019-03-09T17:30:00Z,True,12,17,0,0,71,42,29,43,23,20,28,22
Sandler,603,1,315,2019-03-30T12:30:00Z,False,12,8,0,0,74,45,29,17,15,2,57,14
Sandler,603,1,324,2019-04-03T18:45:00Z,True,12,4,0,0,77,45,32,28,20,8,49,37
Sandler,603,1,332,2019-04-14T13:05:00Z,False,12,6,0,0,80,48,32,39,16,23,41,16
Sandler,603,1,346,2019-04-20T11:30:00Z,True,12,16,0,0,83,48,35,67,34,33,16,15
Sandler,603,1,305,2019-04-24T19:00:00Z,False,12,13,0,0,86,51,35,64,35,29,22,0
Sandler,603,1,351,2019-04-28T13:05:00Z,False,12,3,0,0,89,51,38,40,23,17,49,15
Sandler,603,1,366,2019-05-06T19:00:00Z,True,12,10,0,0,92,51,41,51,26,25,41,26
Sandler,603,1,370,2019-05-12T14:00:00Z,False,12,2,0,0,95,54,41,36,23,13,59,18
Johnson,604,1,277,2019-02-27T20:00:00Z,False,18,12,62,2,36,21,15,65,39,26,-29,-24
Johnson,604,1,288,2019-03-02T17:30:00Z,True,18,14,0,0,36,21,15,31,19,12,5,9
Johnson,604,1,291,2019-03-09T15:00:00Z,False,18,4,0,0,39,24,15,25,17,8,14,-2
Johnson,604,1,308,2019-03-16T15:00:00Z,True,18,9,0,0,39,24,15,14,8,6,25,18
Johnson,604,1,319,2019-03-30T17:30:00Z,True,18,7,0,0,42,27,15,40,25,15,2,12
Johnson,604,1,321,2019-04-08T19:00:00Z,False,18,5,0,0,42,27,15,63,35,28,-21,-20
Johnson,604,1,336,2019-04-13T16:30:00Z,False,18,13,0,0,42,27,15,61,32,29,-19,-17
Johnson,604,1,348,2019-04-20T14:00:00Z,True,18,10,0,0,42,27,15,47,23,24,-5,3
Johnson,604,1,358,2019-04-27T11:30:00Z,False,18,16,0,0,43,28,15,70,37,33,-27,-22
Johnson,604,1,368,2019-05-04T14:00:00Z,True,18,15,0,0,46,28,18,38,22,16,8,12
Johnson,604,1,379,2019-05-12T14:00:00Z,False,18,17,0,0,49,31,18,50,27,23,-1,-9
Daly,605,2,281,2019-03-02T15:00:00Z,False,9,2,0,0,14,8,6,27,19,8,-13,-13
Daly,605,2,294,2019-03-09T15:00:00Z,True,9,1,0,0,14,8,6,34,25,9,-20,-1
Daly,605,2,308,2019-03-16T15:00:00Z,False,9,18,0,0,14,8,6,39,24,15,-25,-18
Daly,605,2,314,2019-03-30T15:00:00Z,False,9,6,0,0,14,8,6,33,13,20,-19,-7
Daly,605,2,323,2019-04-06T14:00:00Z,True,9,10,0,0,14,8,6,44,23,21,-30,-13
Daly,605,2,338,2019-04-13T11:30:00Z,False,9,16,0,0,14,8,6,64,31,33,-50,-25
Daly,605,2,345,2019-04-20T14:00:00Z,True,9,17,49,1,14,8,6,46,26,20,-32,-12
Daly,605,2,355,2019-04-26T19:00:00Z,False,9,11,0,0,14,8,6,88,47,41,-74,-41
Daly,605,2,365,2019-05-05T13:00:00Z,True,9,13,0,0,14,8,6,65,36,29,-51,-21
Daly,605,2,377,2019-05-12T14:00:00Z,False,9,15,24,1,15,9,6,38,22,16,-23,-16
Rowe,606,2,294,2019-03-09T15:00:00Z,True,9,1,14,1,14,8,6,34,25,9,-20,-1
Rowe,606,2,308,2019-03-16T15:00:00Z,False,9,18,54,1,14,8,6,39,24,15,-25,-18
Rowe,606,2,314,2019-03-30T15:00:00Z,False,9,6,0,0,14,8,6,33,13,20,-19,-7
Rowe,606,2,323,2019-04-06T14:00:00Z,True,9,10,0,0,14,8,6,44,23,21,-30,-13
Rowe,606,2,338,2019-04-13T11:30:00Z,False,9,16,0,0,14,8,6,64,31,33,-50,-25
Rowe,606,2,345,2019-04-20T14:00:00Z,True,9,17,0,0,14,8,6,46,26,20,-32,-12
Rowe,606,2,355,2019-04-26T19:00:00Z,False,9,11,0,0,14,8,6,88,47,41,-74,-41
Rowe,606,2,365,2019-05-05T13:00:00Z,True,9,13,0,0,14,8,6,65,36,29,-51,-21
Rowe,606,2,377,2019-05-12T14:00:00Z,False,9,15,0,0,15,9,6,38,22,16,-23,-16
Greenwood,607,3,290,2019-03-10T16:30:00Z,False,13,0,10,1,58,29,29,57,38,19,1,-9
Greenwood,607,3,318,2019-03-30T15:00:00Z,True,13,17,0,0,58,29,29,43,23,20,15,9
Greenwood,607,3,329,2019-04-02T18:45:00Z,False,13,19,0,0,61,32,29,44,24,20,17,5
Greenwood,607,3,336,2019-04-13T16:30:00Z,True,13,18,15,1,61,32,29,42,27,15,19,17
Greenwood,607,3,344,2019-04-21T12:30:00Z,False,13,7,0,0,64,35,29,46,28,18,18,1
Greenwood,607,3,305,2019-04-24T19:00:00Z,True,13,12,0,0,64,35,29,86,51,35,-22,0
Greenwood,607,3,356,2019-04-28T15:30:00Z,True,13,5,0,0,64,35,29,67,39,28,-3,7
Greenwood,607,3,365,2019-05-05T13:00:00Z,False,13,9,0,0,65,36,29,14,8,6,51,21
Greenwood,607,3,376,2019-05-12T14:00:00Z,True,13,4,90,2,66,36,30,31,20,11,35,25
Woods,608,1,325,2019-04-06T14:00:00Z,False,6,14,0,0,36,16,20,35,22,13,1,-2
Woods,608,1,332,2019-04-14T13:05:00Z,True,6,12,0,0,39,16,23,80,48,32,-41,-16
Woods,608,1,340,2019-04-21T15:00:00Z,False,6,0,0,0,39,16,23,66,44,22,-27,-21
Woods,608,1,352,2019-04-27T14:00:00Z,True,6,7,0,0,42,16,26,49,31,18,-7,-2
Woods,608,1,362,2019-05-04T16:30:00Z,False,6,4,0,0,43,17,26,31,20,11,12,6
Woods,608,1,372,2019-05-12T14:00:00Z,True,6,1,0,0,46,17,29,45,29,16,1,1
Elliott,609,2,333,2019-04-13T14:00:00Z,True,8,7,0,0,17,15,2,46,28,18,-29,-3
Elliott,609,2,341,2019-04-20T14:00:00Z,False,8,1,0,0,20,18,2,41,26,15,-21,-24
Elliott,609,2,353,2019-04-27T14:00:00Z,True,8,4,0,0,23,18,5,31,20,11,-8,7
Elliott,609,2,369,2019-05-04T14:00:00Z,False,8,19,2,1,26,21,5,54,31,23,-28,-26
Elliott,609,2,373,2019-05-12T14:00:00Z,True,8,14,16,1,26,21,5,42,25,17,-16,4
Holland,610,2,336,2019-04-13T16:30:00Z,False,18,13,0,0,42,27,15,61,32,29,-19,-17
Holland,610,2,348,2019-04-20T14:00:00Z,True,18,10,0,0,42,27,15,47,23,24,-5,3
Holland,610,2,358,2019-04-27T11:30:00Z,False,18,16,0,0,43,28,15,70,37,33,-27,-22
Holland,610,2,368,2019-05-04T14:00:00Z,True,18,15,0,0,46,28,18,38,22,16,8,12
Holland,610,2,379,2019-05-12T14:00:00Z,False,18,17,0,0,49,31,18,50,27,23,-1,-9
Marsh,611,2,338,2019-04-13T11:30:00Z,True,16,9,0,0,64,31,33,14,8,6,50,25
Marsh,611,2,346,2019-04-20T11:30:00Z,False,16,12,0,0,67,34,33,83,48,35,-16,-15
Marsh,611,2,327,2019-04-23T18:45:00Z,True,16,2,0,0,67,34,33,34,22,12,33,22
Marsh,611,2,358,2019-04-27T11:30:00Z,True,16,18,0,0,70,37,33,43,28,15,27,22
Marsh,611,2,361,2019-05-04T11:30:00Z,False,16,1,0,0,70,37,33,42,26,16,28,7
Marsh,611,2,378,2019-05-12T14:00:00Z,True,16,7,0,0,70,37,33,53,34,19,17,18
Ofoborh,612,2,341,2019-04-20T14:00:00Z,True,1,8,0,0,41,26,15,20,18,2,21,24
Ofoborh,612,2,357,2019-04-27T14:00:00Z,False,1,15,0,0,41,26,15,37,21,16,4,-6
Ofoborh,612,2,361,2019-05-04T11:30:00Z,True,1,16,0,0,42,26,16,70,37,33,-28,-7
Ofoborh,612,2,372,2019-05-12T14:00:00Z,False,1,6,0,0,45,29,16,46,17,29,-1,-1
Janssen,613,3,346,2019-04-20T11:30:00Z,False,16,12,0,0,67,34,33,83,48,35,-16,-15
Janssen,613,3,327,2019-04-23T18:45:00Z,True,16,2,10,1,67,34,33,34,22,12,33,22
Janssen,613,3,358,2019-04-27T11:30:00Z,True,16,18,13,1,70,37,33,43,28,15,27,22
Janssen,613,3,361,2019-05-04T11:30:00Z,False,16,1,0,0,70,37,33,42,26,16,28,7
Janssen,613,3,378,2019-05-12T14:00:00Z,True,16,7,13,1,70,37,33,53,34,19,17,18
Driscoll-Glennon,614,1,351,2019-04-28T13:05:00Z,True,3,12,0,0,40,23,17,89,51,38,-49,-15
Driscoll-Glennon,614,1,364,2019-05-03T19:00:00Z,False,3,7,0,0,40,23,17,50,31,19,-10,-14
Driscoll-Glennon,614,1,371,2019-05-12T14:00:00Z,True,3,0,0,0,40,23,17,67,45,22,-27,1
Travers,615,0,361,2019-05-04T11:30:00Z,True,1,16,90,8,42,26,16,70,37,33,-28,-7
Travers,615,0,372,2019-05-12T14:00:00Z,False,1,6,90,1,45,29,16,46,17,29,-1,-1
Molumby,616,2,370,2019-05-12T14:00:00Z,True,2,12,0,0,36,23,13,95,54,41,-59,-18
Dreher,617,2,372,2019-05-12T14:00:00Z,True,6,1,1,1,46,17,29,45,29,16,1,1
Tavares,618,1,372,2019-05-12T14:00:00Z,True,6,1,0,0,46,17,29,45,29,16,1,1
Butcher,619,2,372,2019-05-12T14:00:00Z,False,1,6,0,0,45,29,16,46,17,29,-1,-1
De La Torre,620,2,373,2019-05-12T14:00:00Z,True,8,14,0,0,26,21,5,42,25,17,-16,4
Watts,621,2,373,2019-05-12T14:00:00Z,False,14,8,0,0,42,25,17,26,21,5,16,-4
Cass,622,1,373,2019-05-12T14:00:00Z,False,14,8,0,0,42,25,17,26,21,5,16,-4
Guehi,623,1,374,2019-05-12T14:00:00Z,False,5,10,0,0,71,42,29,51,26,25,20,3
